女生最少的专业	女生最多的专业
麻烦英文怎么读	方便英文怎么读
经常拉肚子是什么原因	偶尔拉肚子是什么原因
南航就业方向	北航就业方向
晶莹的英文	晦暗的英文
小孩经常咳嗽	小孩偶尔咳嗽
没怀孕hcg低是什么原因	没怀孕hcg高是什么原因
左脚麻木是什么原因	左脚敏感是什么原因
散光看近处模糊吗	散光看近处清晰吗
孕后期胎儿偏小	孕后期胎儿偏大
聪明的英文单词怎么读	愚蠢的英文单词怎么读
睡眠质量差怎么办	睡眠质量好怎么办
血压高缺钾	血压低缺钾
湖北大学二千零二十研究生分数线	湖南大学二千零二十研究生分数线
新生儿老是吐奶怎么回事	新生儿偶尔吐奶怎么回事
嘴老是苦的是怎么回事	嘴老是甜的是怎么回事
密字行草书怎么写	疏字行草书怎么写
什么是急性肝炎	什么是慢性肝炎
高密度脂蛋白胆固醇低怎么办	高密度脂蛋白胆固醇高怎么办
嘴唇太厚怎么办	嘴唇太薄怎么办
痛风急性发作怎么治疗	痛风慢性发作怎么治疗
梦到清澈的水里有鱼	梦到浑浊的水里有鱼
三个月宝宝睡觉老是摇头怎么回事	三个月宝宝睡觉偶尔摇头怎么回事
甘油三酯低怎么回事	甘油三酯高怎么回事
老是跟女朋友吵架	老是跟男朋友吵架
轻五笔怎么打	重五笔怎么打
低组词语词	高组词语词
安徽警官职业学院女生多吗	安徽警官职业学院女生少吗
生病会胖吗	生病会瘦吗
经常胸闷喘不上气	偶尔胸闷喘不上气
河南职工住院报销比例	河北职工住院报销比例
冬虫夏草粗支价格	冬虫夏草细支价格
周六日银行开门吗	周六日银行关门吗
孩子经常流鼻血是什么原因	孩子偶尔流鼻血是什么原因
科威特穷吗	科威特富吗
清宫后不用吃消炎药吗	清宫后必须吃消炎药吗
舌厚是什么原因	舌薄是什么原因
不生气的歌	不高兴的歌
很小用英语怎么读	很大用英语怎么读
0两年阳历九月十一什么星座	0两年阴历九月十一什么星座
心率快血压会高吗	心率快血压会低吗
一周瘦五斤正常吗	一周胖五斤正常吗
把字体变大	把字体变小
睡觉老是做梦是什么原因	睡觉偶尔做梦是什么原因
怎样保存手机数据	怎样删除手机数据
身上长了大痘痘	身上长了小痘痘
经常耳鸣是什么原因	偶尔耳鸣是什么原因
睡觉老是手麻	睡觉偶尔手麻
世界上脖子最细的人	世界上脖子最粗的人
尿少是什么原因	尿多是什么原因
阳历十一月六是什么星座的呀	阴历十一月六是什么星座的呀
经常只睡五个小时会怎样	偶尔只睡五个小时会怎样
晚什么结构	早什么结构
月经多怎么办	月经少怎么办
最便宜洗衣机	最贵洗衣机
肌张力低的表现	肌张力大的表现
铜和铝哪个熔点高	铜和铝哪个熔点低
金鱼凹眼什么原因	金鱼凸眼什么原因
血小板低怎么回事	血小板高怎么回事
脚趾甲发白怎么治	脚趾甲发黑怎么治
字数最少的成语	字数最多的成语
血小板高是什么原因	血小板低是什么原因
基金风险比股票小吗	基金风险比股票高吗
甘油三酯高怎么办	甘油三酯低怎么办
记忆力差怎么办	记忆力好怎么办
折射率越小波长	折射率越高波长
老是干呕想吐是怎么回事	偶尔干呕想吐是怎么回事
经常肚子疼是怎么回事	偶尔肚子疼是怎么回事
耳壁上有硬的片状耳屎	耳壁上有软的片状耳屎
关闭网易云音乐	开启网易云音乐
伤心用英语怎么写	高兴用英语怎么写
轻型触探检测频率	重型触探检测频率
形容轻微的词语	形容重大的词语
吃冰激凌会胖吗	吃冰激凌会瘦吗
t值越大说明什么	t值越小说明什么
怎么让视频清晰一点	怎么让视频模糊一点
孕期铁蛋白低是怎么回事	孕期铁蛋白高是怎么回事
什么忙成语	什么闲成语
保鲜期长的水果	保鲜期短的水果
宝妈断奶后会瘦吗	宝妈断奶后会胖吗
顺丰怎么快	顺丰怎么慢
食材嫩玉米窍门	食材老玉米窍门
牙齿经常出血是怎么回事	牙齿偶尔出血是怎么回事
上环后月经量少怎么办	上环后月经量多怎么办
中国最发达的城市	中国最落后的城市
走路会让腿变粗吗	走路会让腿变细吗
快的的英文是什么	慢的的英文是什么
转氨酶高的原因	转氨酶低的原因
久保田小型收割机多少钱一台	久保田大型收割机多少钱一台
ipadair内屏多少钱	ipadair外屏多少钱
鼻子经常出血是什么原因	鼻子偶尔出血是什么原因
焦距越大越好吗	焦距越小越好吗
怎么设置前台运行	怎么设置后台运行
恶这个字一共几画	好这个字一共几画
善部首查字法	恶部首查字法
关闭荒野乱斗	打开荒野乱斗
内存大好玩的游戏	内存小好玩的游戏
小孩子晚上哭闹是怎么回事	小孩子早上哭闹是怎么回事
坏时光用英语怎么说	好时光用英语怎么说
二十年阳历五月哪天搬家好	二十年阴历五月哪天搬家好
一千是奇数吗	一千是偶数吗
美图秀秀怎么把人p黑	美图秀秀怎么把人p亮
经常便血是什么情况	偶尔便血是什么情况
近视怎么恢复视力	远视怎么恢复视力
哪个星座最聪明	哪个星座最愚蠢
河南大学到底什么时候开学	河北大学到底什么时候开学
心率慢怎么回事	心率快怎么回事
如何关闭儿童空间	如何打开儿童空间
普通近义词是什么标准答案	珍贵近义词是什么标准答案
胰岛素高是什么原因	胰岛素低是什么原因
眼睛眼压低是怎么回事	眼睛眼压高是怎么回事
甲亢吃药会胖吗	甲亢吃药会瘦吗
孩子老是挤眼睛怎么办	孩子偶尔挤眼睛怎么办
舌头白怎么回事	舌头黑怎么回事
血压高可以吃二十一金维他吗	血压低可以吃二十一金维他吗
梦见手机坏了	梦见手机好了
咸鸭蛋腌得太淡了怎么办	咸鸭蛋腌得太咸了怎么办
舌苔白怎么回事	舌苔黑怎么回事
大汽车品牌	小汽车品牌
身体热脚凉怎么回事	身体冷脚凉怎么回事
早上起来嘴苦怎么回事	早上起来嘴甜怎么回事
节奏慢的英语	节奏快的英语
异分母分数加减算理	同分母分数加减算理
喝减肥咖啡会不会导致月经提前	喝减肥咖啡会不会导致月经推迟
伤口愈合慢怎么回事	伤口愈合快怎么回事
幸福感最高的职业	幸福感最低的职业
白财神心咒的功德利益	黑财神心咒的功德利益
白细胞低的危害	白细胞高的危害
今日山东卫视节目单	今日山西卫视节目单
姨妈只有两天量少	姨妈只有两天量多
尿频量少是什么原因	尿频量多是什么原因
王者最高冷却	王者最低冷却
少的英语	老的英语
以难开头的诗句	以易开头的诗句
男的什么样的掌纹最好	男的什么样的掌纹最差
崭新的近义词是	陈旧的近义词是
喝纯牛奶会胖吗	喝纯牛奶会瘦吗
舌苔白怎么办	舌苔黑怎么办
形容女生个子矮的词语	形容女生个子高的词语
用蛮横造句	用和蔼造句
嘴巴苦是怎么了	嘴巴甜是怎么了
河北距离广西多远	河北距离广东多远
年龄小腰疼	年龄大腰疼
抽油烟机烟管短了怎么办	抽油烟机烟管长了怎么办
脚指甲变白怎么回事	脚指甲变黑怎么回事
手机白号是什么意思	手机黑号是什么意思
结肠腺瘤低级别	结肠腺瘤高级别
急性气管炎的症状	慢性气管炎的症状
特别的音节	普通的音节
马虎反义词是什么标准答案	认真反义词是什么标准答案
舌头发白口苦是什么原因	舌头发黑口苦是什么原因
胎儿大四周怎么办	胎儿小四周怎么办
乌黑相反的词	雪白相反的词
下次世界杯冠军是哪个国家	上次世界杯冠军是哪个国家
中国最好的大学	中国最坏的大学
包粽子的简单步骤	包粽子的详细步骤
手机屏幕经常花屏	手机屏幕偶尔花屏
女人情商低的典型表现	女人情商高的典型表现
小风炮加什么油	大风炮加什么油
老是反胃干呕怎么回事	偶尔反胃干呕怎么回事
深圳哪个区最繁华	深圳哪个区最偏僻
低脂肪高碳水	低脂肪低碳水
例假来之前胸部胀痛	例假来之后胸部胀痛
心跳过快是什么病	心跳过慢是什么病
湖南大学偏文还是偏理	湖北大学偏文还是偏理
什么血型最好	什么血型最差
腋下温度比口腔高	腋下温度比口腔低
梦见小女孩输液	梦见小男孩输液
头发稀疏的原因	头发茂密的原因
新陈代谢慢是什么原因	新陈代谢快是什么原因
贵阳观山湖区公立小学有哪些	贵阳观山湖区私立小学有哪些
为什么身体越来越瘦	为什么身体越来越胖
避孕药对身体有害吗	避孕药对身体有益吗
近视最高度数	近视最低度数
神奇的鹿游戏	普通的鹿游戏
老是打嗝怎么办	偶尔打嗝怎么办
形容高兴的词语有哪一些	形容悲伤的词语有哪一些
时间短的古文	时间长的古文
羊水少是怎么回事	羊水多是怎么回事
舌头厚白是怎么回事	舌头厚黑是怎么回事
怎么折大皇冠	怎么折小皇冠
上海哪里富	上海哪里穷
一个月瘦了五斤正常吗	一个月胖了五斤正常吗
肝胆虚热吃什么中成药	肝胆实热吃什么中成药
形容说话很多的四字词语	形容说话很少的四字词语
什么东西越吃越硬	什么东西越吃越软
什么是高碘食物有哪些	什么是低碘食物有哪些
甜芥菜怎么做好吃	苦芥菜怎么做好吃
经济最发达的县	经济最落后的县
晚上喝酸奶会胖吗	晚上喝酸奶会瘦吗
经常牙龈肿痛是什么原因	偶尔牙龈肿痛是什么原因
慢性胃炎会瘦吗	慢性胃炎会胖吗
形容富庶的诗词	形容贫穷的诗词
精致的读音	粗率的读音
厨师工资低	厨师工资高
好老师的特点	坏老师的特点
月经特别少	月经特别多
快手说说短句子热门	快手说说长句子热门
让男人伤心的话	让男人高兴的话
大型沙滩车价格	小型沙滩车价格
宝宝老是干呕怎么回事	宝宝偶尔干呕怎么回事
血压高怎么办	血压低怎么办
怎么追一个比自己小的男生	怎么追一个比自己大的男生
拉肚子会瘦吗	拉肚子会胖吗
中国最富的省是哪一个	中国最穷的省是哪一个
整齐用英文怎么说	凌乱用英文怎么说
白甜菜的功效与作用	白苦菜的功效与作用
脚丫大怎么办	脚丫小怎么办
阳历两．二十号是什么星座	阴历两．二十号是什么星座
脖子短的动物有哪些	脖子长的动物有哪些
指甲变厚分层是怎么回事	指甲变薄分层是怎么回事
用粉底液之前要不要用隔离	用粉底液之后要不要用隔离
老是拉肚子是怎么回事	偶尔拉肚子是怎么回事
孕妇尿碘高怎么回事	孕妇尿碘低怎么回事
阳历两点十一是什么星座	阴历两点十一是什么星座
小傻逼的英语	大傻逼的英语
吃活血化瘀的药会瘦吗	吃活血化瘀的药会胖吗
脚掌和脚面疼是怎么回事	脚掌和脚背疼是怎么回事
心率过慢的危害	心率过快的危害
离广东最近的草原	离广西最近的草原
鼻子经常出血怎么办	鼻子偶尔出血怎么办
结肠炎可以吃大白菜吗	结肠炎可以吃小白菜吗
血小板高是怎么回事	血小板低是怎么回事
关闭微信后台	打开微信后台
宝宝老是干恶心怎么回事	宝宝偶尔干恶心怎么回事
什么水果脂肪低	什么水果脂肪高
白带有点绿是什么原因	白带有点红是什么原因
牛排热量高	牛排热量低
经常打喷嚏是怎么回事	偶尔打喷嚏是怎么回事
湖北工业大学研究生读几年	湖南工业大学研究生读几年
舌头厚白是怎么回事	舌头薄白是怎么回事
身体代谢慢怎么办	身体代谢快怎么办
钠低有什么症状	钠高有什么症状
小便慢怎么回事	小便快怎么回事
急性心衰症状	慢性心衰症状
丰田小排量	丰田大排量
十二生肖最聪明的动物是什么	十二生肖最愚蠢的动物是什么
人为什么会胖	人为什么会瘦
脚泡白了怎么办	脚泡黑了怎么办
世界上最小的国家是哪个国家	世界上最大的国家是哪个国家
淘气的日语	老实的日语
角的大小与什么无关与什么有关	角的大小与什么有关与什么有关
心脏跳动慢怎么治疗	心脏跳动快怎么治疗
大乐透最高中多少	大乐透最低中多少
小孩急性肺炎严重吗	小孩慢性肺炎严重吗
童话故事是假的吗	童话故事是真的吗
为什么有些人怎么吃都不胖	为什么有些人怎么吃都不瘦
oppowatch关机	oppowatch开机
早上好的长句子	早上好的短句子
舌苔发白怎么办	舌苔发黑怎么办
身子特别短的狗	身子特别长的狗
神奇的反近义词	普通的反近义词
慢的拼音和部首	急的拼音和部首
缝纫机不吃厚	缝纫机不吃薄
哈士奇大的多少钱	哈士奇小的多少钱
葡萄吃多了会胖吗	葡萄吃多了会瘦吗
阳历七十三年一月九日是什么星座	阴历七十三年一月九日是什么星座
月经前几天体温会升高吗	月经后几天体温会升高吗
如何错误的套路一个魔教教主广播剧	如何正确的套路一个魔教教主广播剧
孕妇得了急性肠胃炎怎么办	孕妇得了慢性肠胃炎怎么办
就业率高的学校	就业率低的学校
什么避孕药副作用最小	什么避孕药副作用最大
怀孕的肚子是硬的吗	怀孕的肚子是软的吗
产后恶露少是怎么回事	产后恶露多是怎么回事
阳历七月初九是什么星座	阴历七月初九是什么星座
身体老是发麻	身体偶尔发麻
苏打饼干吃了会胖吗	苏打饼干吃了会瘦吗
吐白痰怎么回事	吐黑痰怎么回事
十一月十九日阳历是什么星座	十一月十九日阴历是什么星座
尿酸高的症状	尿酸低的症状
山东师范大学历史系分数线	山西师范大学历史系分数线
女人幼稚的表现	女人老练的表现
咸的意思	淡的意思
眉眼距离宽怎么办	眉眼距离窄怎么办
血小板高是什么原因	血小板小是什么原因
怀孕初期热正常吗	怀孕初期冷正常吗
经常干呕想吐是怎么回事	偶尔干呕想吐是怎么回事
孑然一身反义词是什么	形单影只反义词是什么
难什么成语大全	易什么成语大全
形容柔软的	形容坚硬的
大便颜色深褐色	大便颜色浅褐色
高钾症状有哪些	低钾症状有哪些
发烧血小板低怎么回事	发烧血小板高怎么回事
描写心情阴郁的句子	描写心情开朗的句子
河北中医院科室列表	河南中医院科室列表
怎么关闭word安全模式	怎么打开word安全模式
低级别恶性程度高吗	高级别恶性程度高吗
阳历六月份出生的是什么星座	阴历六月份出生的是什么星座
小冰箱尺寸一般	大冰箱尺寸一般
西部证券是大券商吗	西部证券是小券商吗
发热白细胞高怎么回事	发热白细胞低怎么回事
月经量比较多	月经量比较小
什么什么无事	什么什么有事
鼻子里偶尔有血丝是怎么回事	鼻子里老是有血丝是怎么回事
什么是软导体	什么是硬导体
伟大同义词是什么	平凡同义词是什么
浪琴越走越快怎么办	浪琴越走越慢怎么办
胆解脂酶高	胆解脂酶低
急性胆囊结石症状	慢性胆囊结石症状
如何把照片像素调高	如何把照片像素调小
吃麦片会胖吗	吃麦片会瘦吗
比中国慢半个小时的国家	比中国快半个小时的国家
血压高有什么症状	血压低有什么症状
经常咳嗽怎么办	偶尔咳嗽怎么办
朝阳离天安门远吗	朝阳离天安门近吗
河南师范大学招美术生吗	河北师范大学招美术生吗
孕妇血糖低怎么回事	孕妇血糖高怎么回事
美金最高汇率	美金最低汇率
心跳过快是怎么回事	心跳过慢是怎么回事
身份证年龄怎么改小	身份证年龄怎么改大
形容人很胖的句子	形容人很瘦的句子
阳历八月二十三日是什么星座的	阴历八月二十三日是什么星座的
大繁体字	小繁体字
嘴里唾液甜	嘴里唾液苦
女人幼稚的表现	女人成熟的表现
经常咳嗽有痰	偶尔咳嗽有痰
为什么怀孕肚子那么大	为什么怀孕肚子那么小
鼻子干燥是怎么回事	鼻子湿润是怎么回事
漂亮的的英文单词怎么写	丑陋的的英文单词怎么写
头发白怎么回事	头发黑怎么回事
舌头发白怎么办	舌头发黑怎么办
皮肤经常过敏怎么办	皮肤偶尔过敏怎么办
早上吃什么饭	晚上吃什么饭
牙齿敏感怎么办	牙齿麻木怎么办
钾低会引起什么	钾高会引起什么
阴沉的英语怎么说	明朗的英语怎么说
雌性激素高是怎么回事	雌性激素低是怎么回事
树叶少怎么形容	树叶多怎么形容
胆固醇高的症状	胆固醇低的症状
什么食物蛋白质含量高	什么食物蛋白质含量低
甘油三酯高说明什么	甘油三酯低说明什么
孔雀鱼水温高	孔雀鱼水温低
偶尔便血是怎么回事	老是便血是怎么回事
世界上最穷的国家是什么国家	世界上最富的国家是什么国家
反复发烧是怎么回事	偶尔发烧是怎么回事
饭后胃疼是怎么回事	饭前胃疼是怎么回事
脚趾麻木怎么办	脚趾敏感怎么办
胖人遗传吗	瘦人遗传吗
可爱用英语怎么说	可恨用英语怎么说
九十三年正月二十六是阳历多少	九十三年正月二十六是阴历多少
大便难解是怎么回事	小便难解是怎么回事
小肚子大是怎么回事	小肚子小是怎么回事
hcg低怎么办	hcg高怎么办
关关闭手机	打开关闭手机
感觉嗓子有异物老是咳嗽	感觉嗓子有异物偶尔咳嗽
形容人聪明的英语	形容人愚蠢的英语
苏打水坏处	苏打水好处
稀疏怎么拼	繁茂怎么拼
心脏跳的慢是怎么回事	心脏跳的快是怎么回事
早上醒来嘴巴苦	早上醒来嘴巴甜
快速排序最坏时间复杂度	快速排序最好时间复杂度
天津人最少的地方	天津人最多的地方
多乐士避孕套厚吗	多乐士避孕套薄吗
笔画少的二字词语	笔画多的二字词语
嘴苦怎么回事	嘴甜怎么回事
隧道最高限速	隧道最低限速
澄澈的近义词和反义词是什么	混浊的近义词和反义词是什么
老是干咳嗽是什么原因	偶尔干咳嗽是什么原因
无足轻重的反义词	人命关天的反义词
经常吃健胃消食片好吗	偶尔吃健胃消食片好吗
经常便秘是什么原因	偶尔便秘是什么原因
地级市最少的省份	地级市最多的省份
脖子粗是什么原因	脖子细是什么原因
伤心用英语怎么说	高兴用英语怎么说
高钾心脏骤停	低钾心脏骤停
小的用英语怎么说	大的用英语怎么说
亮度亮一点	亮度暗一点
身高矮怎么办	身高高怎么办
手机外放音量大	手机外放音量小
晚上吃苹果会胖吗	晚上吃苹果会瘦吗
美食小广场	美食大广场
心率过慢怎么调节	心率过快怎么调节
什么菜油少	什么菜油多
下半身肥胖	下半身消瘦
宝宝经常咳嗽什么原因	宝宝偶尔咳嗽什么原因
如何唱高音简易方法	如何唱低音简易方法
新的拼音怎么写	旧的拼音怎么写
坚硬的反义词和近义词是什么	柔软的反义词和近义词是什么
嘴唇太厚可以整吗	嘴唇太薄可以整吗
我的腿很短英文	我的腿很长英文
减肥喝粥会胖吗	减肥喝粥会瘦吗
目光短浅的下一句是什么	高瞻远瞩的下一句是什么
夸张句的例子夸小	夸张句的例子夸大
月经量少该怎么办	月经量多该怎么办
女性反复尿频是怎么回事	女性偶尔尿频是怎么回事
月经老是推迟的原因	月经偶尔推迟的原因
吃方便面会胖吗	吃方便面会瘦吗
月经前一天是安全期吗	月经后一天是安全期吗
怀孕前三个月会瘦吗	怀孕前三个月会胖吗
天然的英文	人造的英文
白带有臭味	白带有香味
什么动物最聪明	什么动物最愚蠢
睡眠不足会血压高吗	睡眠不足会血压低吗
肛周脓肿算大手术吗	肛周脓肿算小手术吗
薄弱的词语	雄厚的词语
阿娇有多高	阿娇有多矮
小孩偶尔咳嗽	小孩经常咳嗽
怎样怀孕几率大	怎样怀孕几率低
荔枝皮是干垃圾吗	荔枝皮是湿垃圾吗
在瑞士买劳力士便宜吗	在瑞士买劳力士贵吗
白的颜色有哪些	黑的颜色有哪些
轻薄的成语	稳重的成语
怎么样让照片模糊	怎么样让照片清晰
经常梦到一个人代表什么	偶尔梦到一个人代表什么
酒的度数低	酒的度数高
宽阔的反义词近义词	狭小的反义词近义词
九十年两月七日是什么星座阳历	九十年两月七日是什么星座阴历
血小板低怎样治疗	血小板高怎样治疗
肌酐高的症状	肌酐低的症状
六十六年十二月二十一日生阳历是什么星座	六十六年十二月二十一日生阴历是什么星座
胖的英语反义词是什么	瘦的英语反义词是什么
小便混浊是什么原因	小便清白是什么原因
人流后月经量多	人流后月经量小
笨拙的近义词	伶俐的近义词
献血对身体有害吗	献血对身体有益吗
外省回广东的人员需要隔离吗	外省回广西的人员需要隔离吗
今天最低气温	今天最高气温
微信怎么关掉通讯录	微信怎么开通讯录
湖南帅哥多不多	湖北帅哥多不多
男孩子网名	女孩子网名
胃泌素高说明什么	胃泌素低说明什么
形容心情惆怅的诗句	形容心情舒畅的诗句
脚底麻木是什么原因	脚底敏感是什么原因
大便颜色发黑	大便颜色发亮
世界上飞得最快的昆虫是什么	世界上飞得最慢的昆虫是什么
好看的女孩子名字	好看的男孩子名字
怀孕胸部会变大吗	怀孕胸部会变小吗
最短命的生肖是什么	最长寿的生肖是什么
什么少什么什么的成语	什么多什么什么的成语
怎么才能长胖	怎么才能长瘦
贱换一个偏旁组词	贵换一个偏旁组词
便秘有什么好办法	腹泻有什么好办法
严重颈椎病怎么办	轻微颈椎病怎么办
沙盘模拟长期贷款什么时候还	沙盘模拟短期贷款什么时候还
吃瓜子会胖吗	吃瓜子会瘦吗
紫外线几点到几点最弱	紫外线几点到几点最强
只吃白米饭会胖吗	只吃白米饭会瘦吗
戒指尺寸可以调大吗	戒指尺寸可以调小吗
大姨妈后几天是安全期	大姨妈后几天是危险期
感冒头痛发热吃什么药	感冒头痛发冷吃什么药
关掉手机淘宝	开手机淘宝
感冒怎么好的快	感冒怎么好的慢
蛋白高怎么回事	蛋白低怎么回事
最便宜的网线	最贵的网线
小便混浊是怎么回事	小便清白是怎么回事
带有异字的成语有哪些	带有同字的成语有哪些
轻微食物中毒症状	严重食物中毒症状
宝宝反复低烧	宝宝偶尔低烧
为什么脸比脖子白	为什么脸比脖子黑
东北大学详细地址	西北大学详细地址
湖南大学文科优势专业	湖北大学文科优势专业
梦见别人买白衣服	梦见别人买黑衣服
小橘猫多少钱	大橘猫多少钱
关闭导航	打开导航
形容舞台大	形容舞台小
压力过大会导致月经量少吗	压力过大会导致月经量多吗
小孩反复发烧	小孩偶尔发烧
小孩子偶尔流鼻血是怎么回事	小孩子老是流鼻血是怎么回事
谁是世界上最漂亮的人	谁是世界上最丑陋的人
贫血血压会低吗	贫血血压会高吗
河北高考五百分难吗	河南高考五百分难吗
李子吃多了会胖吗	李子吃多了会瘦吗
小兔关掉手机电筒	小兔打开手机电筒
不喜欢吃热的食物	不喜欢吃冷的食物
东北的九百八十五大学	西北的九百八十五大学
三国以前是什么朝代	三国以后是什么朝代
属于深感觉检查的是	属于浅感觉检查的是
最漂亮的鱼	最丑陋的鱼
晚上吃橘子会胖吗	晚上吃橘子会瘦吗
急性肝炎的症状	慢性肝炎的症状
第一个残的成语	第一个全的成语
经常打嗝怎么办	偶尔打嗝怎么办
雄伟的怎么写	渺小的怎么写
满腹经纶的成语	目不识丁的成语
小型货车使用年限是多少年	大型货车使用年限是多少年
形容轻微的词语	形容惨重的词语
乳糖不耐受喝牛奶会瘦吗	乳糖不耐受喝牛奶会胖吗
华南植物园几点关门	华南植物园几点开门
形容很急促的词语	形容很缓慢的词语
这次月经量特别少怎么回事	这次月经量特别多怎么回事
肌酸激酶高怎么办	肌酸激酶低怎么办
宝宝老是摇头	宝宝偶尔摇头
八十六年阳历十一月二十六日是什么星座	八十六年阴历十一月二十六日是什么星座
关闭儿童模式	打开儿童模式
电脑上怎么输入错号	电脑上怎么输入对号
关于热的诗句	关于冷的诗句
肠胃蠕动慢怎么办	肠胃蠕动快怎么办
老实的四字成语	调皮的四字成语
什么血型最好	什么血型最坏
月经老是提前是什么原因	月经偶尔提前是什么原因
南方哪里最热	南方哪里最冷
心跳过快什么原因引起的	心跳过慢什么原因引起的
新生儿经常呛奶正常吗	新生儿偶尔呛奶正常吗
阳历十一月是什么星座	阴历十一月是什么星座
人流后月经很少怎么办	人流后月经很多怎么办
头围正常双顶径偏小原因	头围正常双顶径偏大原因
三个水是什么字	三个火是什么字
山西离内蒙古远吗	山西离内蒙古近吗
湖南大学教育学研究生分数线	湖北大学教育学研究生分数线
小红书怎么复制长链接	小红书怎么复制短链接
尿少尿黄是怎么回事	尿多尿黄是怎么回事
今天最低气温多少度	今天最高气温多少度
轻微脑震荡怎么治疗	严重脑震荡怎么治疗
浑浊的拼音怎么拼写	清澈的拼音怎么拼写
小型混凝土搅拌机多少钱	大型混凝土搅拌机多少钱
形容枪法差的词语	形容枪法好的词语
愚蠢的动物指什么生肖	聪明的动物指什么生肖
睡眠差是什么原因	睡眠好是什么原因
孩子越吃越胖怎么办	孩子越吃越瘦怎么办
形容开朗的成语	形容孤僻的成语
河北师范大学分数线	河南师范大学分数线
轻微痔疮怎么办	严重痔疮怎么办
花青素含量高的食物	花青素含量低的食物
越大越好的东西	越小越好的东西
饭后跑步好吗	饭前跑步好吗
俊俏怎么拼	丑陋怎么拼
心跳过快吃什么药	心跳过慢吃什么药
什么东西含糖低	什么东西含糖高
心跳快憋得慌	心跳慢憋得慌
河北大学怎么样	河南大学怎么样
中国最矮的山	中国最高的山
如何让照片小于六十k	如何让照片大于六十k
什么油脂肪含量最低	什么油脂肪含量最高
血小板低会不会是白血病	血小板高会不会是白血病
老是打喷嚏是怎么回事	偶尔打喷嚏是怎么回事
手经常发麻是什么原因	手偶尔发麻是什么原因
早上起来嗓子甜	早上起来嗓子苦
河南人为什么那么高	河南人为什么那么矮
手机qq语音声音大怎么调	手机qq语音声音小怎么调
为什么自己的口水是苦的	为什么自己的口水是甜的
电脑字体怎么调粗	电脑字体怎么调细
迅速的组词是什么	缓慢的组词是什么
轻微烫伤怎么办	严重烫伤怎么办
威少最高得分	威少最低得分
天气很热怎么发朋友圈	天气很冷怎么发朋友圈
大的什么填词语	小的什么填词语
眼睛小和什么有关	眼睛大和什么有关
机械硬盘和固态硬盘哪个便宜	机械硬盘和固态硬盘哪个贵
怎么看iphone是不是假的	怎么看iphone是不是真的
轻色调是什么颜色	重色调是什么颜色
新生儿老是吐奶正常吗	新生儿偶尔吐奶正常吗
形容很冷清的四字成语	形容很热闹的四字成语
胃疼经常打嗝怎么回事	胃疼偶尔打嗝怎么回事
母猫发情会打滚吗	公猫发情会打滚吗
带有脏的四字词语	带有净的四字词语
老是发烧怎么回事	偶尔发烧怎么回事
偶尔便血是什么原因	老是便血是什么原因
葫芦岛穷吗	葫芦岛富吗
但是有点瘦英语	但是有点胖英语
表示舒服的词有哪些	表示难受的词有哪些
全身热怎么办	全身冷怎么办
沙井新天虹在哪里	沙井旧天虹在哪里
便宜的用英语怎么	昂贵的用英语怎么
宜家装修贵吗	宜家装修便宜吗
深粉色代表什么	浅粉色代表什么
反复发烧是什么原因	偶尔发烧是什么原因
丝芙兰的东西便宜吗	丝芙兰的东西贵吗
经常打喷嚏是什么原因	偶尔打喷嚏是什么原因
什么动物爬的最慢	什么动物爬的最快
你会说广东话吗	你会说广西话吗
西北师大考研分数线	东北师大考研分数线
上海哪个地方最繁华	上海哪个地方最偏僻
含钾较低的食物有哪些	含钾较高的食物有哪些
资产负债率和流动比率都很低	资产负债率和流动比率都很高
经常放屁是什么原因	偶尔放屁是什么原因
动脉斑块怎么治疗	静脉斑块怎么治疗
旧电表怎么看度数	新电表怎么看度数
尿少尿黄怎么回事	尿多尿黄怎么回事
单纯甲状腺素高	单纯甲状腺素低
关闭自动连点器	打开自动连点器
手脚经常发抖是什么病	手脚偶尔发抖是什么病
河南大学声乐分数线	河北大学声乐分数线
牙齿老是出血	牙齿偶尔出血
一个月的宝宝老是吐奶怎么回事	一个月的宝宝偶尔吐奶怎么回事
嘉兴公立初中排名榜	嘉兴私立初中排名榜
老包是什么	嫩包是什么
笨拙的近义词是什么	聪明的近义词是什么
甘肃人口最多的市	甘肃人口最少的市
亮得什么填词语	黑得什么填词语
很热的风怎么形容	很冷的风怎么形容
把歌曲关闭	把歌曲打开
中国哪里黑的最晚	中国哪里亮的最晚
咳嗽有白痰怎么回事	咳嗽有黑痰怎么回事
头发长得慢怎么回事	头发长得快怎么回事
抽烟会瘦吗	抽烟会胖吗
甲亢会月经提前吗	甲亢会月经推迟吗
白蛋白高的症状有哪些	白蛋白低的症状有哪些
经常胃疼是什么原因	偶尔胃疼是什么原因
经常失眠怎么调理	偶尔失眠怎么调理
蓝牙耳机太大了怎么办	蓝牙耳机太小了怎么办
广东公务员一年考几次	广西公务员一年考几次
冰箱线太长怎么办	冰箱线太短怎么办
全身疲惫是什么原因	全身亢奋是什么原因
中国最大的淡水湖是哪个	中国最大的咸水湖是哪个
人胖胸小怎么选内衣	人胖胸大怎么选内衣
急性肝炎症状	慢性肝炎症状
背部部位名称	腹部部位名称
尿不湿小了怎么贴	尿不湿大了怎么贴
消化不良容易胖吗	消化不良容易瘦吗
审核凭证相关说法错误的是	审核凭证相关说法正确的是
白带少怎么回事	白带多怎么回事
小型平板车运输车价格	大型平板车运输车价格
母英文翻译	公英文翻译
长城站的纬度位置	长城站的经度位置
蛀牙轻微疼痛	蛀牙剧烈疼痛
美国独立战争之前的社会性质	美国独立战争之后的社会性质
借贷利息最高多少	借贷利息最低多少
牙齿经常出血是什么原因	牙齿偶尔出血是什么原因
怎样把胳膊练细	怎样把胳膊练粗
十大唱功差的歌手	十大唱功好的歌手
小型地基打桩机多少钱一台	大型地基打桩机多少钱一台
大便干燥拉不出来怎么办	大便湿润拉不出来怎么办
眼皮太厚怎么办	眼皮太薄怎么办
老是吐痰是怎么回事	偶尔吐痰是怎么回事
婴儿指甲发白怎么回事	婴儿指甲发黑怎么回事
世界上工资最高的人	世界上工资最低的人
对我们有益的英语怎么写	对我们有害的英语怎么写
咳白痰是怎么回事	咳黑痰是怎么回事
指甲软是什么原因	指甲硬是什么原因
小孩偶尔咳嗽	小孩老是咳嗽
橄榄核上色快	橄榄核上色慢
toonboom怎么导入图片	toonboom怎么导出图片
鸭腿鸡腿哪个贵	鸭腿鸡腿哪个便宜
忧伤的长句子	忧伤的短句子
九十七年一月五日阳历	九十七年一月五日阴历
猫吃的特别少	猫吃的特别多
什么是弱周期	什么是强周期
反义词雪白对什么	反义词漆黑对什么
越来越瘦是什么原因	越来越胖是什么原因
奢华的词语	俭朴的词语
肚子太大怎么办	肚子太小怎么办
你能帮我找个女朋友吗	你能帮我找个男朋友吗
适合女生唱的高音歌曲	适合女生唱的低音歌曲
胆红素高的原因	胆红素低的原因
密集反义词	零星反义词
咸奶油蛋糕热量	淡奶油蛋糕热量
手背血管细是什么原因	手背血管粗是什么原因
你可以做我女朋友吗	你可以做我男朋友吗
又厚又长的头发怎么扎	又厚又短的头发怎么扎
戴口罩的错误方式	戴口罩的正确方式
总蛋白高说明什么	总蛋白低说明什么
描写男生的穿着	描写女生的穿着
高的英语怎么	矮的英语怎么
表达忧郁的句子	表达畅快的句子
十九年广西企业一百强	十九年广东企业一百强
小型打谷机价格	大型打谷机价格
经常出虚汗是怎么回事	偶尔出虚汗是怎么回事
身体水份含量低怎么办	身体水份含量高怎么办
小孩脸上长白斑怎么办	小孩脸上长黑斑怎么办
胸大怎么办	胸小怎么办
左臂发冷是什么原因	右臂发冷是什么原因
河南师范大学领导名单	河北师范大学领导名单
怀孕初期老是肚子疼怎么回事	怀孕初期偶尔肚子疼怎么回事
孕酮低怎么回事	孕酮高怎么回事
晚上喝酸奶会瘦吗	晚上喝酸奶会胖吗
梦见大便解不出来	梦见小便解不出来
西北政法大学是不是九百八十五	西南政法大学是不是九百八十五
脚趾甲发白怎么回事	脚趾甲发黑怎么回事
南京比较好的美容医院	北京比较好的美容医院
形容别人美的词	形容别人丑的词
广阔的反义词是什么	狭窄的反义词是什么
经常头疼是什么问题	偶尔头疼是什么问题
海拔越高温差越大	海拔越高温差越小
反复发烧怎么回事	偶尔发烧怎么回事
有期限的时装可以合成吗	有期限的时装可以分解吗
奶水少回奶	奶水多回奶
月经完第二天是安全期吗	月经完第二天是危险期吗
月经少可以吃坤灵丸吗	月经多可以吃坤灵丸吗
脸上长小疙瘩怎么办	脸上长大疙瘩怎么办
老是打嗝是什么原因	偶尔打嗝是什么原因
女人太胖对身体有什么影响	女人太瘦对身体有什么影响
注册小公司流程及费用	注册大公司流程及费用
婴儿身高矮	婴儿身高高
胸小的原因	胸大的原因
雌二醇低怎么办	雌二醇高怎么办
头经常眩晕是怎么回事	头偶尔眩晕是怎么回事
