南阳到焦作的火车时刻表查询	焦作到南阳的火车时刻表查询
汤原到南岔列车时刻表	南岔到汤原列车时刻表
吉木萨尔到哈密	哈密到吉木萨尔
石家庄西广场到东广场怎么走	石家庄东广场到西广场怎么走
安阳到偃师	偃师到安阳
衡水到石家庄北站	石家庄北站到衡水
荥阳去郑州怎么坐车	郑州去荥阳怎么坐车
济南到西安火车	西安到济南火车
高碑店东到保定东	保定东到高碑店东
赤壁到洪湖班车	洪湖到赤壁班车
沈阳到庐山	庐山到沈阳
顺丰从上海到哈尔滨	顺丰从哈尔滨到上海
唐山到沈阳北火车时刻表	沈阳到唐山北火车时刻表
如何把qq的钱转到微信上	如何把微信的钱转到qq上
昆山到成都的高铁	成都到昆山的高铁
微信转账到银行卡要手续费吗	银行卡转账到微信要手续费吗
石家庄至芜湖	芜湖至石家庄
葫芦岛到建昌拼车	建昌到葫芦岛拼车
广州到上海自驾游攻略	上海到广州自驾游攻略
密山到齐齐哈尔	齐齐哈尔到密山
浙江到青海	青海到浙江
上海到米兰飞机	米兰到上海飞机
郑州火车站到新密大巴	新密到郑州火车站大巴
你真的不会离开我吗	我真的不会离开你吗
指甲长到肉里怎么办	肉长到指甲里怎么办
大溪到金华汽车时刻表	金华到大溪汽车时刻表
北京到庆阳	庆阳到北京
风油精搞到眼睛怎么办	眼睛搞到风油精怎么办
铁力到沈阳的火车时刻表	沈阳到铁力的火车时刻表
保定到邯郸高铁	邯郸到保定高铁
镇江到南京禄口机场大巴	南京禄口机场到镇江大巴
长春到南通火车票	南通到长春火车票
南京禄口机场到扬中	扬中到南京禄口机场
银行卡可以转账到信用卡吗	信用卡可以转账到银行卡吗
济南至保定高铁时刻表查询	保定至济南高铁时刻表查询
六里桥地铁站到长阳地铁站	长阳地铁站到六里桥地铁站
厦门北站到高崎机场t四	高崎机场t四到厦门北站
昆明到广南顺风车	广南到昆明顺风车
鹰潭到瑞金汽车时刻表	瑞金到鹰潭汽车时刻表
宁波到信阳火车	信阳到宁波火车
台州到临沂客车	临沂到台州客车
芜湖到上饶高铁时刻表	上饶到芜湖高铁时刻表
重庆到呼和浩特火车时刻表	呼和浩特到重庆火车时刻表
泗水到兖州火车	兖州到泗水火车
长沙至湘乡的火车	湘乡至长沙的火车
沣河森林公园到咸阳火车站	咸阳火车站到沣河森林公园
男生见到暗恋女生反应	女生见到暗恋男生反应
纽约飞中国机票	中国飞纽约机票
睢宁到贾汪的车次查询	贾汪到睢宁的车次查询
铜仁到贵阳过路费	贵阳到铜仁过路费
武汉到哈尔滨要隔离吗	哈尔滨到武汉要隔离吗
支付宝怎么转账到银行卡	银行卡怎么转账到支付宝
济南到成都高铁票	成都到济南高铁票
连界到重庆汽车时刻表	重庆到连界汽车时刻表
桐乡到临平怎么坐车	临平到桐乡怎么坐车
任丘到石家庄的客车通车了吗	石家庄到任丘的客车通车了吗
商洛到城南客运站	城南客运站到商洛
通辽离长春	长春离通辽
本溪到敦化高铁时刻表	敦化到本溪高铁时刻表
信用卡能转账到支付宝吗	支付宝能转账到信用卡吗
江阴到苏州的汽车时刻表	苏州到江阴的汽车时刻表
济南到厦门的飞机	厦门到济南的飞机
天润城到南京站	南京站到天润城
攸县南站到广州东站	广州东站到攸县南站
江阴客运站到无锡	无锡到江阴客运站
武汉去深圳需要隔离吗	深圳去武汉需要隔离吗
乌鲁木齐到张家口的火车时刻表	张家口到乌鲁木齐的火车时刻表
扬州到重庆飞机时刻表	重庆到扬州飞机时刻表
excel复制文字到word	word复制文字到excel
重庆到西安火车票	西安到重庆火车票
德令哈到西宁汽车票	西宁到德令哈汽车票
呼兰到天津火车时刻表	天津到呼兰火车时刻表
长兴至商丘火车时刻表	商丘至长兴火车时刻表
天津到阜阳飞机	阜阳到天津飞机
花都到赣州火车时刻表	赣州到花都火车时刻表
上海到重庆火车票	重庆到上海火车票
西安至重庆机票价格	重庆至西安机票价格
齐齐哈尔到阿城的火车时刻表	阿城到齐齐哈尔的火车时刻表
山东到贵州需要隔离吗	贵州到山东需要隔离吗
清原到梅河口火车	梅河口到清原火车
本溪到武汉	武汉到本溪
遵义到保定火车票	保定到遵义火车票
许昌至万州火车票	万州至许昌火车票
临颍到郑州火车	郑州到临颍火车
太原到涉县的客车	涉县到太原的客车
大兴国际机场到首都机场	首都机场到大兴国际机场
从铜仁到贵阳	从贵阳到铜仁
沈阳到扬州飞机票	扬州到沈阳飞机票
成都到林芝的飞机	林芝到成都的飞机
衡水到周口	周口到衡水
息县到萧山大巴电话	萧山到息县大巴电话
你实在是没有什么法子能帮到我	我实在是没有什么法子能帮到你
金寨到杭州火车时刻表	杭州到金寨火车时刻表
九江到南宁的火车票	南宁到九江的火车票
北京到开封快递几天	开封到北京快递几天
南阳到深圳的机票	深圳到南阳的机票
闻喜到临汾高铁时刻表	临汾到闻喜高铁时刻表
武汉至石首商务车电话	石首至武汉商务车电话
台前到莘县的客车时刻表	莘县到台前的客车时刻表
如何把支付宝的钱转到余额宝	如何把余额宝的钱转到支付宝
崇州市到成都火车站怎么坐车	成都火车站到崇州市怎么坐车
枣庄到黄山高铁时刻表	黄山到枣庄高铁时刻表
西宁到沈阳飞机票查询	沈阳到西宁飞机票查询
哈尔滨到双城的客车	双城到哈尔滨的客车
榆中到兰州的车最早几点	兰州到榆中的车最早几点
太原到上海飞机航线图	上海到太原飞机航线图
学硕可以调剂到专硕吗	专硕可以调剂到学硕吗
深圳飞金边的航班时刻表	金边飞深圳的航班时刻表
小燕子什么时候从南方飞回北方	小燕子什么时候从北方飞回南方
齐齐哈尔到牡丹江快递几天	牡丹江到齐齐哈尔快递几天
益阳到深圳火车	深圳到益阳火车
邢台到济南汽车时刻表查询	济南到邢台汽车时刻表查询
西峰到崇信汽车时刻表	崇信到西峰汽车时刻表
深圳至长沙火车票	长沙至深圳火车票
西安至怀化火车时刻表	怀化至西安火车时刻表
户县到兴平班车	兴平到户县班车
商丘到廊坊的火车票	廊坊到商丘的火车票
义乌至武义	武义至义乌
北京去昆明需要隔离吗	昆明去北京需要隔离吗
盐城到潍坊高铁时刻表	潍坊到盐城高铁时刻表
邳州到盐城的火车时刻表	盐城到邳州的火车时刻表
小米到华为一键换机	华为到小米一键换机
武汉至京山火车	京山至武汉火车
上虞到义乌汽车时刻表	义乌到上虞汽车时刻表
珠海怎么去深圳	深圳怎么去珠海
彰武到锦州客车时刻表	锦州到彰武客车时刻表
荆州到南通	南通到荆州
沁阳到郑州汽车时刻表除汽车票查询	郑州到沁阳汽车时刻表除汽车票查询
上海到西雅图的机票	西雅图到上海的机票
徐州火车到邳州时刻表	邳州火车到徐州时刻表
台北至成都航班时刻表	成都至台北航班时刻表
锡林浩特到上海飞机	上海到锡林浩特飞机
瑞安到台州	台州到瑞安
福州到芒市	芒市到福州
遵化至唐山	唐山至遵化
重庆到金城江	金城江到重庆
佳木斯到青岛的火车	青岛到佳木斯的火车
成都至雅安客车时间表	雅安至成都客车时间表
小米音响搜不到蓝牙	小米蓝牙搜不到音响
金昌到新沂火车时刻表	新沂到金昌火车时刻表
商丘到民权汽车	民权到商丘汽车
巢湖到苏州的火车时刻表	苏州到巢湖的火车时刻表
温州到上海动车	上海到温州动车
盐城到淮安汽车	淮安到盐城汽车
达州到贵阳飞机	贵阳到达州飞机
支付宝可以转账到信用卡吗	信用卡可以转账到支付宝吗
浙江到广州需要隔离吗	广州到浙江需要隔离吗
北京到安康机票	安康到北京机票
苏州火车站到平江路	平江路到苏州火车站
合肥到淮安汽车时刻表	淮安到合肥汽车时刻表
广州飞盐城机票时刻表	盐城飞广州机票时刻表
长沙到株洲汽车时刻表查询	株洲到长沙汽车时刻表查询
齐齐哈尔到加格达奇的火车	加格达奇到齐齐哈尔的火车
潍坊到洛阳高铁时刻表查询	洛阳到潍坊高铁时刻表查询
商丘到无锡汽车票	无锡到商丘汽车票
通化至临江	临江至通化
扬州到南京不走高速怎么走	南京到扬州不走高速怎么走
成都到大足汽车时刻表查询	大足到成都汽车时刻表查询
北京到九华山	九华山到北京
诸暨到景德镇高铁时刻表	景德镇到诸暨高铁时刻表
喀什到长沙	长沙到喀什
信阳到舞阳	舞阳到信阳
淮安到泗阳火车	泗阳到淮安火车
亳州至宣城火车票	宣城至亳州火车票
重庆到海口机票价格查询	海口到重庆机票价格查询
攸县到衡阳高铁站	衡阳高铁站到攸县
天水南站到秦安高铁时刻表	秦安到天水南站高铁时刻表
兰州到拉萨自驾	拉萨到兰州自驾
兰州开车到西安几个小时	西安开车到兰州几个小时
自贡到井研汽车时刻表	井研到自贡汽车时刻表
杭州到九华山	九华山到杭州
南京到淮安的汽车时刻表	淮安到南京的汽车时刻表
巴中到万州火车时刻表	万州到巴中火车时刻表
泰安到黄山	黄山到泰安
南京到唐山的火车票	唐山到南京的火车票
上海社保可以转到江苏吗	江苏社保可以转到上海吗
葫芦岛至天津的火车票	天津至葫芦岛的火车票
扬州机场到仪征大巴	仪征到扬州机场大巴
济南至潍坊火车时刻表	潍坊至济南火车时刻表
天津到大连的船票	大连到天津的船票
宿迁至上海高铁时刻表	上海至宿迁高铁时刻表
九江到株洲火车时刻表查询	株洲到九江火车时刻表查询
兴隆县到承德的火车时刻表	承德到兴隆县的火车时刻表
太原至莱阳火车时刻表	莱阳至太原火车时刻表
瓦房店到菏泽火车时刻表	菏泽到瓦房店火车时刻表
女方提出离婚男方不同意	男方提出离婚女方不同意
巴南到沙坪坝	沙坪坝到巴南
重庆至杭州特价机票	杭州至重庆特价机票
怀化到重庆经过哪些站	重庆到怀化经过哪些站
