萧红带我回到身后的村庄的启示	萧红带我回到身后的村庄的启示
发烧可以开空调	发烧可以开空调
见闻vip怎么样	见闻vip怎么样
标志杆厂家六千二百六十六一七百八十八沧州胜翔实体厂家电话	标志杆厂家六千二百六十六一七百八十八沧州胜翔实体厂家电话
小狗活动的特点有哪些	小狗活动的特点有哪些
兰州汽车东站投诉电话	兰州汽车东站投诉电话
贵定到金华高铁票查询	贵定到金华高铁票查询
扎手指验血能验出是否怀孕么	扎手指验血能验出是否怀孕么
武警一个师有多少人	武警一个师有多少人
会不会有雨	会不会有雨
来月经可以吃海鲜	来月经可以吃海鲜
六十四加六十四	六十四加六十四
借酒消愁的伤感句子	借酒消愁的伤感句子
胃疼可以吃水果	胃疼可以吃水果
中华小子小龙被吸取青春是哪一集	中华小子小龙被吸取青春是哪一集
手撕牛肉的做法大全	手撕牛肉的做法大全
有什么好看的电影	有什么好看的电影
抗过敏药吃了会过敏吗	抗过敏药吃了会过敏吗
小孩能刮痧	小孩能刮痧
上航制服款式	上航制服款式
双重趋避冲突的例子三个	双重趋避冲突的例子三个
建行app在哪买原油	建行app在哪买原油
你会吹口哨吗	你会吹口哨吗
北京五环的房价是多少	北京五环的房价是多少
希戈艺术学校学费多少	希戈艺术学校学费多少
打开作业帮	打开作业帮
海曙可仁大药房电话	海曙可仁大药房电话
西山区第一中学升学率	西山区第一中学升学率
一活到老学到老老不服老画亦精字亦精两处处飞花飞处处	一活到老学到老老不服老画亦精字亦精两处处飞花飞处处
被召唤巨人是什么体验笔趣阁	被召唤巨人是什么体验笔趣阁
蟑螂会咬人	蟑螂会咬人
甲辰日怎样才能富贵	甲辰日怎样才能富贵
涤纶面料裤子夏天穿会不会热	涤纶面料裤子夏天穿会不会热
关掉音乐	关掉音乐
华为十点八寸的平板多少厘米	华为十点八寸的平板多少厘米
热敷消肿	热敷消肿
你知道是	你知道是
吗啡片多长时间起效	吗啡片多长时间起效
怀孕能吃生蚝	怀孕能吃生蚝
明日之后建筑怎么回收	明日之后建筑怎么回收
孕期能吃烧烤	孕期能吃烧烤
小叶增生可以喝豆浆	小叶增生可以喝豆浆
淘宝退货单号总是不正确	淘宝退货单号总是不正确
excel工作表sheet排序	excel工作表sheet排序
如何改wifi密码	如何改wifi密码
孕妇可以吃鸭肉	孕妇可以吃鸭肉
抖音里面的流行音乐怎么没有搜索到	抖音里面的流行音乐怎么没有搜索到
按哪个穴位可以缓解头晕	按哪个穴位可以缓解头晕
微波炉能做披萨	微波炉能做披萨
高血压能吃黄瓜	高血压能吃黄瓜
ar镀膜玻璃的	ar镀膜玻璃的
三加二减五	三加二减五
怀孕能吃蚬子	怀孕能吃蚬子
月经可以吃红枣	月经可以吃红枣
痛风能吃海带	痛风能吃海带
智能驾驶的功能	智能驾驶的功能
梦见已婚亲人再次结婚	梦见已婚亲人再次结婚
一次就会怀孕	一次就会怀孕
怎么开心呢	怎么开心呢
艾滋病身上会痒	艾滋病身上会痒
喝可乐上火	喝可乐上火
人流手术后能吃小龙虾吗	人流手术后能吃小龙虾吗
二十年工程院院士	二十年工程院院士
痛风可以吃红薯	痛风可以吃红薯
西曲溴铵与苯扎氯铵哪个更好	西曲溴铵与苯扎氯铵哪个更好
鹿晗和黄子韬张艺兴关系	鹿晗和黄子韬张艺兴关系
为什么结婚要门当户对	为什么结婚要门当户对
新西兰是澳大利亚的	新西兰是澳大利亚的
维生素e软胶囊吃了对人体有什么好处	维生素e软胶囊吃了对人体有什么好处
有什么游戏好玩的	有什么游戏好玩的
华为密码忘记了怎么手动刷机	华为密码忘记了怎么手动刷机
移动营业厅更改套餐	移动营业厅更改套餐
陈丹青关于祖国的言论	陈丹青关于祖国的言论
哺乳期可以喝板蓝根	哺乳期可以喝板蓝根
视频特效的功能	视频特效的功能
输卵管积水可以怀孕	输卵管积水可以怀孕
中秋节的月相是什么样的	中秋节的月相是什么样的
布洛芬吃下去多久后才有效果	布洛芬吃下去多久后才有效果
慢性胃炎能吃苹果	慢性胃炎能吃苹果
来月经可以吃阿胶	来月经可以吃阿胶
感冒发烧能吃橙子	感冒发烧能吃橙子
白带是排卵	白带是排卵
怎么挽回生意上的老客户	怎么挽回生意上的老客户
excel如何退出筛选	excel如何退出筛选
我是你大哥吗	我是你大哥吗
快走能减肥	快走能减肥
寿光摩托车驾驶证办理	寿光摩托车驾驶证办理
经营杠杆系数等一说明	经营杠杆系数等一说明
崩坏三开放世界等级	崩坏三开放世界等级
上海房产税如何征收	上海房产税如何征收
南京优秀的装饰公司	南京优秀的装饰公司
龙舟的身体是什么颜色的	龙舟的身体是什么颜色的
叶伏天和余生是什么关系	叶伏天和余生是什么关系
孕妇能吃芥末	孕妇能吃芥末
上海闯红灯一次保费上浮吗	上海闯红灯一次保费上浮吗
你会骂我吗	你会骂我吗
八公山服务区在哪里	八公山服务区在哪里
植物大战僵尸两原始坚果墙装扮怎么获得	植物大战僵尸两原始坚果墙装扮怎么获得
银渐层能长到多少斤	银渐层能长到多少斤
一千本金如何跟计划投	一千本金如何跟计划投
胆结石可以吃鸭蛋	胆结石可以吃鸭蛋
悬挑脚手架多少层验收一次	悬挑脚手架多少层验收一次
产妇能吃冬瓜	产妇能吃冬瓜
四股圆编口诀最简单	四股圆编口诀最简单
痛风可以吃海鲜	痛风可以吃海鲜
九价疫苗影响怀孕吗	九价疫苗影响怀孕吗
十一乘五十	十一乘五十
通辽的	通辽的
比比东的魂技是什么	比比东的魂技是什么
六乘八	六乘八
江南招行营业网点	江南招行营业网点
喝阿莫西林能喝酒	喝阿莫西林能喝酒
一百八十加一百八十	一百八十加一百八十
温州的邮编	温州的邮编
我要运动	我要运动
公民参与政治生活的基本要求是什么	公民参与政治生活的基本要求是什么
斐林试剂能鉴定淀粉吗	斐林试剂能鉴定淀粉吗
四乘八	四乘八
三十七度一算发烧	三十七度一算发烧
吃葡萄上火	吃葡萄上火
四十二乘二	四十二乘二
月经推迟十几天正常	月经推迟十几天正常
学生买的保险生病了可以报销吗	学生买的保险生病了可以报销吗
不吃晚饭可以减肥	不吃晚饭可以减肥
打开酷狗音乐并播放	打开酷狗音乐并播放
艾叶可以泡水喝	艾叶可以泡水喝
天津下雨了	天津下雨了
揉胸能变大	揉胸能变大
尿酸高能吃生蚝	尿酸高能吃生蚝
五十除十二	五十除十二
裸车十万上路得多少钱	裸车十万上路得多少钱
你认识王俊凯吗	你认识王俊凯吗
宁河滨江锦园物业电话	宁河滨江锦园物业电话
红外可见分光光度法	红外可见分光光度法
你的妈妈是谁	你的妈妈是谁
怎么跟异地跟老公聊色话题	怎么跟异地跟老公聊色话题
怀孕初期腹痛正常	怀孕初期腹痛正常
你是什么人	你是什么人
请问需要什么帮助	请问需要什么帮助
叫什么名字	叫什么名字
刘涛结婚了	刘涛结婚了
容易怀孕	容易怀孕
ace两的呼吸灯	ace两的呼吸灯
里巴巴如何开店	里巴巴如何开店
被骗二十块钱报警有用吗	被骗二十块钱报警有用吗
带心的名字女孩子名字	带心的名字女孩子名字
茄子会回奶	茄子会回奶
退出游戏	退出游戏
初霜和御剑仙女杯怎么区分	初霜和御剑仙女杯怎么区分
孔雀钻石画适合挂哪里	孔雀钻石画适合挂哪里
孕妇能吃黄桃	孕妇能吃黄桃
艾灸能天天做	艾灸能天天做
拉肚子能喝咖啡	拉肚子能喝咖啡
生物之间物质和能量的传递主要是通过	生物之间物质和能量的传递主要是通过
大连三十六中和四十八中哪个好	大连三十六中和四十八中哪个好
你有姐姐吗	你有姐姐吗
作易者其有忧患乎什么意思	作易者其有忧患乎什么意思
火影忍者哪一集是忍界大战	火影忍者哪一集是忍界大战
体检用挂号	体检用挂号
交通事故赔护理费怎么算	交通事故赔护理费怎么算
小布你会唱歌吗	小布你会唱歌吗
复方黄柏液涂剂可以坐浴吗	复方黄柏液涂剂可以坐浴吗
左脑缺血灶的最好治疗方法	左脑缺血灶的最好治疗方法
花呗是不是自动还款	花呗是不是自动还款
你的参数是多少	你的参数是多少
应届大学毕业生找工作时应当最看重什么才能在工作中找到持久的动力	应届大学毕业生找工作时应当最看重什么才能在工作中找到持久的动力
小葱素馅饺子怎么做	小葱素馅饺子怎么做
眼睛重影眯着眼看才正常	眼睛重影眯着眼看才正常
大肠息肉严重	大肠息肉严重
酷睿i五万四千五百七十配什么主板	酷睿i五万四千五百七十配什么主板
四川快乐十二开奖结果四川福彩快乐十二开奖结果	四川快乐十二开奖结果四川福彩快乐十二开奖结果
驾驶证扣分要本人去	驾驶证扣分要本人去
寿光摩托车驾驶证办理	寿光摩托车驾驶证办理
虎林到鸡西火车时刻表	虎林到鸡西火车时刻表
八公山服务区在哪里	八公山服务区在哪里
国内航班要护照	国内航班要护照
怎么不一样	怎么不一样
摄像头二百万和一千零八十p哪个好	摄像头二百万和一千零八十p哪个好
oppowatch防水	oppowatch防水
gay里面狗是什么意思	gay里面狗是什么意思
一百二十乘五	一百二十乘五
某工程项目有两个可供选择的方案	某工程项目有两个可供选择的方案
练单杠可以治疗腰椎间盘突出吗	练单杠可以治疗腰椎间盘突出吗
咸丰庚午年是哪一年	咸丰庚午年是哪一年
ipad无法卸载	ipad无法卸载
什么快快的四字词语	什么快快的四字词语
梅毒能治好	梅毒能治好
咦春雨到底是什么颜色的呢类似句	咦春雨到底是什么颜色的呢类似句
顺序启动实物接线图	顺序启动实物接线图
妊娠糖尿病可以吃南瓜	妊娠糖尿病可以吃南瓜
支气管炎会引起发烧	支气管炎会引起发烧
二十年应用心理学考研国家线	二十年应用心理学考研国家线
校花是男的女的	校花是男的女的
腿上有红圈怎么回事	腿上有红圈怎么回事
来大姨妈能洗头	来大姨妈能洗头
今天气温多少度	今天气温多少度
五菱荣光v中门中控锁安装	五菱荣光v中门中控锁安装
怀孕木耳能吃	怀孕木耳能吃
哺乳期能吃鸽子	哺乳期能吃鸽子
睡觉睡到一半突然左耳朵痛	睡觉睡到一半突然左耳朵痛
吉林有哪些	吉林有哪些
酵素的作用与功效	酵素的作用与功效
最具催眠效果的音乐	最具催眠效果的音乐
糖尿病人可以吃银耳	糖尿病人可以吃银耳
为什么抖音播放量是零	为什么抖音播放量是零
形容作爱感觉的词语	形容作爱感觉的词语
二十除二	二十除二
九月里的生日是什么星座	九月里的生日是什么星座
一百二十五乘八	一百二十五乘八
菠萝蜜吃了上火	菠萝蜜吃了上火
唇裂遗传	唇裂遗传
中山学校排名	中山学校排名
属龙女五月生好不好	属龙女五月生好不好
如何查找淘宝的淘气值	如何查找淘宝的淘气值
甲辰日怎样才能富贵	甲辰日怎样才能富贵
gta五自由视角怎么用	gta五自由视角怎么用
孕妇可以吃板栗	孕妇可以吃板栗
马达上面的齿轮怎么弄下来	马达上面的齿轮怎么弄下来
国产皮鞋品牌排行	国产皮鞋品牌排行
零点零一除零点一	零点零一除零点一
重庆金辉城花样派房价	重庆金辉城花样派房价
孕妇能吃可乐鸡翅	孕妇能吃可乐鸡翅
艨艟的意思是什么意思	艨艟的意思是什么意思
成长守护平台怎么转人工	成长守护平台怎么转人工
怀孕可以吃无花果干	怀孕可以吃无花果干
原核细胞有没有复杂的细胞器	原核细胞有没有复杂的细胞器
九月里的生日是什么星座	九月里的生日是什么星座
满五唯一能省多少钱	满五唯一能省多少钱
k五的价格	k五的价格
浙商银行的理财产品	浙商银行的理财产品
泰迪可以吃米饭	泰迪可以吃米饭
发什么快递	发什么快递
激光祛斑留疤	激光祛斑留疤
妊娠糖尿病可以吃小米粥	妊娠糖尿病可以吃小米粥
对数字化加工公司的建议	对数字化加工公司的建议
明天什么天气	明天什么天气
怀孕初期会头晕	怀孕初期会头晕
登高中揭出前文所蕴含的比兴	登高中揭出前文所蕴含的比兴
消化不良可以吃香蕉	消化不良可以吃香蕉
三月一是什么星座	三月一是什么星座
香蕉敷脸治红血丝吗	香蕉敷脸治红血丝吗
宫颈糜烂治好会复发吗	宫颈糜烂治好会复发吗
肺炎有少量胸腔积液不住院行吗	肺炎有少量胸腔积液不住院行吗
两个字聚财网名	两个字聚财网名
甲状腺胶质结节超声描述	甲状腺胶质结节超声描述
评价一下肖战	评价一下肖战
多根网线同时接一个猫	多根网线同时接一个猫
你叫什么名字来着	你叫什么名字来着
孕妇可以吃甘蔗	孕妇可以吃甘蔗
怀孕了可以纹眉	怀孕了可以纹眉
精油可以去痘印	精油可以去痘印
上古卷轴五黑暗兄弟会任务对直线有影响吗	上古卷轴五黑暗兄弟会任务对直线有影响吗
妊娠糖尿病可以吃南瓜	妊娠糖尿病可以吃南瓜
世界十大动物儿童电影排名	世界十大动物儿童电影排名
小布你喜欢谁	小布你喜欢谁
信用卡还重了怎么办	信用卡还重了怎么办
a四纸上站人科学原理	a四纸上站人科学原理
我家的wifi密码是多少	我家的wifi密码是多少
背诵有什么好处	背诵有什么好处
肾结石会影响怀孕	肾结石会影响怀孕
诺氟沙星治疗拉肚子	诺氟沙星治疗拉肚子
孕妇可以吃提子	孕妇可以吃提子
包钢钢业合肥有限责任公司怎么样	包钢钢业合肥有限责任公司怎么样
你能唱歌给我听吗	你能唱歌给我听吗
为什么来电之前先闪一下	为什么来电之前先闪一下
来月经可以吃辣椒	来月经可以吃辣椒
小龙虾的做法和绝密配方	小龙虾的做法和绝密配方
浦发银行可以绑定几个手机号码	浦发银行可以绑定几个手机号码
柠檬能减肥	柠檬能减肥
附近有什么奶茶店	附近有什么奶茶店
吃李子会胖	吃李子会胖
皮肤过敏能用牙膏擦吗	皮肤过敏能用牙膏擦吗
激光手术疼	激光手术疼
孕妇能吃冰棍	孕妇能吃冰棍
邢台货车通行证高峰期	邢台货车通行证高峰期
珍五金装与珍品珍酒哪个好	珍五金装与珍品珍酒哪个好
节约用水下一句怎么说	节约用水下一句怎么说
建行快贷服务电话	建行快贷服务电话
cubase如何设置midi键盘	cubase如何设置midi键盘
慢性肝病传染	慢性肝病传染
发芽大蒜能吃	发芽大蒜能吃
大连大学排名	大连大学排名
我们去哪里	我们去哪里
脂肪肝可以当兵	脂肪肝可以当兵
一除十五分之二	一除十五分之二
十五除七化成小数是多少	十五除七化成小数是多少
零乘零	零乘零
cad编组后不能解除编组	cad编组后不能解除编组
二百五十乘六十	二百五十乘六十
a九x的价格	a九x的价格
肾炎遗传	肾炎遗传
打开qq安全中心	打开qq安全中心
六百一十八别墅聚会轰趴馆怎么样	六百一十八别墅聚会轰趴馆怎么样
苏州浒墅关工商局电话	苏州浒墅关工商局电话
熊猫的脾气描写句子	熊猫的脾气描写句子
中暑会拉肚子	中暑会拉肚子
月经期可以吃逍遥丸	月经期可以吃逍遥丸
孕妇可以做足疗	孕妇可以做足疗
上海快三技巧	上海快三技巧
二十三乘五十	二十三乘五十
来月经可以喝奶茶	来月经可以喝奶茶
经期能吃羊肉	经期能吃羊肉
能组什么词	能组什么词
孕妇可以吃银耳	孕妇可以吃银耳
西安西三爻属于哪个区	西安西三爻属于哪个区
十堰的高铁什么时候开通	十堰的高铁什么时候开通
扁桃体发炎能吃杨梅	扁桃体发炎能吃杨梅
专业人员的培训费计入什么费用	专业人员的培训费计入什么费用
醉后不知天在水满船清梦压星河什么意思	醉后不知天在水满船清梦压星河什么意思
旅游促销方案怎么写	旅游促销方案怎么写
北大几个食堂	北大几个食堂
月经第一天恶心头晕乏力	月经第一天恶心头晕乏力
停车熄火正确的方法	停车熄火正确的方法
国庆节在十月一日用英语怎么说	国庆节在十月一日用英语怎么说
甲状腺结节能吃海带	甲状腺结节能吃海带
下雨天可以艾灸	下雨天可以艾灸
汽车故障码南京依维柯p00八十七	汽车故障码南京依维柯p00八十七
多高的身高可以扣篮	多高的身高可以扣篮
十二月初八是什么座	十二月初八是什么座
现代雅绅特变速箱加油口在哪	现代雅绅特变速箱加油口在哪
陕西的挂壁公路在哪里	陕西的挂壁公路在哪里
四个月泰迪吃什么牌子狗粮	四个月泰迪吃什么牌子狗粮
word怎么一键生成表格	word怎么一键生成表格
离过年还有几天	离过年还有几天
糖尿病能治好	糖尿病能治好
大疆灵眸电量持续多久	大疆灵眸电量持续多久
糖尿病能治好	糖尿病能治好
apple是什么意思	apple是什么意思
热感冒可以喝姜汤	热感冒可以喝姜汤
食用油过期能吃	食用油过期能吃
如果卫星通过k二十一地区的间隔时间服从指数分布	如果卫星通过k二十一地区的间隔时间服从指数分布
经期能喝茶	经期能喝茶
每天大便三次正常	每天大便三次正常
重庆银行渝中区网点分布	重庆银行渝中区网点分布
等边三角形有三个锐角对吗	等边三角形有三个锐角对吗
国产轮胎质量排名	国产轮胎质量排名
二十年西工大研究生复试名单	二十年西工大研究生复试名单
r十七屏幕价格	r十七屏幕价格
高血压能吃苦瓜	高血压能吃苦瓜
ip六十八防水等级	ip六十八防水等级
来月经可以吃火龙果	来月经可以吃火龙果
个人营业执照增项怎么办理	个人营业执照增项怎么办理
a九十二s包装清单	a九十二s包装清单
为什么眼睛总是睡不醒的感觉	为什么眼睛总是睡不醒的感觉
枝江顺丰快递的电话	枝江顺丰快递的电话
甲状腺结节能吃海带	甲状腺结节能吃海带
有朋友	有朋友
腰椎间盘突出能做仰卧起坐	腰椎间盘突出能做仰卧起坐
怎样走上人生巅峰	怎样走上人生巅峰
减肥晚上可以吃水果	减肥晚上可以吃水果
怎样输入英语单词之间的空格	怎样输入英语单词之间的空格
打开计算机	打开计算机
子宫肌瘤能吃红枣	子宫肌瘤能吃红枣
梦见买东西花钱是什么意思	梦见买东西花钱是什么意思
r十七pro后盖价格	r十七pro后盖价格
吃减肥药会反弹	吃减肥药会反弹
哺乳期能吃头孢克洛咀嚼片吗	哺乳期能吃头孢克洛咀嚼片吗
北京二十年棚改计划	北京二十年棚改计划
川大基础医学怎么样	川大基础医学怎么样
oppo手机支持无线充电	oppo手机支持无线充电
到此为止用文言文怎么说	到此为止用文言文怎么说
九十五年农历八月初三是什么星座	九十五年农历八月初三是什么星座
肚脐贴真的可以祛湿吗	肚脐贴真的可以祛湿吗
形容亲密写出与手有关的成语	形容亲密写出与手有关的成语
cctv节目官网	cctv节目官网
吸毒后感觉下面在流水	吸毒后感觉下面在流水
怎么知道枸杞有没有被硫磺熏过	怎么知道枸杞有没有被硫磺熏过
天上下来的人很多吗	天上下来的人很多吗
a加b的六次方	a加b的六次方
机器人搭建有什么好处	机器人搭建有什么好处
减肥塑形大套盒哪里有	减肥塑形大套盒哪里有
检查乙肝需要空腹	检查乙肝需要空腹
兰州有啥好玩的	兰州有啥好玩的
存在银行的钱不见了银行赔吗	存在银行的钱不见了银行赔吗
r十七proar测量功能	r十七proar测量功能
徐州到乌鲁木齐	徐州到乌鲁木齐
来大姨妈能喝咖啡	来大姨妈能喝咖啡
二十年五月suv汽车销量	二十年五月suv汽车销量
三十二除八	三十二除八
生津止渴的食物蜂蜜	生津止渴的食物蜂蜜
一直响铃然后直接挂了	一直响铃然后直接挂了
国家环境质量标准由哪里制定	国家环境质量标准由哪里制定
江宁男科多少钱就找金科	江宁男科多少钱就找金科
子宫内膜癌十年不复发	子宫内膜癌十年不复发
吃鸡灵敏度怎么调最稳苹果十一	吃鸡灵敏度怎么调最稳苹果十一
三点一四乘六十四	三点一四乘六十四
咳嗽可以吃香瓜	咳嗽可以吃香瓜
寂寞寂寞就好歌词是什么意思	寂寞寂寞就好歌词是什么意思
白癜风能吃黄瓜	白癜风能吃黄瓜
园洲中行电话号码是多少	园洲中行电话号码是多少
喝蜂蜜水减肥	喝蜂蜜水减肥
samuelmorse发明了什么	samuelmorse发明了什么
一百二十五乘四十	一百二十五乘四十
可以帮我打游戏吗	可以帮我打游戏吗
男生怎么样可以把自己的声音变好听	男生怎么样可以把自己的声音变好听
二十年江门最低工资标准	二十年江门最低工资标准
一直响铃然后直接挂了	一直响铃然后直接挂了
你爹是谁	你爹是谁
怀孕能吃生鱼片	怀孕能吃生鱼片
生育津贴差额是税前还是税后	生育津贴差额是税前还是税后
散热风扇发热什么原因	散热风扇发热什么原因
中美联合招考物理研究生项目	中美联合招考物理研究生项目
怀孕能吃茭白	怀孕能吃茭白
一个软件能否运行在两个不同厂家的cpu上	一个软件能否运行在两个不同厂家的cpu上
新生儿能喝葡萄糖	新生儿能喝葡萄糖
南京哪家医院治疗白癜风效果最好	南京哪家医院治疗白癜风效果最好
铁山港潮汐表	铁山港潮汐表
荔枝上火	荔枝上火
我能行吗	我能行吗
适合老年人玩的手机单机游戏	适合老年人玩的手机单机游戏
退出王者游戏	退出王者游戏
西曲溴铵与苯扎氯铵哪个更好	西曲溴铵与苯扎氯铵哪个更好
火龙果孕妇可以吃	火龙果孕妇可以吃
中老年适合什么工作	中老年适合什么工作
三点二十二千米等多少米	三点二十二千米等多少米
江苏师范大学有哪些专业怎么样	江苏师范大学有哪些专业怎么样
孕妇能吃生姜	孕妇能吃生姜
今天适合运动吗	今天适合运动吗
宣政院什么时候设立的	宣政院什么时候设立的
怀孕初期可以吃火锅	怀孕初期可以吃火锅
二十年安徽公务员职位	二十年安徽公务员职位
支付宝可以买火车票	支付宝可以买火车票
在职研究生算应届吗	在职研究生算应届吗
你喜欢鹿晗吗	你喜欢鹿晗吗
冬虫夏草和什么一起吃比较好	冬虫夏草和什么一起吃比较好
吸奶器可以开奶	吸奶器可以开奶
生姜发芽还能吃	生姜发芽还能吃
西山区第一中学升学率	西山区第一中学升学率
怎么加好友不让他知道我是谁	怎么加好友不让他知道我是谁
慢性胃炎可以吃益生菌	慢性胃炎可以吃益生菌
今天的天气怎么样	今天的天气怎么样
网络干是什么意思是什么	网络干是什么意思是什么
浙江到西安高铁需要多长时间	浙江到西安高铁需要多长时间
近视影响捐献眼角膜吗	近视影响捐献眼角膜吗
香蕉牛奶能一起吃	香蕉牛奶能一起吃
你会唱你笑起来真好看吗	你会唱你笑起来真好看吗
rapper是什么意思	rapper是什么意思
喝酒喝的是一种心情	喝酒喝的是一种心情
来月经可以吃木耳	来月经可以吃木耳
otg连接是什	otg连接是什
我国与发达国家在gdp上的差距说明了什么	我国与发达国家在gdp上的差距说明了什么
酒酿一定要烧熟了才能吃	酒酿一定要烧熟了才能吃
鼻咽癌可以治愈	鼻咽癌可以治愈
今天天气咋样	今天天气咋样
联想电脑已重置应用默认设置	联想电脑已重置应用默认设置
生理期可以吃芒果	生理期可以吃芒果
明天的天气怎么样	明天的天气怎么样
全国居民幸福指数排行	全国居民幸福指数排行
试管婴儿的小孩是不是都是很健康的	试管婴儿的小孩是不是都是很健康的
你这是什么歌	你这是什么歌
布洛芬吃下去多久后才有效果	布洛芬吃下去多久后才有效果
十到三十之间的合数	十到三十之间的合数
感冒可以吃生蚝	感冒可以吃生蚝
通州区政务大厅电话	通州区政务大厅电话
你有没有女朋友	你有没有女朋友
梦见抓到甲鱼又放生是什么意思	梦见抓到甲鱼又放生是什么意思
一百五十乘三十	一百五十乘三十
隔夜豆浆能喝	隔夜豆浆能喝
手电筒打不开怎么回事	手电筒打不开怎么回事
他长得帅吗	他长得帅吗
图片水印怎么去掉	图片水印怎么去掉
怀孕可以喝养乐多	怀孕可以喝养乐多
睡前可以喝蜂蜜水	睡前可以喝蜂蜜水
放疗可以报销	放疗可以报销
家里的灯关灯后有时会闪一下	家里的灯关灯后有时会闪一下
打电话给宝宝	打电话给宝宝
一世纪等多少个月	一世纪等多少个月
抓娃娃抓哪个部位好抓	抓娃娃抓哪个部位好抓
葡萄减肥可以吃	葡萄减肥可以吃
颈椎病能每天洗澡吗	颈椎病能每天洗澡吗
信用卡还重了怎么办	信用卡还重了怎么办
我是什么样的人	我是什么样的人
什么物流可以运活鸡	什么物流可以运活鸡
吴桥杂技大世界门票	吴桥杂技大世界门票
来月经能吃葡萄	来月经能吃葡萄
乙肝携带者传染	乙肝携带者传染
桥本甲状腺炎能吃海带	桥本甲状腺炎能吃海带
书籍的装订方法有哪些	书籍的装订方法有哪些
敷完面膜需要洗脸	敷完面膜需要洗脸
一砖多少金	一砖多少金
哺乳期可以喝蒲公英颗粒	哺乳期可以喝蒲公英颗粒
高考之后报什么学校好	高考之后报什么学校好
明天几度	明天几度
可以写文章的app	可以写文章的app
涤纶面料裤子夏天穿会不会热	涤纶面料裤子夏天穿会不会热
一繁体字是什么样的	一繁体字是什么样的
你喜欢吃什么	你喜欢吃什么
怎么不吃	怎么不吃
肺炎会传染吗	肺炎会传染吗
骨头坏死能治好	骨头坏死能治好
皇沃汽车是什么品牌	皇沃汽车是什么品牌
孕妇可以吃红薯粉	孕妇可以吃红薯粉
拔火罐可以减肥	拔火罐可以减肥
丰润区法院电话	丰润区法院电话
今天天气怎么样	今天天气怎么样
直升飞机的样子作用和特点	直升飞机的样子作用和特点
有什么赚钱的软件	有什么赚钱的软件
来月经能练瑜伽	来月经能练瑜伽
率土之滨三赛季九级地难度表	率土之滨三赛季九级地难度表
康乃馨送花一般送几朵	康乃馨送花一般送几朵
ct诊断是人工还是机器	ct诊断是人工还是机器
一百八十乘十五	一百八十乘十五
描写边塞将士的诗句	描写边塞将士的诗句
坐月子可以吃红枣	坐月子可以吃红枣
你空闲时间喜欢做什么英语	你空闲时间喜欢做什么英语
一百五十乘三十	一百五十乘三十
糖尿病可以吃黄瓜	糖尿病可以吃黄瓜
她最喜欢的科目用英语怎么写	她最喜欢的科目用英语怎么写
和平精英玛莎拉蒂可以隐藏吗	和平精英玛莎拉蒂可以隐藏吗
而应声答曰未闻孔雀是夫子家禽翻译成白话文	而应声答曰未闻孔雀是夫子家禽翻译成白话文
这个怎么读	这个怎么读
快递能寄液体	快递能寄液体
怎么把领带系成蝴蝶结	怎么把领带系成蝴蝶结
年代热水器t十二m三十七价格	年代热水器t十二m三十七价格
雀斑能去掉	雀斑能去掉
江苏师范大学有哪些专业怎么样	江苏师范大学有哪些专业怎么样
我可以帮你改名字吗	我可以帮你改名字吗
糖尿病能吃芒果	糖尿病能吃芒果
正弘国际小学好上吗	正弘国际小学好上吗
牧马人英文名英文单词	牧马人英文名英文单词
酸奶做出来很酸怎么办	酸奶做出来很酸怎么办
白面少红薯多可以做出馒头	白面少红薯多可以做出馒头
x平方减x减一等零	x平方减x减一等零
我老婆是猪	我老婆是猪
尿路感染会低烧	尿路感染会低烧
珍五金装与珍品珍酒哪个好	珍五金装与珍品珍酒哪个好
中药有副作用	中药有副作用
七十七年这年的高考不是在夏天而是在哪一天	七十七年这年的高考不是在夏天而是在哪一天
不吃米饭只吃菜能瘦	不吃米饭只吃菜能瘦
电脑如何打开ie浏览器	电脑如何打开ie浏览器
赣州高层次人才引进实施办法	赣州高层次人才引进实施办法
招行实习工资	招行实习工资
徐州到宿州火车票	徐州到宿州火车票
电池会爆炸	电池会爆炸
你是男还是女	你是男还是女
睡眠障碍最常见的是	睡眠障碍最常见的是
桂林有蜂鸟众包	桂林有蜂鸟众包
你会说方言吗	你会说方言吗
猫粮自己做怎么配方	猫粮自己做怎么配方
华为无线路由如何恢复出厂设置	华为无线路由如何恢复出厂设置
经期可以喝逍遥丸	经期可以喝逍遥丸
腹泻可以喝蜂蜜水	腹泻可以喝蜂蜜水
怎么知道自己是什么原因引起的肥胖	怎么知道自己是什么原因引起的肥胖
怀孕肚子硬	怀孕肚子硬
塔一般放在家的哪里好	塔一般放在家的哪里好
刘涛和李小冉合作的电视剧	刘涛和李小冉合作的电视剧
健的大写字母怎么写	健的大写字母怎么写
江南招行营业网点	江南招行营业网点
咱们聪明	咱们聪明
读完上海戏剧学院要多少钱	读完上海戏剧学院要多少钱
苹果手机怎么删除id帐号	苹果手机怎么删除id帐号
人为什么要活着	人为什么要活着
一般纳税人可以使用普通发票吗	一般纳税人可以使用普通发票吗
吉林花卉养殖基地	吉林花卉养殖基地
一个人吃午饭的心情	一个人吃午饭的心情
乙肝大三阳传染	乙肝大三阳传染
串钩用什么线不缠绕	串钩用什么线不缠绕
感冒了能吃冰激凌	感冒了能吃冰激凌
哺乳期能拔智齿	哺乳期能拔智齿
大姨妈期间可以拔牙	大姨妈期间可以拔牙
五菱荣光v中门中控锁安装	五菱荣光v中门中控锁安装
人为什么会做梦	人为什么会做梦
消费者权益保护宣传标语	消费者权益保护宣传标语
石家庄四院上班时间	石家庄四院上班时间
中山几个区	中山几个区
九年的二手车能卖多少	九年的二手车能卖多少
我是谁你是谁	我是谁你是谁
怀孕初期可以吃辣条	怀孕初期可以吃辣条
怀孕能吃面包	怀孕能吃面包
跳绳一小时消耗的热量	跳绳一小时消耗的热量
计算机二级是nit还是ncre	计算机二级是nit还是ncre
神经衰弱能治愈	神经衰弱能治愈
海边欢快的歌曲有哪些	海边欢快的歌曲有哪些
不来月经垫卫生巾的坏处	不来月经垫卫生巾的坏处
节日前面的the要不要大写	节日前面的the要不要大写
快乐男声李炜现在在干嘛	快乐男声李炜现在在干嘛
积分在哪里兑换	积分在哪里兑换
涿州翡翠华府最新房价	涿州翡翠华府最新房价
朱茵结婚了	朱茵结婚了
榴莲的果子可以吃吗	榴莲的果子可以吃吗
土豆属于发物	土豆属于发物
我没有钱吃饭了	我没有钱吃饭了
妊娠糖尿病可以喝绿豆汤	妊娠糖尿病可以喝绿豆汤
怎么查残疾证被公司套用	怎么查残疾证被公司套用
包钢钢业合肥有限责任公司怎么样	包钢钢业合肥有限责任公司怎么样
小时候玩过的玩具有什么	小时候玩过的玩具有什么
学校户口属于什么性质	学校户口属于什么性质
在重庆买的医保在贵州可以使用么	在重庆买的医保在贵州可以使用么
黑咖啡可以减肥	黑咖啡可以减肥
这个怎么读	这个怎么读
现代雅绅特变速箱加油口在哪	现代雅绅特变速箱加油口在哪
狐臭遗传	狐臭遗传
驿站大概是什么意思	驿站大概是什么意思
五十乘七十	五十乘七十
小布打开颜色反转	小布打开颜色反转
不是不是	不是不是
女主强大男主宠的小说	女主强大男主宠的小说
色弱可以考驾照	色弱可以考驾照
花甲的形状是什么样子	花甲的形状是什么样子
打车会传染冠状病毒吗	打车会传染冠状病毒吗
防蓝光眼镜哪个牌子最好	防蓝光眼镜哪个牌子最好
fast是什么意思	fast是什么意思
三十厘米等多少立方厘米	三十厘米等多少立方厘米
沃尔沃最贵的是哪一款价格	沃尔沃最贵的是哪一款价格
来月经可以吃生蚝	来月经可以吃生蚝
九十四年十月初八是什么命	九十四年十月初八是什么命
孕妇餐后一小时血糖正常值	孕妇餐后一小时血糖正常值
一除三	一除三
你会一直在	你会一直在
脂肪肝可以买健康险吗	脂肪肝可以买健康险吗
你有朋友	你有朋友
孕妇可以吃鸡公	孕妇可以吃鸡公
相提什么什么救人四字成语	相提什么什么救人四字成语
做完人流可以敷面膜	做完人流可以敷面膜
怎么样看孩子有没有发育	怎么样看孩子有没有发育
投诉电话	投诉电话
淋巴细胞低是艾滋病	淋巴细胞低是艾滋病
你是谁的主人	你是谁的主人
工行算商业银行	工行算商业银行
凯美瑞新车味道散不掉	凯美瑞新车味道散不掉
如何加快手机充电	如何加快手机充电
你怎么这么笨	你怎么这么笨
oppo怎么投屏	oppo怎么投屏
肾结石能吃鸡蛋	肾结石能吃鸡蛋
彩票店赚钱	彩票店赚钱
哺乳期可以喝酵素	哺乳期可以喝酵素
莒南跑临沂客车时刻表	莒南跑临沂客车时刻表
玩一会儿	玩一会儿
天津哪儿卖电动缝纫机	天津哪儿卖电动缝纫机
你的智商有多高	你的智商有多高
怀孕初期可以吃金针菇	怀孕初期可以吃金针菇
给娃喂奶可以吃香菜木耳吗	给娃喂奶可以吃香菜木耳吗
鸡腿怎么做不油腻还好吃	鸡腿怎么做不油腻还好吃
可以带发修行的寺庙	可以带发修行的寺庙
什么不什么手成语有哪些	什么不什么手成语有哪些
蚕宝宝生长需要什么条件	蚕宝宝生长需要什么条件
脂肪肝可以买健康险吗	脂肪肝可以买健康险吗
零点一五化成分数	零点一五化成分数
小孩能吃榴莲	小孩能吃榴莲
月经期间可以喝首乌吗	月经期间可以喝首乌吗
她怎么不说话	她怎么不说话
导函数大于等零说明什么	导函数大于等零说明什么
负一减一	负一减一
剖腹产盆底肌训练什么时候开始	剖腹产盆底肌训练什么时候开始
宝宝拉肚子能吃酸奶	宝宝拉肚子能吃酸奶
什么是人生最早出现的认识过程是其他认识过程的基础	什么是人生最早出现的认识过程是其他认识过程的基础
七号房的礼物exo	七号房的礼物exo
五十岁男脸上长黑斑了怎么办	五十岁男脸上长黑斑了怎么办
运动可以减肥	运动可以减肥
孕妇可以吃料酒	孕妇可以吃料酒
怎么置换	怎么置换
不射进去会怀孕	不射进去会怀孕
闲鱼芝麻信用未授权的买家	闲鱼芝麻信用未授权的买家
电子厂学徒工资多少	电子厂学徒工资多少
pubg可以家庭共享吗	pubg可以家庭共享吗
心绞痛动态心电图能查到吗	心绞痛动态心电图能查到吗
九百除三	九百除三
四川快乐十二开奖结果四川福彩快乐十二开奖结果	四川快乐十二开奖结果四川福彩快乐十二开奖结果
来月经能练瑜伽	来月经能练瑜伽
上眼皮长斑是怎么回事	上眼皮长斑是怎么回事
角声满天秋色里前一句	角声满天秋色里前一句
你是谁呀	你是谁呀
粤省事粤康码小孩子怎么申请	粤省事粤康码小孩子怎么申请
阅读心电图的基本流程	阅读心电图的基本流程
明天有太阳吗	明天有太阳吗
汉赋九问兰草八章作者	汉赋九问兰草八章作者
不睡枕头好	不睡枕头好
吃雪糕的声音	吃雪糕的声音
cad制图倒圆角怎么画	cad制图倒圆角怎么画
评价一下王源	评价一下王源
胃病会传染吗	胃病会传染吗
感冒可以拔罐	感冒可以拔罐
教学过程流程图的基本内容	教学过程流程图的基本内容
来例假能喝茶	来例假能喝茶
糖尿病人可以吃辣椒	糖尿病人可以吃辣椒
武警一个师有多少人	武警一个师有多少人
什么属于大变局中存在的风险	什么属于大变局中存在的风险
高血压能吃带鱼	高血压能吃带鱼
打开酷狗音乐	打开酷狗音乐
血压一百四十正常	血压一百四十正常
四字人生哲理	四字人生哲理
直面惨淡的人生什么意思	直面惨淡的人生什么意思
肝癌可以治愈	肝癌可以治愈
玉米可以微波炉烤吗	玉米可以微波炉烤吗
狗可以吃冰棒	狗可以吃冰棒
重庆高校分数线排名	重庆高校分数线排名
oppo手环设置夜间模式	oppo手环设置夜间模式
询盘三天内回复旺旺几小时内回复的算及时回复率	询盘三天内回复旺旺几小时内回复的算及时回复率
复方氢氧化铝片孕妇可以吃	复方氢氧化铝片孕妇可以吃
泰迪能吃豌豆	泰迪能吃豌豆
胆结石能不能喝雪碧	胆结石能不能喝雪碧
减肥可以吃牛油果	减肥可以吃牛油果
四米高的房子可以做阁楼吗	四米高的房子可以做阁楼吗
oppo怎么刷机	oppo怎么刷机
蒲公英能长期喝	蒲公英能长期喝
otg连接的功能	otg连接的功能
正弘国际小学好上吗	正弘国际小学好上吗
五度白醋是什么意思	五度白醋是什么意思
孕妇能吃皮皮虾	孕妇能吃皮皮虾
师尊黑化的腹黑徒弟小说	师尊黑化的腹黑徒弟小说
皮肤有油脂粒怎么去除	皮肤有油脂粒怎么去除
你在玩什么游戏	你在玩什么游戏
练习本的长约两什么	练习本的长约两什么
她最喜欢的科目用英语怎么写	她最喜欢的科目用英语怎么写
王者梦魇的属性	王者梦魇的属性
孕妇能吃玉米	孕妇能吃玉米
苹果官方回收价格查询在哪里	苹果官方回收价格查询在哪里
多高的身高可以扣篮	多高的身高可以扣篮
你是oppo什么型号	你是oppo什么型号
中信信用卡被系统锁定	中信信用卡被系统锁定
猜我现在在干嘛	猜我现在在干嘛
辣条的热量高	辣条的热量高
怀孕能吃大蒜	怀孕能吃大蒜
一开始虐女主后来宠的小说	一开始虐女主后来宠的小说
鸡腿怎么做不油腻还好吃	鸡腿怎么做不油腻还好吃
青岛城区常住人口	青岛城区常住人口
浦发银行可以绑定几个手机号码	浦发银行可以绑定几个手机号码
四十亿零八百零三万零六百九十五这电话正规吗	四十亿零八百零三万零六百九十五这电话正规吗
卡超级加倍什么意思	卡超级加倍什么意思
从小不发烧是好事还是坏事	从小不发烧是好事还是坏事
本来不痒用完硝呋太尔特别痒怎么办	本来不痒用完硝呋太尔特别痒怎么办
三百六十除九	三百六十除九
副处级干部几年后升正处	副处级干部几年后升正处
我是不是天下第一美少女	我是不是天下第一美少女
红斑狼疮会痒	红斑狼疮会痒
怎样关闭豪华黄钻自动续费	怎样关闭豪华黄钻自动续费
昆明离阜阳有多远	昆明离阜阳有多远
iphone十一自动免提怎么关闭	iphone十一自动免提怎么关闭
鸡蛋豆浆能一起吃	鸡蛋豆浆能一起吃
肩周炎是什么症状	肩周炎是什么症状
姨妈快没了但是又来了	姨妈快没了但是又来了
支付宝通讯物流怎么关	支付宝通讯物流怎么关
河南八年级什么时候开学	河南八年级什么时候开学
肺炎有少量胸腔积液不住院行吗	肺炎有少量胸腔积液不住院行吗
来月经可以吃西洋参	来月经可以吃西洋参
党的十八大提出的两个一百年的奋斗目标指的是	党的十八大提出的两个一百年的奋斗目标指的是
三点双眼皮是永久的	三点双眼皮是永久的
农行怎么注册网上银行	农行怎么注册网上银行
明天多少度啊	明天多少度啊
风神h三十自动挡怎么样	风神h三十自动挡怎么样
白酒加公牛是什么意思	白酒加公牛是什么意思
在五月翻译	在五月翻译
身体虚弱腰疼怎么调理	身体虚弱腰疼怎么调理
能帮我打王者吗	能帮我打王者吗
怀孕能用化妆品	怀孕能用化妆品
颈椎病会引起头晕	颈椎病会引起头晕
减肥可以吃西瓜	减肥可以吃西瓜
荷叶茶能减肥	荷叶茶能减肥
工行etc信用卡怎么样	工行etc信用卡怎么样
希戈艺术学校学费多少	希戈艺术学校学费多少
生孩子的苦怎么表达	生孩子的苦怎么表达
波司登羽绒服公司在哪里	波司登羽绒服公司在哪里
北京甲状腺最好的医院	北京甲状腺最好的医院
处女膜没破会怀孕	处女膜没破会怀孕
快递能寄液体	快递能寄液体
广陵世家二手房价	广陵世家二手房价
东莞苹果官方售后维修点	东莞苹果官方售后维修点
来月经能吃生蚝	来月经能吃生蚝
为什么睡觉会打呼噜	为什么睡觉会打呼噜
颈椎病能每天洗澡吗	颈椎病能每天洗澡吗
沈阳三好街农行电话	沈阳三好街农行电话
艾灸可以天天灸	艾灸可以天天灸
月经来了可以喝可乐	月经来了可以喝可乐
世卫组织官员国籍	世卫组织官员国籍
糜烂性直肠炎灌肠用什么药	糜烂性直肠炎灌肠用什么药
二千零一十九款日产骊威什么时候能国产	二千零一十九款日产骊威什么时候能国产
无锡海鲜批发市场在哪里	无锡海鲜批发市场在哪里
怎么说的	怎么说的
小孩换牙是全换	小孩换牙是全换
艾滋病有治愈的	艾滋病有治愈的
孕妇吃橘子好	孕妇吃橘子好
男朋友是用来干嘛的	男朋友是用来干嘛的
毕业论文署名怎么写	毕业论文署名怎么写
乙肝表面抗体阳性正常	乙肝表面抗体阳性正常
昂科威倒车镜怎么拆	昂科威倒车镜怎么拆
尚品雪花粉是什么面粉	尚品雪花粉是什么面粉
怀孕后手掌周围红中间白	怀孕后手掌周围红中间白
家用暖气循环泵安装在什么位置合适	家用暖气循环泵安装在什么位置合适
老年人喉咙喘气有声音猫叫	老年人喉咙喘气有声音猫叫
渭南的大学	渭南的大学
三月是什么节气	三月是什么节气
怎么加好友不让他知道我是谁	怎么加好友不让他知道我是谁
经常有口臭是什么原因	经常有口臭是什么原因
华为mate二十铃声渐强怎么设置	华为mate二十铃声渐强怎么设置
扁桃体能切除	扁桃体能切除
六十六除六	六十六除六
桥本氏甲减会遗传	桥本氏甲减会遗传
三百六十乘十五	三百六十乘十五
迷你牛奶盲盒的制作方法	迷你牛奶盲盒的制作方法
乳房疼痛有哪些情况	乳房疼痛有哪些情况
太原康复机构天使比较好	太原康复机构天使比较好
洒布沥青材料时气温不应低于	洒布沥青材料时气温不应低于
肠胃炎可以喝蜂蜜水	肠胃炎可以喝蜂蜜水
导致九十八年长江洪水泛滥的主要原因是什么	导致九十八年长江洪水泛滥的主要原因是什么
糖尿病能吃荞麦挂面	糖尿病能吃荞麦挂面
车内显示屏可以看电视吗	车内显示屏可以看电视吗
建行app登录信息不正确	建行app登录信息不正确
发烧可以吹空调	发烧可以吹空调
都安到南宁拼车顺风车群	都安到南宁拼车顺风车群
重庆迈科唯待遇怎么样	重庆迈科唯待遇怎么样
加速度传感器的	加速度传感器的
十二律名和对应的现代名	十二律名和对应的现代名
白化病是遗传病	白化病是遗传病
怀孕可以吃麻油	怀孕可以吃麻油
骨折可以吃生蚝	骨折可以吃生蚝
鼻子干痒一扣就流鼻血	鼻子干痒一扣就流鼻血
脸上补水用什么牌子的好	脸上补水用什么牌子的好
甲辰日怎样才能富贵	甲辰日怎样才能富贵
上古卷轴五拉罗夫在哪	上古卷轴五拉罗夫在哪
五gcpet一支持的频段	五gcpet一支持的频段
有没有好玩的游戏	有没有好玩的游戏
八乘九	八乘九
珠海皮肤疾病的医院	珠海皮肤疾病的医院
刚来完月经是安全期	刚来完月经是安全期
七十六年的龙一生命运如何	七十六年的龙一生命运如何
屁股大用英文怎么说	屁股大用英文怎么说
白化病是遗传病	白化病是遗传病
二十年建行大额存单利率	二十年建行大额存单利率
柠檬水可以美白	柠檬水可以美白
abab式的词语有哪些	abab式的词语有哪些
洒布沥青材料时气温不应低于	洒布沥青材料时气温不应低于
怀孕胸会变大	怀孕胸会变大
排球教练郎平多大岁数	排球教练郎平多大岁数
打完hpv九价可以吃辣吗	打完hpv九价可以吃辣吗
苹果手机打开热点电脑连不上网怎么办	苹果手机打开热点电脑连不上网怎么办
杜鹃花可以净化空气吗	杜鹃花可以净化空气吗
是谁我是谁	是谁我是谁
怎么预防膝盖滑膜炎	怎么预防膝盖滑膜炎
十四乘五	十四乘五
怀孕初期能吃榴莲	怀孕初期能吃榴莲
无网络连接请连接网络后重试	无网络连接请连接网络后重试
龙泉驿长	龙泉驿长
来大姨妈能喝咖啡	来大姨妈能喝咖啡
月经来了可以喝可乐	月经来了可以喝可乐
ibm上海年薪	ibm上海年薪
月经突然提前六天怎么回事	月经突然提前六天怎么回事
孕妇可以吃海带	孕妇可以吃海带
两个月宝宝下颚有白点	两个月宝宝下颚有白点
qq网名女生有特殊符号	qq网名女生有特殊符号
离骚体现了什么情感	离骚体现了什么情感
那个人是谁	那个人是谁
艾灸可以去湿气	艾灸可以去湿气
crv本田二千零一十九款导航怎么关闭	crv本田二千零一十九款导航怎么关闭
你会些什么	你会些什么
佛堂里能不能放活人的照片	佛堂里能不能放活人的照片
游戏账号怎么找回	游戏账号怎么找回
孕晚期能吃花甲	孕晚期能吃花甲
电视无法接收遥控器信号是什么原因	电视无法接收遥控器信号是什么原因
豆芽发芽了还能吃	豆芽发芽了还能吃
月经期可以减肥	月经期可以减肥
有人工客服么	有人工客服么
科二约了几天可以看见结果	科二约了几天可以看见结果
来大姨妈可以洗澡	来大姨妈可以洗澡
感冒能吃芒果	感冒能吃芒果
酸汤子的做法视频教程	酸汤子的做法视频教程
痘痘留下的黑点怎么办	痘痘留下的黑点怎么办
六十乘十五	六十乘十五
committee的意思中文翻译	committee的意思中文翻译
梦见自己的亲姨妈死了	梦见自己的亲姨妈死了
小米八什么时候能更新miui十二	小米八什么时候能更新miui十二
一分米长的物体有什么	一分米长的物体有什么
大众suv车型大全斯柯达十万	大众suv车型大全斯柯达十万
今天天气咋样	今天天气咋样
玉米糖分高	玉米糖分高
安徽取消一次性奖励	安徽取消一次性奖励
甲硝唑副作用大	甲硝唑副作用大
成都到昆山多少公里	成都到昆山多少公里
一美金多少人民币	一美金多少人民币
抽烟喝酒对怀孕有影响	抽烟喝酒对怀孕有影响
肝硬化可以治愈	肝硬化可以治愈
注册公司需要u盾	注册公司需要u盾
从国内寄快递到伦敦多少钱	从国内寄快递到伦敦多少钱
经常性尿黄味道大是什么原因	经常性尿黄味道大是什么原因
nfc怎么开启	nfc怎么开启
坐月子可以吃饼干	坐月子可以吃饼干
痛风病人能吃海带	痛风病人能吃海带
你有女朋友吗	你有女朋友吗
表达对妈妈爱的成语	表达对妈妈爱的成语
五岁小儿的正常血压约为	五岁小儿的正常血压约为
来月经可以吃韭菜	来月经可以吃韭菜
怀孕初期可以吃大蒜	怀孕初期可以吃大蒜
喝水可以治疗感冒吗	喝水可以治疗感冒吗
幸运飞艇微信群那里有天香威三百三十九万一千八百四十一	幸运飞艇微信群那里有天香威三百三十九万一千八百四十一
小孩缺乏生长激素必须要打吗	小孩缺乏生长激素必须要打吗
你认识小威吗	你认识小威吗
假性湿疣会自己消失	假性湿疣会自己消失
上火能吃橙子	上火能吃橙子
眼睛里面一眨眼就疼	眼睛里面一眨眼就疼
糖尿病能喝无糖可乐	糖尿病能喝无糖可乐
计量经济学的应用包括哪几方面	计量经济学的应用包括哪几方面
充足的近义词可以是足够吗	充足的近义词可以是足够吗
你是美女还是帅哥	你是美女还是帅哥
慢性咽炎会自己好	慢性咽炎会自己好
奶粉过期还能喝	奶粉过期还能喝
孕妇能用皮炎平	孕妇能用皮炎平
你会讲笑话吗	你会讲笑话吗
朝阳界限	朝阳界限
哺乳期可以打乙肝疫苗	哺乳期可以打乙肝疫苗
生理期能喝茶	生理期能喝茶
三十加三十	三十加三十
你能帮我打王者吗	你能帮我打王者吗
现任文山市公安局局长	现任文山市公安局局长
宝宝鼻炎鼻塞晚上严重怎么办	宝宝鼻炎鼻塞晚上严重怎么办
孕妇可以吃鸭爪	孕妇可以吃鸭爪
表示两者之间的介词	表示两者之间的介词
慢半拍的情敌是什么意思	慢半拍的情敌是什么意思
电热毯有辐射	电热毯有辐射
你有几个孩子	你有几个孩子
孕妇能吃卤味	孕妇能吃卤味
为确保设计和开发的输出满足输入的要求应进行	为确保设计和开发的输出满足输入的要求应进行
你长什么样	你长什么样
哈尔滨正义街的位置	哈尔滨正义街的位置
吃黄瓜可以减肥	吃黄瓜可以减肥
急性咽炎严重了会怎么样	急性咽炎严重了会怎么样
你叫什么	你叫什么
甲亢可以吃海带	甲亢可以吃海带
天津台球厅营业了吗	天津台球厅营业了吗
鸡眼会自己好	鸡眼会自己好
经过一个角的顶点引这个角所在平面的斜线	经过一个角的顶点引这个角所在平面的斜线
你可真有意思	你可真有意思
鼻梁上有鸡皮疙瘩一样的小痘怎么办	鼻梁上有鸡皮疙瘩一样的小痘怎么办
科目二如何在考场买圈	科目二如何在考场买圈
几除几等零	几除几等零
世界上最美的女人是谁	世界上最美的女人是谁
能组什么词	能组什么词
四匹一拖三中央空调费电吗	四匹一拖三中央空调费电吗
盆腔积液会影响怀孕	盆腔积液会影响怀孕
月经期可以喝益母草	月经期可以喝益母草
来例假可以吃橘子	来例假可以吃橘子
靠近厨房的地板油烟怎么处理	靠近厨房的地板油烟怎么处理
放了三个月的烟还能抽吗	放了三个月的烟还能抽吗
发到微信群里的图片怎么撤回	发到微信群里的图片怎么撤回
孕妇能喝柠檬蜂蜜水	孕妇能喝柠檬蜂蜜水
圆形和水滴形做出来	圆形和水滴形做出来
没有插入会怀孕	没有插入会怀孕
荣耀日历怎么设置生日提醒	荣耀日历怎么设置生日提醒
五系百公里加速几秒	五系百公里加速几秒
三点一四乘零点二五	三点一四乘零点二五
别人问为什么把他删了	别人问为什么把他删了
rh血型阳性是什么意思	rh血型阳性是什么意思
四角粽子做法	四角粽子做法
植物神经紊乱可以自愈	植物神经紊乱可以自愈
电脑如何打开ie浏览器	电脑如何打开ie浏览器
鼻子干痒一扣就流鼻血	鼻子干痒一扣就流鼻血
满城尽带黄金甲在哪儿拍的	满城尽带黄金甲在哪儿拍的
一万除一万	一万除一万
衡水中学在临汾选址	衡水中学在临汾选址
邵阳内景点排名大全	邵阳内景点排名大全
一除三	一除三
火柴人战争作者是谁	火柴人战争作者是谁
宁波一院口腔科专家	宁波一院口腔科专家
香蕉和牛奶可以一起吃	香蕉和牛奶可以一起吃
故宫周一为什么要闭馆	故宫周一为什么要闭馆
蓝莓酱要熬多长时间	蓝莓酱要熬多长时间
故障灯用解码器解码后还亮	故障灯用解码器解码后还亮
怎么使用oppo互传	怎么使用oppo互传
燕麦回奶	燕麦回奶
猫能吃方便面	猫能吃方便面
牛奶和酒能一起喝	牛奶和酒能一起喝
六十岁能不能办银行卡	六十岁能不能办银行卡
手机上定位怎么关不了	手机上定位怎么关不了
农村户口可以买社保	农村户口可以买社保
吃完药能喝牛奶	吃完药能喝牛奶
月经前白带会多	月经前白带会多
整数乘法的方法是什么	整数乘法的方法是什么
宁波一院口腔科专家	宁波一院口腔科专家
为什么生完孩子身体变宽了	为什么生完孩子身体变宽了
春回大地风光好下联	春回大地风光好下联
用英语怎么读	用英语怎么读
例假前白带会增多	例假前白带会增多
唐山在哪	唐山在哪
迁移动宽带要怎么办理流程	迁移动宽带要怎么办理流程
贵阳鸿通城是什么时候开业的	贵阳鸿通城是什么时候开业的
剖腹产第三天吃什么好	剖腹产第三天吃什么好
肝硬化有什么症状	肝硬化有什么症状
你能干啥	你能干啥
我爸叫什么	我爸叫什么
肾结石患者可以吃南瓜	肾结石患者可以吃南瓜
每天晚上跑步能减肥	每天晚上跑步能减肥
超人和奔腾剃须刀哪个好	超人和奔腾剃须刀哪个好
oppo手机是哪个国家的	oppo手机是哪个国家的
双重趋避冲突的例子三个	双重趋避冲突的例子三个
成吉思汗三技能怎么用	成吉思汗三技能怎么用
公文的成文时间使用	公文的成文时间使用
吃头孢可以喝啤酒	吃头孢可以喝啤酒
新生婴儿睡觉时抽搐	新生婴儿睡觉时抽搐
从二百到二百一十五分针旋转了多少度	从二百到二百一十五分针旋转了多少度
怎样输入英语单词之间的空格	怎样输入英语单词之间的空格
售后换屏需要手工费嘛	售后换屏需要手工费嘛
二百加三百	二百加三百
星座解释用的什么定律	星座解释用的什么定律
abb写词语	abb写词语
你没有眼睛	你没有眼睛
融洽的词语	融洽的词语
你有女朋友了吗	你有女朋友了吗
唐军叶龙是什么电视	唐军叶龙是什么电视
十二律名和对应的现代名	十二律名和对应的现代名
川大是不是重本	川大是不是重本
我的oppo账号	我的oppo账号
慢性肾炎会遗传	慢性肾炎会遗传
中药一钱等多少克	中药一钱等多少克
番茄可以和豆奶一起吃吗	番茄可以和豆奶一起吃吗
六乘九	六乘九
根据刑法的规定年满周岁以上的人开始承担刑事责任	根据刑法的规定年满周岁以上的人开始承担刑事责任
客服电话	客服电话
时迟那时快是什么意思	时迟那时快是什么意思
肥西上派镇邮政编码	肥西上派镇邮政编码
千兆网可以用七类线吗	千兆网可以用七类线吗
领导上海工人第三次武装起义的人是	领导上海工人第三次武装起义的人是
九百一十除十四	九百一十除十四
坐地铁恶心呼吸不上来	坐地铁恶心呼吸不上来
十六岁还没有须佐能乎正常吗	十六岁还没有须佐能乎正常吗
没有反应	没有反应
屁股大用英文怎么说	屁股大用英文怎么说
子宫肌瘤需要做手术	子宫肌瘤需要做手术
怀孕初期可以吃生蚝	怀孕初期可以吃生蚝
肾结石可以吃橘子	肾结石可以吃橘子
巨蟹座和天蝎座配	巨蟹座和天蝎座配
孕妇能吃橙子	孕妇能吃橙子
孕妇可以吃炒黄瓜	孕妇可以吃炒黄瓜
长城m四变速箱油多久更换一次	长城m四变速箱油多久更换一次
你为什么不跟我聊天	你为什么不跟我聊天
联盟等级框过多少级变一下	联盟等级框过多少级变一下
形容林徽因的成语有哪些	形容林徽因的成语有哪些
护士未来职业生涯规划	护士未来职业生涯规划
成都公办二本院校	成都公办二本院校
练习本的长约两什么	练习本的长约两什么
甲状腺结节可以吃燕窝	甲状腺结节可以吃燕窝
用什么方式可以定位别人的手机	用什么方式可以定位别人的手机
网络主播是不是真的	网络主播是不是真的
abigail是什么意思	abigail是什么意思
来月经能喝茶	来月经能喝茶
乐曲名加书名号还是引号	乐曲名加书名号还是引号
音乐类省统考考什么	音乐类省统考考什么
要不要	要不要
你是哪个学校毕业的	你是哪个学校毕业的
你还能写出几个这样的字吗	你还能写出几个这样的字吗
农行信息服务怎么取消	农行信息服务怎么取消
你是男是女	你是男是女
痛风能吃虾皮	痛风能吃虾皮
怀孕能吃米酒	怀孕能吃米酒
用英语怎么说	用英语怎么说
clearimpression是什么品牌	clearimpression是什么品牌
一百八十乘二十五	一百八十乘二十五
罗切斯特的疯妻子是怎么死的	罗切斯特的疯妻子是怎么死的
游泳可以减肥	游泳可以减肥
肿瘤引起的性早熟有什么症状	肿瘤引起的性早熟有什么症状
你会背乘法口诀吗	你会背乘法口诀吗
麦滋林的作用是什么	麦滋林的作用是什么
世界文化遗产古城位于什么省	世界文化遗产古城位于什么省
怀孕可以吃棒冰	怀孕可以吃棒冰
黑色衬衫下面配什么好看	黑色衬衫下面配什么好看
蒙脱石混悬液可以和奶一起吃会怎样	蒙脱石混悬液可以和奶一起吃会怎样
等边三角形有三个锐角对吗	等边三角形有三个锐角对吗
人性有哪些弱点可以被利用	人性有哪些弱点可以被利用
茄子会回奶	茄子会回奶
山东属于哪个地区	山东属于哪个地区
荣耀v二十换非原装屏可以吗	荣耀v二十换非原装屏可以吗
湿疹可以吃苦瓜	湿疹可以吃苦瓜
预防近视要减少什么的摄入	预防近视要减少什么的摄入
一港币等多少人民币	一港币等多少人民币
血常规能测出艾滋病	血常规能测出艾滋病
百度自媒体在哪里进入	百度自媒体在哪里进入
发烧能吃橘子	发烧能吃橘子
年底结平应交增值税会计分录	年底结平应交增值税会计分录
朝阳离大连多远	朝阳离大连多远
孕妇能喝椰子汁	孕妇能喝椰子汁
打开密码本	打开密码本
三七是田七	三七是田七
破产案件诉讼费标准	破产案件诉讼费标准
西湖邮政编码	西湖邮政编码
结婚证上的花是啥花	结婚证上的花是啥花
你是不是人工智能	你是不是人工智能
来月经可以吃叶酸	来月经可以吃叶酸
韩红个人捐款多少钱了	韩红个人捐款多少钱了
减肥后面部憔悴怎么办	减肥后面部憔悴怎么办
怀孕可以吃零食	怀孕可以吃零食
芒果可以空腹吃	芒果可以空腹吃
颈椎病会引起头痛	颈椎病会引起头痛
还没回来	还没回来
吃烧烤会胖	吃烧烤会胖
绝对温度的零度是	绝对温度的零度是
二零	二零
怎么知道枸杞有没有被硫磺熏过	怎么知道枸杞有没有被硫磺熏过
做月子可以吃螃蟹	做月子可以吃螃蟹
支原体感染会传染	支原体感染会传染
积累关于三国的歇后语	积累关于三国的歇后语
浙江理工大学专业对选科的要求	浙江理工大学专业对选科的要求
八公山服务区在哪里	八公山服务区在哪里
明天有雨下吗	明天有雨下吗
初中求角度的方法总结	初中求角度的方法总结
脸上有绒毛怎么回事	脸上有绒毛怎么回事
二乘四	二乘四
手掌上出现红色血斑点	手掌上出现红色血斑点
正当防卫四手机版怎么下	正当防卫四手机版怎么下
手掌上出现红色血斑点	手掌上出现红色血斑点
打完hpv九价可以吃辣吗	打完hpv九价可以吃辣吗
可以帮我打王者吗	可以帮我打王者吗
三洋洗衣机出现e十一点排水管一直出水	三洋洗衣机出现e十一点排水管一直出水
荣耀v二十换非原装屏可以吗	荣耀v二十换非原装屏可以吗
怀孕可以吃乳酸菌素片	怀孕可以吃乳酸菌素片
为什么还没到账	为什么还没到账
表达对妈妈爱的成语	表达对妈妈爱的成语
来大姨妈可以喝酒	来大姨妈可以喝酒
你什么都知道吗	你什么都知道吗
糜烂性直肠炎灌肠用什么药	糜烂性直肠炎灌肠用什么药
女人还是呆呆的坐在院子里等他	女人还是呆呆的坐在院子里等他
铝青铜圆棒重量怎么算	铝青铜圆棒重量怎么算
起泡胶粘在裤子上怎么弄	起泡胶粘在裤子上怎么弄
ace两刷新率	ace两刷新率
广东什么时候开始考全国卷	广东什么时候开始考全国卷
三十乘一百八十	三十乘一百八十
新三界模式下退游的有多少	新三界模式下退游的有多少
虾和地瓜能一起吃	虾和地瓜能一起吃
后天什么天气	后天什么天气
大连建筑工程项目招标	大连建筑工程项目招标
六十六除六	六十六除六
肾结石会引起尿潜血	肾结石会引起尿潜血
拉肚子可以吃火龙果	拉肚子可以吃火龙果
脂肪肝可以买健康险吗	脂肪肝可以买健康险吗
电子烟有危害	电子烟有危害
胆囊炎可以吃红薯	胆囊炎可以吃红薯
吃降压药能喝酒	吃降压药能喝酒
安卓如何查看安装路径	安卓如何查看安装路径
四十三乘二	四十三乘二
十四乘十四	十四乘十四
你是个美女吗	你是个美女吗
孩子吃羊奶大便干燥怎么办	孩子吃羊奶大便干燥怎么办
拔智齿脸会变小	拔智齿脸会变小
日照景点地图	日照景点地图
g七十三可以用半径补偿吗	g七十三可以用半径补偿吗
四十四乘二	四十四乘二
你有几个孩子	你有几个孩子
四个月的宝宝才十一斤	四个月的宝宝才十一斤
怀孕初期可以吃李子	怀孕初期可以吃李子
网商贷怎么没有额度了	网商贷怎么没有额度了
大疆灵眸电量持续多久	大疆灵眸电量持续多久
响水是不是贫困县	响水是不是贫困县
韩语写给exo的话	韩语写给exo的话
三百乘五十	三百乘五十
慢性非萎缩性胃炎能吃方便面吗	慢性非萎缩性胃炎能吃方便面吗
怎么样的	怎么样的
腹泻能吃橙子	腹泻能吃橙子
宝宝嗓子红咳嗽吃啥药	宝宝嗓子红咳嗽吃啥药
物业管理费包括二次加压费吗	物业管理费包括二次加压费吗
拉肚子能吃蛋糕	拉肚子能吃蛋糕
北京租房公积金提取额度	北京租房公积金提取额度
一般拔牙之后要痛几小时	一般拔牙之后要痛几小时
发烧可以吃芒果	发烧可以吃芒果
支付宝二维码发微信里怎么扫码	支付宝二维码发微信里怎么扫码
喝完酒打哈欠睡不着怎么回事	喝完酒打哈欠睡不着怎么回事
狗狗拉稀出血怎么办	狗狗拉稀出血怎么办
菠萝上火	菠萝上火
淘宝退货单号总是不正确	淘宝退货单号总是不正确
孕七月躺下呼吸困难	孕七月躺下呼吸困难
怎么关闭斗鱼开机自启	怎么关闭斗鱼开机自启
尿酸高能治愈	尿酸高能治愈
一直响铃然后直接挂了	一直响铃然后直接挂了
奉贤邮编	奉贤邮编
g七十三可以用半径补偿吗	g七十三可以用半径补偿吗
肥西上派镇邮政编码	肥西上派镇邮政编码
what是什么意思	what是什么意思
机器人搭建有什么好处	机器人搭建有什么好处
微波炉可以考披萨	微波炉可以考披萨
二十年青木川古镇开放了吗	二十年青木川古镇开放了吗
教学设计过程模式	教学设计过程模式
小孩皮肤有红斑	小孩皮肤有红斑
儿童吹泡泡水简单配方比例	儿童吹泡泡水简单配方比例
迪达斯的标志	迪达斯的标志
坐月子洗头可以用吹风机	坐月子洗头可以用吹风机
忘记隐私密码	忘记隐私密码
陕西出省务工的健康证在哪里办理	陕西出省务工的健康证在哪里办理
在职研究生算应届吗	在职研究生算应届吗
牛奶和榴莲能一起吃	牛奶和榴莲能一起吃
激光能去雀斑	激光能去雀斑
无痛人流怎么样恢复快	无痛人流怎么样恢复快
pubg可以家庭共享吗	pubg可以家庭共享吗
不符合更年期雌激素变化作用的规律是	不符合更年期雌激素变化作用的规律是
糟糕的近义词是什么	糟糕的近义词是什么
手机进水了	手机进水了
肺炎有少量胸腔积液不住院行吗	肺炎有少量胸腔积液不住院行吗
三型防水是什么意思	三型防水是什么意思
北京甲状腺最好的医院	北京甲状腺最好的医院
豆浆会发胖	豆浆会发胖
转到财付通的钱去哪了	转到财付通的钱去哪了
自动测量海拔高度软件	自动测量海拔高度软件
月经来了可以洗头	月经来了可以洗头
怎么设置你	怎么设置你
电冰箱照明灯不亮什么原因	电冰箱照明灯不亮什么原因
abb的词语有	abb的词语有
我忘记密码了怎么办	我忘记密码了怎么办
河东人社局电话号码	河东人社局电话号码
小步你会bbox吗	小步你会bbox吗
招行young信用卡年费	招行young信用卡年费
中考四百分能上高中	中考四百分能上高中
天津安全员证在哪里报考	天津安全员证在哪里报考
包皮手术要拆线	包皮手术要拆线
五月应季水果有哪些	五月应季水果有哪些
你喜欢什么	你喜欢什么
今天天气咋样	今天天气咋样
你有脑袋	你有脑袋
四十六除二	四十六除二
银行卡能在手机上办吗	银行卡能在手机上办吗
晚上不吃饭可以	晚上不吃饭可以
皮肤病血毒丸的药理解析	皮肤病血毒丸的药理解析
我能考多少分	我能考多少分
脚丫子痒有水泡怎么回事	脚丫子痒有水泡怎么回事
月经期间可以吃芒果	月经期间可以吃芒果
二十四除四等多少	二十四除四等多少
用香皂洗脸好	用香皂洗脸好
清朝赔款实际支付总额	清朝赔款实际支付总额
顺序启动实物接线图	顺序启动实物接线图
网上如何问女生要微信	网上如何问女生要微信
迷你世界陷阱怎么做	迷你世界陷阱怎么做
孕妇可以吃马蹄	孕妇可以吃马蹄
短信验证码	短信验证码
零除零	零除零
房子防水物业保修多长时间	房子防水物业保修多长时间
根号五百七十一	根号五百七十一
二千零一十九内蒙古脱贫摘帽旗县名单	二千零一十九内蒙古脱贫摘帽旗县名单
西安公积金贷款额度上限	西安公积金贷款额度上限
吃土豆会发胖	吃土豆会发胖
复方氢氧化铝片孕妇可以吃	复方氢氧化铝片孕妇可以吃
小龙虾的做法和绝密配方	小龙虾的做法和绝密配方
尿路感染会低烧	尿路感染会低烧
有什么好玩的东西	有什么好玩的东西
妇炎洁孕妇可以洗	妇炎洁孕妇可以洗
小孩能吃秋葵	小孩能吃秋葵
胃病能治好	胃病能治好
描写边塞将士的诗句	描写边塞将士的诗句
孕妇可以拔罐	孕妇可以拔罐
糖耐有必要做	糖耐有必要做
血常规能看出艾滋病	血常规能看出艾滋病
角声满天秋色里前一句	角声满天秋色里前一句
中国肝癌治疗最佳医院	中国肝癌治疗最佳医院
更改报税人需要什么资料	更改报税人需要什么资料
猫妈妈为什么不管小猫	猫妈妈为什么不管小猫
大便变细是肠癌	大便变细是肠癌
肠炎能吃红薯	肠炎能吃红薯
你心目中的班干部是怎么样的	你心目中的班干部是怎么样的
连云港中级职称评定条件	连云港中级职称评定条件
在项目启动期间一名关键相关方	在项目启动期间一名关键相关方
孕初期可以吃榴莲	孕初期可以吃榴莲
上海农村危房鉴定标准	上海农村危房鉴定标准
八十九年农历四月初四是什么星座	八十九年农历四月初四是什么星座
排球教练郎平多大岁数	排球教练郎平多大岁数
刚怀孕小肚子会疼	刚怀孕小肚子会疼
你妈叫什么名字	你妈叫什么名字
形容珍惜的	形容珍惜的
失重条件下生长素可以横向	失重条件下生长素可以横向
糖尿病能吃红枣	糖尿病能吃红枣
得失心疯了是什么意思	得失心疯了是什么意思
我是不是单身狗	我是不是单身狗
蛋黄胆固醇高	蛋黄胆固醇高
你有朋友	你有朋友
明天冷不冷	明天冷不冷
七百五十除十五	七百五十除十五
在重庆买的医保在贵州可以使用么	在重庆买的医保在贵州可以使用么
黄体破裂严重	黄体破裂严重
高血压可以吃黄瓜	高血压可以吃黄瓜
剖腹产第三天吃什么好	剖腹产第三天吃什么好
荨麻疹能用盐水洗	荨麻疹能用盐水洗
湿热吃什么药	湿热吃什么药
姨妈快没了但是又来了	姨妈快没了但是又来了
你是男的	你是男的
小米九后盖怎么拆	小米九后盖怎么拆
深蹲可以减肥	深蹲可以减肥
一平方等多少吨	一平方等多少吨
深基坑和浅基坑的区别	深基坑和浅基坑的区别
经期能拔牙	经期能拔牙
胆囊炎能吃鸭蛋	胆囊炎能吃鸭蛋
国泰君安与银河比较	国泰君安与银河比较
吃鸡灵敏度怎么调最稳苹果十一	吃鸡灵敏度怎么调最稳苹果十一
天麻多少钱一斤药店	天麻多少钱一斤药店
面对面建群怎么拉人进来	面对面建群怎么拉人进来
天上下来的人很多吗	天上下来的人很多吗
你知道什么事	你知道什么事
不完全履行合同定金怎么算	不完全履行合同定金怎么算
石家庄著名律师	石家庄著名律师
六十缸用多大的过滤桶	六十缸用多大的过滤桶
那我是什么座	那我是什么座
没有网络	没有网络
厦门海警第三支队人员名单	厦门海警第三支队人员名单
oppocare加的退换规则	oppocare加的退换规则
布洛芬吃下去多久后才有效果	布洛芬吃下去多久后才有效果
迷你世界陷阱怎么做	迷你世界陷阱怎么做
包钢钢业合肥有限责任公司怎么样	包钢钢业合肥有限责任公司怎么样
人力资源管理师四级报名网站	人力资源管理师四级报名网站
学信网如何更改账号	学信网如何更改账号
天猫什么时候活动力度大	天猫什么时候活动力度大
什么病的人不能吃芹菜	什么病的人不能吃芹菜
肾结石痛	肾结石痛
如果卫星通过k二十一地区的间隔时间服从指数分布	如果卫星通过k二十一地区的间隔时间服从指数分布
阿普利亚gpr一百五十多久保养一次	阿普利亚gpr一百五十多久保养一次
枸杞石斛花泡水喝的功效	枸杞石斛花泡水喝的功效
手机上如何删除买家秀	手机上如何删除买家秀
珠江零度保质期多久	珠江零度保质期多久
如何退出电脑监控画面	如何退出电脑监控画面
因为我聪明的英文翻译	因为我聪明的英文翻译
ios怎么绕过商店下载	ios怎么绕过商店下载
怀孕能吃鲍鱼	怀孕能吃鲍鱼
龙珠传奇皇上当乞丐是哪一集	龙珠传奇皇上当乞丐是哪一集
二乘五	二乘五
喝水可以治疗感冒吗	喝水可以治疗感冒吗
六十六除六	六十六除六
花甲的形状是什么样子	花甲的形状是什么样子
用手指弄完有血和血丝	用手指弄完有血和血丝
哺乳期可以吃马齿苋	哺乳期可以吃马齿苋
做完人流可以吃巧克力	做完人流可以吃巧克力
先进生产力的发展要求”是指	先进生产力的发展要求”是指
九十年五月是什么星座	九十年五月是什么星座
布洛芬吃下去多久后才有效果	布洛芬吃下去多久后才有效果
核磁共振影响怀孕	核磁共振影响怀孕
厦门哪个医院做胆结石手术比较好	厦门哪个医院做胆结石手术比较好
工行北塘支行电话	工行北塘支行电话
drivingschool二千零一十七设置翻译	drivingschool二千零一十七设置翻译
称怎么组词	称怎么组词
宫颈糜烂传染	宫颈糜烂传染
上海到台儿庄多少公里	上海到台儿庄多少公里
来例假可以艾灸	来例假可以艾灸
杭州哪里看妇科好	杭州哪里看妇科好
刚受孕成功后会腹痛	刚受孕成功后会腹痛
狗粮能喂猫	狗粮能喂猫
怀孕能用花露水	怀孕能用花露水
二十四乘二	二十四乘二
没有幽门螺杆菌会得胃溃疡吗	没有幽门螺杆菌会得胃溃疡吗
中国前十大上市公司	中国前十大上市公司
血压一百四十正常	血压一百四十正常
你是机器人还是人	你是机器人还是人
慢性胃炎能根治	慢性胃炎能根治
来月经可以跳绳	来月经可以跳绳
招行宝可梦卡年费	招行宝可梦卡年费
三十厘米等多少立方厘米	三十厘米等多少立方厘米
中暑会肚子疼	中暑会肚子疼
新都到双流机场t两	新都到双流机场t两
男生第一次吃延时药可以吗	男生第一次吃延时药可以吗
美国流感是什么时间	美国流感是什么时间
诸暨医保局在什么地方	诸暨医保局在什么地方
白水江林业局领导名单	白水江林业局领导名单
痘痘留下的黑点怎么办	痘痘留下的黑点怎么办
和平精英玛莎拉蒂可以隐藏	和平精英玛莎拉蒂可以隐藏
肺癌吃不下饭能撑多久	肺癌吃不下饭能撑多久
男人对你说无语我该怎么回	男人对你说无语我该怎么回
药典规定制备注射用水的方法是	药典规定制备注射用水的方法是
情侣之间高情商说话方式	情侣之间高情商说话方式
u盘直接放iso文件能安装系统吗	u盘直接放iso文件能安装系统吗
今天天气怎么样	今天天气怎么样
孕妇可以吃紫薯	孕妇可以吃紫薯
绵阳哪里好玩	绵阳哪里好玩
上错花轿嫁对主题曲	上错花轿嫁对主题曲
黑龙江明星演员	黑龙江明星演员
冒险岛天使link有没必要	冒险岛天使link有没必要
孕期血糖高能吃红薯	孕期血糖高能吃红薯
海参小孩可以吃	海参小孩可以吃
怀孕会犯困	怀孕会犯困
零的平方是什么	零的平方是什么
毕业论文署名怎么写	毕业论文署名怎么写
尿量多黄是什么原因引起的	尿量多黄是什么原因引起的
子宫纤维性粘连是什么意思	子宫纤维性粘连是什么意思
rap是什么意思	rap是什么意思
猫妈妈为什么不管小猫	猫妈妈为什么不管小猫
四个月泰迪吃什么牌子狗粮	四个月泰迪吃什么牌子狗粮
珠海是哪个省的	珠海是哪个省的
化州属于哪个地级市	化州属于哪个地级市
泰迪可以吃山药	泰迪可以吃山药
酷睿i五万四千五百七十配什么主板	酷睿i五万四千五百七十配什么主板
文娱类完结小说排行榜	文娱类完结小说排行榜
文章和马伊琍离婚了	文章和马伊琍离婚了
肩膀种花为什么会有疤	肩膀种花为什么会有疤
广播电视播音员主持人资格证	广播电视播音员主持人资格证
汉赋九问兰草八章作者	汉赋九问兰草八章作者
缩阴产品有用	缩阴产品有用
七十七年这年的高考不是在夏天而是在哪一天	七十七年这年的高考不是在夏天而是在哪一天
冰点脱毛永久	冰点脱毛永久
一百八十乘五十	一百八十乘五十
脑梗能吃海参	脑梗能吃海参
你有情商吗	你有情商吗
华为手表有测血压功能吗	华为手表有测血压功能吗
请关闭手机	请关闭手机
多久能成为瑜伽教练	多久能成为瑜伽教练
眼镜看东西有蓝条黄条	眼镜看东西有蓝条黄条
重庆银行渝中区网点分布	重庆银行渝中区网点分布
熊猫的脾气描写句子	熊猫的脾气描写句子
湖南的景区有哪些	湖南的景区有哪些
华为密码忘记了怎么手动刷机	华为密码忘记了怎么手动刷机
你吃饭了吗	你吃饭了吗
肺部积水严重	肺部积水严重
自制凉皮为啥会炸口	自制凉皮为啥会炸口
贵定到金华高铁票查询	贵定到金华高铁票查询
你喜欢王俊凯	你喜欢王俊凯
四百二十除六	四百二十除六
项目式组织的缺点有	项目式组织的缺点有
做个没心没肺的人多好	做个没心没肺的人多好
分开用英语短语怎么说part	分开用英语短语怎么说part
今天的气温	今天的气温
韵达沈阳到广州要多久	韵达沈阳到广州要多久
月经推迟两天正常	月经推迟两天正常
before读什	before读什
三体系外审是指什么	三体系外审是指什么
扁桃体发炎能吃虾	扁桃体发炎能吃虾
瘦腿霜有用	瘦腿霜有用
金乡九星花园物业电话	金乡九星花园物业电话
在哪可以看夫人你的马甲掉了	在哪可以看夫人你的马甲掉了
酒酿一定要烧熟了才能吃	酒酿一定要烧熟了才能吃
六味地黄丸对备孕有影响吗	六味地黄丸对备孕有影响吗
国产奶粉三段哪个好	国产奶粉三段哪个好
手机关机铃声的	手机关机铃声的
来月经可以吃梨	来月经可以吃梨
小三挑事还如何处理	小三挑事还如何处理
你什么性别	你什么性别
月经期可以吃苦瓜	月经期可以吃苦瓜
眼睛怎样变大自然方法	眼睛怎样变大自然方法
三的倍数的特征是它的什么的和是什么的倍数	三的倍数的特征是它的什么的和是什么的倍数
写三月春暖花开的句子	写三月春暖花开的句子
你为什么不接话	你为什么不接话
工程院和科学院的区别	工程院和科学院的区别
停车熄火正确的方法	停车熄火正确的方法
你的新房在哪里	你的新房在哪里
疫情期间老师对家长说的话	疫情期间老师对家长说的话
猫能吃鸡皮	猫能吃鸡皮
关于非洲的高分电影	关于非洲的高分电影
新生儿鸟氨酸高复查通过率大吗	新生儿鸟氨酸高复查通过率大吗
committee的意思中文翻译	committee的意思中文翻译
一毫巴等多少帕斯卡	一毫巴等多少帕斯卡
为什么大便的时候白带特别多	为什么大便的时候白带特别多
你是不是有毛病	你是不是有毛病
怀孕能养猫	怀孕能养猫
抖音里一个飞机折合人民币多少钱	抖音里一个飞机折合人民币多少钱
而应声答曰未闻孔雀是夫子家禽翻译成白话文	而应声答曰未闻孔雀是夫子家禽翻译成白话文
避孕套有保质期	避孕套有保质期
月经期间可以吃逍遥丸	月经期间可以吃逍遥丸
郑州到济南汽车时刻表	郑州到济南汽车时刻表
根骨二次手术后多久能走路	根骨二次手术后多久能走路
怀孕能喝椰汁	怀孕能喝椰汁
五十除十	五十除十
猎人宝宝换不了天赋	猎人宝宝换不了天赋
身体虚弱腰疼怎么调理	身体虚弱腰疼怎么调理
节日前面的the要不要大写	节日前面的the要不要大写
四十六除二	四十六除二
怀孕可以吃冬枣	怀孕可以吃冬枣
孕妇身上起痘痘是怎么回事	孕妇身上起痘痘是怎么回事
芜湖到彭泽火车时刻表查询	芜湖到彭泽火车时刻表查询
焊接后产生角变形的原因是	焊接后产生角变形的原因是
血糖高能吃橙子	血糖高能吃橙子
现在怎么办	现在怎么办
十个月宝宝可以吃橙子	十个月宝宝可以吃橙子
你想对我说什么	你想对我说什么
深圳网络诈骗举报电话号码	深圳网络诈骗举报电话号码
昌平区兴寿镇半壁店书记	昌平区兴寿镇半壁店书记
输卵管堵塞会宫外孕	输卵管堵塞会宫外孕
哺乳期能吃奥美拉唑	哺乳期能吃奥美拉唑
吴中离哪个高铁站近	吴中离哪个高铁站近
卡超级加倍什么意思	卡超级加倍什么意思
一百八十除四	一百八十除四
电视无法接收遥控器信号是什么原因	电视无法接收遥控器信号是什么原因
白斑可以用激光治疗吗	白斑可以用激光治疗吗
乙烯使高锰酸钾溶液褪色的化学方程式	乙烯使高锰酸钾溶液褪色的化学方程式
狗狗拉稀出血怎么办	狗狗拉稀出血怎么办
湖北的什么面有青岛什么面有台湾	湖北的什么面有青岛什么面有台湾
西红柿苹果香蕉可以一起吃吗	西红柿苹果香蕉可以一起吃吗
描写乡村生活的段落	描写乡村生活的段落
运城有那些县	运城有那些县
江苏口罩第三方检测机构	江苏口罩第三方检测机构
成都社保养老金计算方法	成都社保养老金计算方法
吃豆腐减肥	吃豆腐减肥
拉肚子会头晕	拉肚子会头晕
长痱子可以打预防针	长痱子可以打预防针
妊娠糖尿病可以喝纯牛奶	妊娠糖尿病可以喝纯牛奶
星海音乐学院好	星海音乐学院好
药物代谢动力学的名词解释	药物代谢动力学的名词解释
家里突然来了一只鸟好不好	家里突然来了一只鸟好不好
仓鼠可以吃水果	仓鼠可以吃水果
双色球开奖结果	双色球开奖结果
胚胎着床会出血	胚胎着床会出血
你什么时候能做到	你什么时候能做到
一百除十八	一百除十八
电子厂学徒工资多少	电子厂学徒工资多少
你叫什么呀	你叫什么呀
沈阳十二中学是重点吗	沈阳十二中学是重点吗
上海交大数学专业排名	上海交大数学专业排名
视频转换动图的软件	视频转换动图的软件
消化不良可以吃香蕉	消化不良可以吃香蕉
六十八号机械润滑油的性能	六十八号机械润滑油的性能
九字情侣网名	九字情侣网名
失眠了怎么办	失眠了怎么办
梦到自己遇到危险但自救了	梦到自己遇到危险但自救了
上海闯红灯一次保费上浮吗	上海闯红灯一次保费上浮吗
学生买的保险生病了可以报销吗	学生买的保险生病了可以报销吗
外面有什	外面有什
行车记录仪有用	行车记录仪有用
根号六	根号六
一万乘一万	一万乘一万
希望之村选不了服务器进不去	希望之村选不了服务器进不去
减肥期间能吃土豆	减肥期间能吃土豆
肠胃炎可以吃水果	肠胃炎可以吃水果
专业人员的培训费计入什么费用	专业人员的培训费计入什么费用
阿普利亚gpr一百五十多久保养一次	阿普利亚gpr一百五十多久保养一次
率土之滨三赛季九级地难度表	率土之滨三赛季九级地难度表
双眼周边网膜血管化未完成	双眼周边网膜血管化未完成
积累关于三国的歇后语	积累关于三国的歇后语
麦克维尔中央空调哪里产的	麦克维尔中央空调哪里产的
科二约了几天可以看见结果	科二约了几天可以看见结果
来月经能吃葡萄	来月经能吃葡萄
孕妇可以吃提子	孕妇可以吃提子
农村户口可以买社保	农村户口可以买社保
小米三恢复出厂设置	小米三恢复出厂设置
类似一百二十三木头人的游戏	类似一百二十三木头人的游戏
长春看妇科病的医院	长春看妇科病的医院
脸上肉多适合做什么紧致项目	脸上肉多适合做什么紧致项目
我长得丑吗	我长得丑吗
肠胃炎会发烧	肠胃炎会发烧
孕妇可以吃腰果	孕妇可以吃腰果
眼睛里面一眨眼就疼	眼睛里面一眨眼就疼
脂肪肝吃苏子籽好吗	脂肪肝吃苏子籽好吗
现在干啥	现在干啥
前夫抚养费不给强制执行不了	前夫抚养费不给强制执行不了
屈原的千古名句是什么激励一代	屈原的千古名句是什么激励一代
为什么老被别人拉黑	为什么老被别人拉黑
喜欢一个人是什么感觉	喜欢一个人是什么感觉
支气管炎会传染	支气管炎会传染
孕妇可以吃白萝卜	孕妇可以吃白萝卜
一加六怎么使用两张电信卡	一加六怎么使用两张电信卡
眼睛重影眯着眼看才正常	眼睛重影眯着眼看才正常
融创乐园里面有吃饭的地方吗	融创乐园里面有吃饭的地方吗
支付宝通讯物流怎么关	支付宝通讯物流怎么关
脂肪肝可以吃生蚝	脂肪肝可以吃生蚝
沙漠的资源如何利用	沙漠的资源如何利用
慢性胃窦炎严重	慢性胃窦炎严重
宝宝鼻炎鼻塞晚上严重怎么办	宝宝鼻炎鼻塞晚上严重怎么办
二保焊机不吐丝不出气原因	二保焊机不吐丝不出气原因
公司降本增效的方法	公司降本增效的方法
手机卡怎么办oppo	手机卡怎么办oppo
来大姨妈可以吃西瓜	来大姨妈可以吃西瓜
多久能成为瑜伽教练	多久能成为瑜伽教练
本命年丢了金项链什么预兆	本命年丢了金项链什么预兆
我的名字叫做用韩语怎么说	我的名字叫做用韩语怎么说
嘴角痒脱皮发黑是怎么回事	嘴角痒脱皮发黑是怎么回事
ofree右耳升级失败	ofree右耳升级失败
怀孕能吃鹅蛋	怀孕能吃鹅蛋
淘宝钻石号是什么意思	淘宝钻石号是什么意思
怀孕一个月可以药流	怀孕一个月可以药流
交行周六周日上班	交行周六周日上班
哺乳期能吃马齿苋	哺乳期能吃马齿苋
九周岁男孩标准身高体重对照表	九周岁男孩标准身高体重对照表
八由哪两个数字组成	八由哪两个数字组成
涤纶面料裤子夏天穿会不会热	涤纶面料裤子夏天穿会不会热
做玉米烙没有淀粉可以用糯米粉代替吗	做玉米烙没有淀粉可以用糯米粉代替吗
副处级干部几年后升正处	副处级干部几年后升正处
梦见自己的亲姨妈死了	梦见自己的亲姨妈死了
都城的都的拼音是什么	都城的都的拼音是什么
怀二胎头疼是怎么回事	怀二胎头疼是怎么回事
南通保险个人和公司的比例	南通保险个人和公司的比例
你谈过几次恋爱	你谈过几次恋爱
世界上真的有龙	世界上真的有龙
方天画戟削苹果什么梗	方天画戟削苹果什么梗
糜烂性直肠炎灌肠用什么药	糜烂性直肠炎灌肠用什么药
ct诊断是人工还是机器	ct诊断是人工还是机器
要聊什么呢	要聊什么呢
招行信用卡和花呗哪个利息高	招行信用卡和花呗哪个利息高
宁波医保卡使用范围	宁波医保卡使用范围
晚上吃鱼会胖	晚上吃鱼会胖
乌鸦是怎么叫的文字	乌鸦是怎么叫的文字
每天吃多少芋头不会胖	每天吃多少芋头不会胖
妊娠糖尿病能吃菠萝	妊娠糖尿病能吃菠萝
布洛芬吃下去多久后才有效果	布洛芬吃下去多久后才有效果
lol冲击之刃炫彩怎么得	lol冲击之刃炫彩怎么得
你会萝莉音吗	你会萝莉音吗
疫情期间老师对家长说的话	疫情期间老师对家长说的话
人机怎么不加信誉积分	人机怎么不加信誉积分
正确处理改革发展稳定三者的结合点是	正确处理改革发展稳定三者的结合点是
四股圆编口诀最简单	四股圆编口诀最简单
孕妇可以吃辣椒	孕妇可以吃辣椒
电动牙刷要用牙膏	电动牙刷要用牙膏
一百乘一千	一百乘一千
北京社保断交多久还可以续上	北京社保断交多久还可以续上
孕妇能吃酸菜	孕妇能吃酸菜
白带增多是月经前兆	白带增多是月经前兆
两周岁宝宝耳温多少正常	两周岁宝宝耳温多少正常
左旋肉碱减肥有用	左旋肉碱减肥有用
你怎么不睡觉	你怎么不睡觉
关于二轮摩托车的年检新规	关于二轮摩托车的年检新规
我爱你你爱我吗	我爱你你爱我吗
猎人宝宝换不了天赋	猎人宝宝换不了天赋
a四纸上站人科学原理	a四纸上站人科学原理
八十八除四	八十八除四
欠条会过期	欠条会过期
精神病会遗传	精神病会遗传
现在的你在干嘛	现在的你在干嘛
人流手术后能吃小龙虾吗	人流手术后能吃小龙虾吗
孕妇可以喝乌鸡汤吗早期	孕妇可以喝乌鸡汤吗早期
柯基能吃桃	柯基能吃桃
情侣之间高情商说话方式	情侣之间高情商说话方式
月经期可以吃阿胶	月经期可以吃阿胶
设随机变量x服从二项分布bnp则ex等	设随机变量x服从二项分布bnp则ex等
一百八十°的余弦值是多少	一百八十°的余弦值是多少
卵巢衰绝无排卵能调理吗	卵巢衰绝无排卵能调理吗
输卵管通而不畅能怀孕	输卵管通而不畅能怀孕
计算机二级是nit还是ncre	计算机二级是nit还是ncre
例假能喝咖啡	例假能喝咖啡
上海的特产	上海的特产
六味地黄丸对备孕有影响吗	六味地黄丸对备孕有影响吗
九月里的生日是什么星座	九月里的生日是什么星座
天津离静海区有多远	天津离静海区有多远
为什么每天早上肚子都不舒服	为什么每天早上肚子都不舒服
天花是水痘	天花是水痘
经常熬夜会肾虚	经常熬夜会肾虚
现在几点了	现在几点了
四十二乘二	四十二乘二
红外可见分光光度法	红外可见分光光度法
双眼周边网膜血管化未完成	双眼周边网膜血管化未完成
零除零	零除零
创维电视音量自动回零	创维电视音量自动回零
你会解梦吗	你会解梦吗
工行是不是倒闭了	工行是不是倒闭了
端午节有什么好玩的	端午节有什么好玩的
五菱荣光v中门中控锁安装	五菱荣光v中门中控锁安装
burn的过去式和过去分词是什么啊	burn的过去式和过去分词是什么啊
宝宝十个月发烧手脚冰凉怎么回事	宝宝十个月发烧手脚冰凉怎么回事
神庭的准确位置和作用	神庭的准确位置和作用
一岁宝宝能吃火龙果	一岁宝宝能吃火龙果
来月经能吃辣	来月经能吃辣
手链掉河里了有没有打捞的工具	手链掉河里了有没有打捞的工具
附近有什么好吃的	附近有什么好吃的
工行免费电话	工行免费电话
建行信用卡怎样激活使用方法	建行信用卡怎样激活使用方法
月经来了能洗头	月经来了能洗头
我不是这个意思	我不是这个意思
房管局备案夫妻都要去吗	房管局备案夫妻都要去吗
孕妇夏天可以吃冰淇淋	孕妇夏天可以吃冰淇淋
明天是什么日子	明天是什么日子
二的十次方	二的十次方
恶心是怀孕了	恶心是怀孕了
长安景点	长安景点
西华师大有几个学院	西华师大有几个学院
一百以内的质数表有什么规律	一百以内的质数表有什么规律
lastdance木西吉他谱	lastdance木西吉他谱
幼儿急疹可以出门	幼儿急疹可以出门
痔疮可以吃鸡肉	痔疮可以吃鸡肉
眼镜店验光一般收费多少呢	眼镜店验光一般收费多少呢
黄金瞳五感尽失结果	黄金瞳五感尽失结果
哺乳期可以喝板蓝根	哺乳期可以喝板蓝根
九百除五	九百除五
你不会说话吗	你不会说话吗
宝马三百二十五仪表盘指示灯图解	宝马三百二十五仪表盘指示灯图解
痛风能吃南瓜	痛风能吃南瓜
七乘十五	七乘十五
口字旁的当	口字旁的当
圣骑士技能	圣骑士技能
孕晚期能吃冰棍	孕晚期能吃冰棍
三十乘五	三十乘五
仰卧起坐能减肚子	仰卧起坐能减肚子
邵阳内景点排名大全	邵阳内景点排名大全
莜面窝窝头的做法大全窍门	莜面窝窝头的做法大全窍门
惊天动地意思和造句	惊天动地意思和造句
十万乘十万	十万乘十万
五十岁男脸上长黑斑了怎么办	五十岁男脸上长黑斑了怎么办
包头防控中心电话	包头防控中心电话
瘦脸仪有用	瘦脸仪有用
我儿子叫什么名字	我儿子叫什么名字
鹿晗和黄子韬张艺兴关系	鹿晗和黄子韬张艺兴关系
十二律名和对应的现代名	十二律名和对应的现代名
四乘八	四乘八
我的妈妈结尾怎么写二百	我的妈妈结尾怎么写二百
手机充不进去电	手机充不进去电
大蛇丸死了	大蛇丸死了
甘蔗和马蹄煮水的功效与作用	甘蔗和马蹄煮水的功效与作用
孕妇可以吃火腿肠	孕妇可以吃火腿肠
梭子蟹孕妇能吃	梭子蟹孕妇能吃
如何取得上海户籍	如何取得上海户籍
十三画属木的繁体字	十三画属木的繁体字
鸡腿怎么做不油腻还好吃	鸡腿怎么做不油腻还好吃
每晚快走一小时能减肥吗	每晚快走一小时能减肥吗
做唐筛要空腹	做唐筛要空腹
舌吻会传染艾滋病	舌吻会传染艾滋病
社保能补交	社保能补交
高铁站是郑州东站吗	高铁站是郑州东站吗
糖尿病能吃什么水果	糖尿病能吃什么水果
适合上官婉儿的网名	适合上官婉儿的网名
办公楼窗户的常规尺寸	办公楼窗户的常规尺寸
等边三角形有三个锐角对吗	等边三角形有三个锐角对吗
孕晚期能吃雪糕	孕晚期能吃雪糕
哺乳期怀孕了还会有奶水	哺乳期怀孕了还会有奶水
通过丝绸之路传入中国的农作物或手工业品	通过丝绸之路传入中国的农作物或手工业品
生命密码九百四十四组密码解析	生命密码九百四十四组密码解析
今天有什么新闻	今天有什么新闻
贫血会引起手抖	贫血会引起手抖
六月一号需要带头盔吗	六月一号需要带头盔吗
眼睛怎样变大自然方法	眼睛怎样变大自然方法
临汾规划四街在哪	临汾规划四街在哪
什么不什么手成语有哪些	什么不什么手成语有哪些
萍果煮红枣有什么功能	萍果煮红枣有什么功能
角膜炎能治好	角膜炎能治好
北京五环的房价是多少	北京五环的房价是多少
孕妇可以喝金银花	孕妇可以喝金银花
塔吊六级风停止作业哪个规范	塔吊六级风停止作业哪个规范
扎手指验血能验出是否怀孕么	扎手指验血能验出是否怀孕么
湖北伤残补助金标准	湖北伤残补助金标准
以下皮损中消退快消退后不留痕迹的是	以下皮损中消退快消退后不留痕迹的是
心梗先兆症状吃什么药	心梗先兆症状吃什么药
海淀亿世界靠谱吗	海淀亿世界靠谱吗
江苏师范大学有哪些专业怎么样	江苏师范大学有哪些专业怎么样
陕西计算机二级报名费多少钱	陕西计算机二级报名费多少钱
韵达是马云的	韵达是马云的
慢性胃炎能吃海带	慢性胃炎能吃海带
怀孕后可以在家里钉钉子吗	怀孕后可以在家里钉钉子吗
你喜欢我吗	你喜欢我吗
川大哲学考研参考书目	川大哲学考研参考书目
iphone如何清除缓存数据	iphone如何清除缓存数据
爱你在干嘛	爱你在干嘛
月经一个月来两次正常	月经一个月来两次正常
三十六乘六	三十六乘六
龟头炎会传染给女性	龟头炎会传染给女性
有什么酒店	有什么酒店
月经推迟也没有怀孕的症状怎么回事	月经推迟也没有怀孕的症状怎么回事
打开小游戏	打开小游戏
北理工各专业分数线	北理工各专业分数线
三缸缺火是什么原因	三缸缺火是什么原因
来例假可以吃橘子	来例假可以吃橘子
之前得过肺结核用激素会复发吗	之前得过肺结核用激素会复发吗
小赢易贷怎么样靠谱吗	小赢易贷怎么样靠谱吗
临沂货车通行证网上办理	临沂货车通行证网上办理
抖音里面的流行音乐怎么没有搜索到	抖音里面的流行音乐怎么没有搜索到
慕丝妮火鸡面是国产的	慕丝妮火鸡面是国产的
沈阳外来人口需要隔离	沈阳外来人口需要隔离
避孕药有副作用	避孕药有副作用
孕妇可以喝乌鸡汤吗早期	孕妇可以喝乌鸡汤吗早期
肾结石能吃橘子	肾结石能吃橘子
医用酒精开启后有效期	医用酒精开启后有效期
网站攻击的常见方式	网站攻击的常见方式
登高中揭出前文所蕴含的比兴	登高中揭出前文所蕴含的比兴
一般拔牙之后要痛几小时	一般拔牙之后要痛几小时
哪个在攻击沉睡目标时不会让其苏醒	哪个在攻击沉睡目标时不会让其苏醒
打开输入法	打开输入法
老式显微镜有收藏的	老式显微镜有收藏的
贷款是转lpr好还是不转好	贷款是转lpr好还是不转好
优酷会员首三月六元是什么意思	优酷会员首三月六元是什么意思
经期可以吃枸杞	经期可以吃枸杞
昆明离阜阳有多远	昆明离阜阳有多远
怎么关机	怎么关机
农村医保可以补交	农村医保可以补交
验孕棒两条杠但是有来月经的感觉	验孕棒两条杠但是有来月经的感觉
今天星期几呀	今天星期几呀
你是机器人	你是机器人
猴头手串怎么盘变红视频	猴头手串怎么盘变红视频
什么酸奶喝了对身体好	什么酸奶喝了对身体好
邳州属于哪个市	邳州属于哪个市
阅读心电图的基本流程	阅读心电图的基本流程
科目二如何在考场买圈	科目二如何在考场买圈
上古卷轴五拉罗夫在哪	上古卷轴五拉罗夫在哪
五花肉炖豆腐土豆家常做法	五花肉炖豆腐土豆家常做法
中信信用卡怎么调账单日	中信信用卡怎么调账单日
张倩琳事件到底怎么样了	张倩琳事件到底怎么样了
孕妇能吃黄桃	孕妇能吃黄桃
丙肝会传染	丙肝会传染
我要咋样	我要咋样
胃不好能吃水果	胃不好能吃水果
你怎么这么聪明	你怎么这么聪明
过期的食用油可以吃	过期的食用油可以吃
一百以内的英语单词怎么写	一百以内的英语单词怎么写
二十年山东退休养老金调整方案	二十年山东退休养老金调整方案
机器人搭建有什么好处	机器人搭建有什么好处
龙岩开学时间二千零二十	龙岩开学时间二千零二十
你是谁呀	你是谁呀
骨刺怎样治疗比较好	骨刺怎样治疗比较好
孔雀钻石画适合挂哪里	孔雀钻石画适合挂哪里
什么轮胎噪音小抓地力好	什么轮胎噪音小抓地力好
a五是五g手机	a五是五g手机
哺乳期能吃米线	哺乳期能吃米线
八个月婴儿智力低下	八个月婴儿智力低下
二百乘二百	二百乘二百
开封东风小康四s店电话	开封东风小康四s店电话
谢娜追张杰追了多久	谢娜追张杰追了多久
需要刷机	需要刷机
扎手指验血能验出是否怀孕么	扎手指验血能验出是否怀孕么
咖啡能加红茶	咖啡能加红茶
肾虚会引起失眠	肾虚会引起失眠
喝牛奶可以长高	喝牛奶可以长高
不符合更年期雌激素变化作用的规律是	不符合更年期雌激素变化作用的规律是
叶伏天和余生是什么关系	叶伏天和余生是什么关系
孕妇可以喝酸奶	孕妇可以喝酸奶
你几年级毕业	你几年级毕业
复方氢氧化铝片孕妇可以吃	复方氢氧化铝片孕妇可以吃
建行app怎么查公积金	建行app怎么查公积金
建行电话密码忘记了怎么办	建行电话密码忘记了怎么办
甲状腺功能减退能治好	甲状腺功能减退能治好
邵阳内景点排名大全	邵阳内景点排名大全
孕妇可以吃鸡胗	孕妇可以吃鸡胗
请问三十二寸电视机什么牌子好	请问三十二寸电视机什么牌子好
天气怎么样	天气怎么样
喝酒喝多了会不会出现什么幻觉	喝酒喝多了会不会出现什么幻觉
表格怎么把sheet一起打印	表格怎么把sheet一起打印
五菱荣光v中门中控锁安装	五菱荣光v中门中控锁安装
死亡率是逐年变化的且变化幅度在不同的年龄段不同较年轻年龄段与较年老年龄	死亡率是逐年变化的且变化幅度在不同的年龄段不同较年轻年龄段与较年老年龄
睢宁县魏集中学怎么样	睢宁县魏集中学怎么样
六月黄道吉日	六月黄道吉日
痛风能喝茶	痛风能喝茶
眼底出血第二天还有扩散	眼底出血第二天还有扩散
直角的符号读作什么	直角的符号读作什么
西南交大研究生拟录取名单	西南交大研究生拟录取名单
两k二十职业业余混合赛怎么加入球队	两k二十职业业余混合赛怎么加入球队
苯甲酸钠抑制什么菌	苯甲酸钠抑制什么菌
氯雷他定片和盐酸西替利嗪片能一起服用吗	氯雷他定片和盐酸西替利嗪片能一起服用吗
怀孕初期会发热	怀孕初期会发热
王俊凯的身高	王俊凯的身高
qq网名女生有特殊符号	qq网名女生有特殊符号
香港的电邮是什么意思	香港的电邮是什么意思
腰椎间盘突出腰不疼大腿疼	腰椎间盘突出腰不疼大腿疼
香菜怎样保存时间长不腐烂	香菜怎样保存时间长不腐烂
你喜不喜欢旅游	你喜不喜欢旅游
二十年江西什么时候可以开学	二十年江西什么时候可以开学
胡桃木地板搭配什么颜色的家具	胡桃木地板搭配什么颜色的家具
utena正规品判定软件	utena正规品判定软件
已有社保异地还可以交吗	已有社保异地还可以交吗
晚上吃桃子会胖	晚上吃桃子会胖
飞行棋游戏规则图解	飞行棋游戏规则图解
喝完酒能洗澡	喝完酒能洗澡
开塞露有副作用	开塞露有副作用
我现在肚子饿了	我现在肚子饿了
九乘九	九乘九
乳腺增生可以喝蜂蜜	乳腺增生可以喝蜂蜜
五年级十一班用英语怎么说	五年级十一班用英语怎么说
嗖一圈安全吗选择导师安娜	嗖一圈安全吗选择导师安娜
粉象生活邀请一个人多少钱	粉象生活邀请一个人多少钱
鱼肝油有什么作用	鱼肝油有什么作用
根据劳动法第十四条规定	根据劳动法第十四条规定
农行招聘咨询电话	农行招聘咨询电话
全麦粉能不能做蛋糕	全麦粉能不能做蛋糕
甲减能治愈	甲减能治愈
小布你会唱什么歌	小布你会唱什么歌
有什么电影好看	有什么电影好看
面膜补水效果好的	面膜补水效果好的
怀孕初期可以吃牛油果	怀孕初期可以吃牛油果
济南先行区房价怎么样	济南先行区房价怎么样
你知道我是男的还是女的	你知道我是男的还是女的
现在几点钟了	现在几点钟了
千字文府罗将相从那篇开始	千字文府罗将相从那篇开始
在家干嘛呢	在家干嘛呢
静安建交委地址	静安建交委地址
keep下载后的运动视频在哪里删除	keep下载后的运动视频在哪里删除
脸上长斑是什么原因	脸上长斑是什么原因
新桥办居住证在哪里	新桥办居住证在哪里
甘蔗和马蹄煮水的功效与作用	甘蔗和马蹄煮水的功效与作用
晚上吃水果减肥	晚上吃水果减肥
孕妇能吃生蚝	孕妇能吃生蚝
深圳知名律师事务所	深圳知名律师事务所
衡水中学在临汾选址	衡水中学在临汾选址
小度小度今天天气怎么样	小度小度今天天气怎么样
兰花指捻红尘似水什么	兰花指捻红尘似水什么
脚面扭伤红肿该怎么办呀	脚面扭伤红肿该怎么办呀
文娱类完结小说排行榜	文娱类完结小说排行榜
王牌对王牌假装打电话的是哪一期	王牌对王牌假装打电话的是哪一期
一万二千一百二十三显示处理失败钱去哪里了	一万二千一百二十三显示处理失败钱去哪里了
生理期能喝茶	生理期能喝茶
二十乘二十四	二十乘二十四
七十八乘六	七十八乘六
大人最喜欢什么东西	大人最喜欢什么东西
电信套餐修改	电信套餐修改
月经推迟也没有怀孕的症状怎么回事	月经推迟也没有怀孕的症状怎么回事
有人宠你像个孩子的下一句	有人宠你像个孩子的下一句
建行定期利息	建行定期利息
男生第一次吃延时药可以吗	男生第一次吃延时药可以吗
沈阳锦麟河院怎么样	沈阳锦麟河院怎么样
怎么不行	怎么不行
平仓线一百三十是什么意思	平仓线一百三十是什么意思
丹拿二百三十二加功放跟不加功放	丹拿二百三十二加功放跟不加功放
吃完饭可以吃水果	吃完饭可以吃水果
巫师三怎么离开水井	巫师三怎么离开水井
怀孕可以喝姜糖水	怀孕可以喝姜糖水
郑州到烟台快递多少钱	郑州到烟台快递多少钱
如何分辨零线和火线	如何分辨零线和火线
扁桃体炎能抽烟	扁桃体炎能抽烟
vr体验馆怎么样	vr体验馆怎么样
删了前任他又加我啥意思	删了前任他又加我啥意思
拔火罐可以减肥	拔火罐可以减肥
肚子疼休克了是什么病	肚子疼休克了是什么病
怎么不唱歌了	怎么不唱歌了
进到随王位置和至今千里来桐柏中的词合适只	进到随王位置和至今千里来桐柏中的词合适只
酸汤子的做法视频教程	酸汤子的做法视频教程
洗衣机洗被套用多少水	洗衣机洗被套用多少水
芋头粉干的做法大全	芋头粉干的做法大全
血糖高的人可以吃红薯	血糖高的人可以吃红薯
直面惨淡的人生什么意思	直面惨淡的人生什么意思
国家环境质量标准由哪里制定	国家环境质量标准由哪里制定
清远旅游景点哪里好玩	清远旅游景点哪里好玩
方天画戟削苹果什么梗	方天画戟削苹果什么梗
白切鸡肉怎么做好吃法大全	白切鸡肉怎么做好吃法大全
摩托车可以上高速公路	摩托车可以上高速公路
凡尔赛体系形成的过程	凡尔赛体系形成的过程
婴儿能坐飞机	婴儿能坐飞机
西安交大什么时候开学	西安交大什么时候开学
天津离静海区有多远	天津离静海区有多远
西瓜皮可以生吃	西瓜皮可以生吃
焊接后产生角变形的原因是	焊接后产生角变形的原因是
boy尺码	boy尺码
可拉伸的爱心怎么叠	可拉伸的爱心怎么叠
你会唱少年吗	你会唱少年吗
天津台球厅营业了吗	天津台球厅营业了吗
上海农村危房鉴定标准	上海农村危房鉴定标准
减肥吃苹果可以	减肥吃苹果可以
孩子吃羊奶大便干燥怎么办	孩子吃羊奶大便干燥怎么办
苹果八plus怎么样	苹果八plus怎么样
螳螂吃蚂蚁	螳螂吃蚂蚁
近义词的四字成语	近义词的四字成语
交通事故赔护理费怎么算	交通事故赔护理费怎么算
金华汽车开锁公司电话	金华汽车开锁公司电话
我是不是马云	我是不是马云
猫把爪子张开什么意思	猫把爪子张开什么意思
怎样向对方发送我的位置	怎样向对方发送我的位置
长沙二十年城市总体规划	长沙二十年城市总体规划
甘肃的省会	甘肃的省会
肿瘤引起的性早熟有什么症状	肿瘤引起的性早熟有什么症状
例假期间可以艾灸	例假期间可以艾灸
青岛是哪个省的省会	青岛是哪个省的省会
华为无线路由如何恢复出厂设置	华为无线路由如何恢复出厂设置
城市桥梁工程施工与质量验收规范	城市桥梁工程施工与质量验收规范
姨妈快没了但是又来了	姨妈快没了但是又来了
楼梯的词语	楼梯的词语
香蕉脂肪高	香蕉脂肪高
哺乳期可以拔罐	哺乳期可以拔罐
你是男性还是女性	你是男性还是女性
clearimpression是什么品牌	clearimpression是什么品牌
八由哪两个数字组成	八由哪两个数字组成
如何退出登录	如何退出登录
苯甲酸钠抑制什么菌	苯甲酸钠抑制什么菌
你是机器人吗	你是机器人吗
妇炎洁可以治脚气	妇炎洁可以治脚气
柯基可以吃橘子	柯基可以吃橘子
狗狗拉稀出血怎么办	狗狗拉稀出血怎么办
八和二十四最小公倍数	八和二十四最小公倍数
怀孕可以吃麻油	怀孕可以吃麻油
细胞的结构和功能概念图	细胞的结构和功能概念图
颈椎病能每天洗澡吗	颈椎病能每天洗澡吗
乌鸦是怎么叫的文字	乌鸦是怎么叫的文字
原油下跌对中石化的影响	原油下跌对中石化的影响
怎么样能找到一个人的位置	怎么样能找到一个人的位置
近视眼会得老花眼	近视眼会得老花眼
清朝赔款实际支付总额	清朝赔款实际支付总额
白术和艾草一起煮水喝行吗	白术和艾草一起煮水喝行吗
怀孕了能吃桂圆	怀孕了能吃桂圆
吃橙子会胖	吃橙子会胖
该怎么办	该怎么办
为什么结婚要门当户对	为什么结婚要门当户对
九十六年七点二十三号什么星座	九十六年七点二十三号什么星座
双麦降噪的	双麦降噪的
二百乘二百	二百乘二百
怎么找对象	怎么找对象
用日语说	用日语说
三模八频的概念	三模八频的概念
射进去一次会怀孕	射进去一次会怀孕
家里突然来了一只鸟好不好	家里突然来了一只鸟好不好
眼底出血第二天还有扩散	眼底出血第二天还有扩散
听得到我说话	听得到我说话
宁河滨江锦园物业电话	宁河滨江锦园物业电话
充电器多少钱	充电器多少钱
肾结石可以吃红薯	肾结石可以吃红薯
华夏本来生活白金卡年费	华夏本来生活白金卡年费
没有wifi	没有wifi
伊利纯牛奶好	伊利纯牛奶好
ab胶硬度	ab胶硬度
医社保是什么意思	医社保是什么意思
八十除二	八十除二
你充电了吗	你充电了吗
怀集到三水高铁时间表	怀集到三水高铁时间表
口腔溃疡能吃橙子	口腔溃疡能吃橙子
快手上一天发几个作品容易热门	快手上一天发几个作品容易热门
玉金方的功效与作用	玉金方的功效与作用
宝宝发烧可以吃橙子	宝宝发烧可以吃橙子
可以和我玩游戏	可以和我玩游戏
离职和自离有什么后果	离职和自离有什么后果
甲状腺功能亢进症严重	甲状腺功能亢进症严重
浙江理工大学专业对选科的要求	浙江理工大学专业对选科的要求
宝马三百二十五仪表盘指示灯图解	宝马三百二十五仪表盘指示灯图解
重庆迈科唯待遇怎么样	重庆迈科唯待遇怎么样
我的妈妈早上六点钟起床的英文	我的妈妈早上六点钟起床的英文
oppowatch如何录音	oppowatch如何录音
孕妇能做心电图	孕妇能做心电图
坐地铁恶心呼吸不上来	坐地铁恶心呼吸不上来
频繁的出现心脏往下坠的感觉	频繁的出现心脏往下坠的感觉
带有政字的女孩名字	带有政字的女孩名字
感冒能打疫苗	感冒能打疫苗
描写边塞将士的诗句	描写边塞将士的诗句
打四价疫苗之前注意事项	打四价疫苗之前注意事项
你这啥意思	你这啥意思
荣威rx五有一键升窗功能吗	荣威rx五有一键升窗功能吗
经常喝柠檬蜂蜜水好	经常喝柠檬蜂蜜水好
双重趋避冲突的例子三个	双重趋避冲突的例子三个
面对面建群怎么拉人进来	面对面建群怎么拉人进来
我国第几批加入世卫组织	我国第几批加入世卫组织
oppo最新款	oppo最新款
你会不会打游戏	你会不会打游戏
白斑可以用激光治疗吗	白斑可以用激光治疗吗
朋友圈微视别人看不到	朋友圈微视别人看不到
甲状腺结节能吃海参	甲状腺结节能吃海参
怀孕可以喝豆腐脑	怀孕可以喝豆腐脑
汉赋九问兰草八章作者	汉赋九问兰草八章作者
武警一个师有多少人	武警一个师有多少人
你知道r十七	你知道r十七
梦幻西游低等级五开	梦幻西游低等级五开
沙漠的资源如何利用	沙漠的资源如何利用
输卵管堵塞还能排卵	输卵管堵塞还能排卵
枣仁安神胶囊的功效与作用	枣仁安神胶囊的功效与作用
水痘疫苗有必要打么	水痘疫苗有必要打么
来大姨妈能洗头	来大姨妈能洗头
九纳米光刻机是哪个公司生产	九纳米光刻机是哪个公司生产
蓝莓酱要熬多长时间	蓝莓酱要熬多长时间
你还会唱什么歌	你还会唱什么歌
你什么时候升级	你什么时候升级
系统可卸载应用找回	系统可卸载应用找回
蓝牙耳机没有充电头怎么充电	蓝牙耳机没有充电头怎么充电
gta五麦克机场任务怎么做	gta五麦克机场任务怎么做
怀孕了还会有白带	怀孕了还会有白带
市面上还有印尼菠萝格木吗	市面上还有印尼菠萝格木吗
有人宠你像个孩子的下一句	有人宠你像个孩子的下一句
怎样输入英语单词之间的空格	怎样输入英语单词之间的空格
防蓝光眼镜哪个牌子最好	防蓝光眼镜哪个牌子最好
国家环境质量标准由哪里制定	国家环境质量标准由哪里制定
有什么功能	有什么功能
真的假的	真的假的
为什么每天都会做乱七八糟的梦	为什么每天都会做乱七八糟的梦
月经能吃榴莲	月经能吃榴莲
福建到台湾有多少公里	福建到台湾有多少公里
北京甲状腺最好的医院	北京甲状腺最好的医院
女孩子大腿根部疼痛是什么原因	女孩子大腿根部疼痛是什么原因
社保局周末上班	社保局周末上班
身高一百八十的标准体重是多少	身高一百八十的标准体重是多少
电脑看不了百度文库	电脑看不了百度文库
福州到长沙多少公里	福州到长沙多少公里
红豆薏米小孩能喝	红豆薏米小孩能喝
怎么加好友不让他知道我是谁	怎么加好友不让他知道我是谁
产妇可以吃桃子	产妇可以吃桃子
太原南中环属于哪个区	太原南中环属于哪个区
两周岁宝宝耳温多少正常	两周岁宝宝耳温多少正常
你知道我的生日吗	你知道我的生日吗
脂肪肝可以当兵	脂肪肝可以当兵
你的声音可以大一点吗	你的声音可以大一点吗
南京治疗糖尿病最好的医院	南京治疗糖尿病最好的医院
六百除二十五	六百除二十五
经常带口罩会长黄褐斑吗	经常带口罩会长黄褐斑吗
肺炎有少量胸腔积液不住院行吗	肺炎有少量胸腔积液不住院行吗
孕妇能吃阿奇霉素片	孕妇能吃阿奇霉素片
身高一米八当啥兵种	身高一米八当啥兵种
咳嗽可以喝豆浆	咳嗽可以喝豆浆
拉肚子能喝酸奶	拉肚子能喝酸奶
我失恋了你能安慰我吗	我失恋了你能安慰我吗
家用暖气循环泵安装在什么位置合适	家用暖气循环泵安装在什么位置合适
男生叫什么网名最好听	男生叫什么网名最好听
为什么不能生你的气	为什么不能生你的气
盐酸萄糖胶囊的危害	盐酸萄糖胶囊的危害
明代有哪些诗人及作品	明代有哪些诗人及作品
希沃易课堂客服电话	希沃易课堂客服电话
健的大写字母怎么写	健的大写字母怎么写
你现在多大了	你现在多大了
农历六月是什么星座	农历六月是什么星座
沈阳十二中学是重点吗	沈阳十二中学是重点吗
吉普指南者轮胎品牌	吉普指南者轮胎品牌
吗啡片多长时间起效	吗啡片多长时间起效
小孩吃蛋白还是蛋黄好	小孩吃蛋白还是蛋黄好
那一年深圳成为了经济特区	那一年深圳成为了经济特区
怎样关闭豪华黄钻自动续费	怎样关闭豪华黄钻自动续费
手机上安装什么软件可以播放swf	手机上安装什么软件可以播放swf
三叉神经穿刺手术多久能恢复	三叉神经穿刺手术多久能恢复
减肥期间可以吃凉面	减肥期间可以吃凉面
诗句的颈联是哪几句	诗句的颈联是哪几句
机械制图圆锥辅助圆法	机械制图圆锥辅助圆法
怀孕会犯困	怀孕会犯困
海康摄像头怎样重置密码	海康摄像头怎样重置密码
对于卫律和李陵的劝降苏武的回答在措辞和态度上有什么不同	对于卫律和李陵的劝降苏武的回答在措辞和态度上有什么不同
二十年农历三月出生是什么命	二十年农历三月出生是什么命
小度打开拼多多	小度打开拼多多
避孕套带反了会怀孕	避孕套带反了会怀孕
邮政侯马中心在哪里	邮政侯马中心在哪里
粮票值钱	粮票值钱
七十年女性哪一年退休	七十年女性哪一年退休
怀孕能吃冷面	怀孕能吃冷面
怎么把广场舞视频下载到u盘	怎么把广场舞视频下载到u盘
强迫症可以治疗	强迫症可以治疗
满城尽带黄金甲在哪儿拍的	满城尽带黄金甲在哪儿拍的
荒野大镖客两线上线下哪个好玩	荒野大镖客两线上线下哪个好玩
怀孕能吃木耳	怀孕能吃木耳
你认识王源吗	你认识王源吗
江门皮肤医院是正规医院吗	江门皮肤医院是正规医院吗
我应该叫你什么	我应该叫你什么
月经期可以洗澡	月经期可以洗澡
既是二的倍数又是五的倍	既是二的倍数又是五的倍
单钢轮与双钢轮区别	单钢轮与双钢轮区别
一岁宝宝可以吃榴莲	一岁宝宝可以吃榴莲
喝酒影响月经	喝酒影响月经
你知道我的星座是什么吗	你知道我的星座是什么吗
网上如何问女生要微信	网上如何问女生要微信
我叫什么	我叫什么
重庆渝南自来水客服电话	重庆渝南自来水客服电话
云时代全屋整装怎样	云时代全屋整装怎样
拉肚子能吃橘子	拉肚子能吃橘子
经期可以吃芒果	经期可以吃芒果
怎么把广场舞视频下载到u盘	怎么把广场舞视频下载到u盘
排卵期肚子会痛	排卵期肚子会痛
喝蜂蜜上火	喝蜂蜜上火
支气管炎传染	支气管炎传染
体检前可以抽烟	体检前可以抽烟
oppo和vivo是一家	oppo和vivo是一家
师尊黑化的腹黑徒弟小说	师尊黑化的腹黑徒弟小说
今天天气如何	今天天气如何
你会啥呀	你会啥呀
你是谁呢	你是谁呢
华为手表有测血压功能吗	华为手表有测血压功能吗
我跟你是什么关系	我跟你是什么关系
孕妇可以吃黄花菜	孕妇可以吃黄花菜
强直脊柱炎吃什么水果好	强直脊柱炎吃什么水果好
长时间站着能减肥	长时间站着能减肥
特斯拉普工好面试吗	特斯拉普工好面试吗
皮肤有油脂粒怎么去除	皮肤有油脂粒怎么去除
游戏为什么退不出来	游戏为什么退不出来
0九立方米等多少立方分米	0九立方米等多少立方分米
高血压能吃菠菜	高血压能吃菠菜
怎么加好友不让他知道我是谁	怎么加好友不让他知道我是谁
如何设置充电声音	如何设置充电声音
神威参麦注射剂价格	神威参麦注射剂价格
五分之四乘七表示	五分之四乘七表示
儿童可以喝蜂蜜水	儿童可以喝蜂蜜水
游戏术语hp	游戏术语hp
如何查找淘宝的淘气值	如何查找淘宝的淘气值
沈阳养老保险个人缴费	沈阳养老保险个人缴费
怀孕可以吃花螺	怀孕可以吃花螺
哺乳期可以喝米酒	哺乳期可以喝米酒
光的三字组词有哪些	光的三字组词有哪些
六味地黄丸有副作用	六味地黄丸有副作用
从工资中扣回代垫分录	从工资中扣回代垫分录
洛阳什么地方好玩	洛阳什么地方好玩
学水彩可以找什么工作	学水彩可以找什么工作
乙肝小三阳传染	乙肝小三阳传染
西关大少陈继棠结局	西关大少陈继棠结局
小说三要素及其作用	小说三要素及其作用
肚子疼休克了是什么病	肚子疼休克了是什么病
开封武夷路属于哪个区	开封武夷路属于哪个区
郑州到烟台快递多少钱	郑州到烟台快递多少钱
在proteus软件中晶振的名称是什么	在proteus软件中晶振的名称是什么
农行怎么查询开户银行	农行怎么查询开户银行
我现在到哪里了	我现在到哪里了
孕妇能吃干贝	孕妇能吃干贝
咳嗽可以喝蜂蜜水	咳嗽可以喝蜂蜜水
属蛇七月出生好不好	属蛇七月出生好不好
换电话微信怎么恢复	换电话微信怎么恢复
生理期可以拔牙	生理期可以拔牙
冬虫夏草和什么一起吃比较好	冬虫夏草和什么一起吃比较好
四个月泰迪吃什么牌子狗粮	四个月泰迪吃什么牌子狗粮
来月经能吃阿胶	来月经能吃阿胶
山东农村无人居住的危房怎么处理	山东农村无人居住的危房怎么处理
常州大金空调售后维修电话四oo一九百六十七一八千八百一十八	常州大金空调售后维修电话四oo一九百六十七一八千八百一十八
火龙果可以减肥	火龙果可以减肥
月经期间可以喝中药	月经期间可以喝中药
荆芥性味归经功效主治	荆芥性味归经功效主治
三角函数四十度的正切值等多少	三角函数四十度的正切值等多少
而应声答曰未闻孔雀是夫子家禽翻译成白话文	而应声答曰未闻孔雀是夫子家禽翻译成白话文
四百九十除七	四百九十除七
a五十七如何快速充电	a五十七如何快速充电
怀孕能吃甲鱼	怀孕能吃甲鱼
八乘九	八乘九
肾炎严重	肾炎严重
演唱会在哪个软件可以看	演唱会在哪个软件可以看
写三月春暖花开的句子	写三月春暖花开的句子
我明天几点上班	我明天几点上班
乐曲名加书名号还是引号	乐曲名加书名号还是引号
坐月子可以吃车厘子	坐月子可以吃车厘子
你喜欢杨紫吗	你喜欢杨紫吗
你有收音机	你有收音机
脚气会传染到手上	脚气会传染到手上
剑来人间最得意是谁	剑来人间最得意是谁
艾滋病唾液传染	艾滋病唾液传染
网络密码是什么	网络密码是什么
华侨华人华裔有什么区别	华侨华人华裔有什么区别
感冒了可以打狂犬疫苗	感冒了可以打狂犬疫苗
吴亦凡火吗	吴亦凡火吗
皮肤有油脂粒怎么去除	皮肤有油脂粒怎么去除
鬼鬼杨洋快乐大本营第几期	鬼鬼杨洋快乐大本营第几期
常熟到濮阳的私家车	常熟到濮阳的私家车
一个人手举着一座山打一成语	一个人手举着一座山打一成语
农行最大股东是谁	农行最大股东是谁
宝宝发烧可以吃虾	宝宝发烧可以吃虾
大公报大陆为什么停刊	大公报大陆为什么停刊
有关法医和解剖的电视剧	有关法医和解剖的电视剧
痛经可以吃止疼药	痛经可以吃止疼药
吃中药能喝牛奶	吃中药能喝牛奶
开封阶梯电价收费标准	开封阶梯电价收费标准
南开学院是几本	南开学院是几本
十月革命后以为代表的先进分子	十月革命后以为代表的先进分子
坐月子可以吃花菜	坐月子可以吃花菜
经期可以吃葡萄	经期可以吃葡萄
招聘信息的弹性工作是什么意思	招聘信息的弹性工作是什么意思
你怎么不睡觉	你怎么不睡觉
蓝牙耳机怎么唤醒小布	蓝牙耳机怎么唤醒小布
怎么不合适	怎么不合适
九十六除三	九十六除三
枸杞石斛花泡水喝的功效	枸杞石斛花泡水喝的功效
兴义电子厂有招工的没	兴义电子厂有招工的没
加味逍遥丸搭配什么药比较好	加味逍遥丸搭配什么药比较好
过敏时哮喘发生的原因	过敏时哮喘发生的原因
接吻会怀孕	接吻会怀孕
小度打开抖音	小度打开抖音
突然胸痛胸闷是什么原因	突然胸痛胸闷是什么原因
痛风能吃红薯	痛风能吃红薯
如何显示修改后的文档	如何显示修改后的文档
解锁的密码是多少	解锁的密码是多少
怀孕可以吃苹果	怀孕可以吃苹果
阑尾炎手术后可以吃蛋糕	阑尾炎手术后可以吃蛋糕
广西有那些好的大专	广西有那些好的大专
五百四十除九	五百四十除九
怀孕初期可以吃枣	怀孕初期可以吃枣
肺上有个瘤子怎么治	肺上有个瘤子怎么治
天正软件是哪家公司的	天正软件是哪家公司的
两个名字的歌手有哪些	两个名字的歌手有哪些
june两nd怎么读	june两nd怎么读
贵定到金华高铁票查询	贵定到金华高铁票查询
如何清除健康使用手机	如何清除健康使用手机
五千加五千	五千加五千
写保护的u盘	写保护的u盘
怀孕初期可以吃生蚝	怀孕初期可以吃生蚝
山东有什么海	山东有什么海
护士未来职业生涯规划	护士未来职业生涯规划
oppo蓝牙音箱断开连接的设备	oppo蓝牙音箱断开连接的设备
怎么用卡纸做七巧板	怎么用卡纸做七巧板
月经期可以吃乌鸡白凤丸	月经期可以吃乌鸡白凤丸
香港的电邮是什么意思	香港的电邮是什么意思
王俊凯帅不帅	王俊凯帅不帅
html超链接格式	html超链接格式
坐月子能吃李子	坐月子能吃李子
五百零六乘二十四	五百零六乘二十四
电脑游戏里打字总是字母怎么办	电脑游戏里打字总是字母怎么办
千字文府罗将相从那篇开始	千字文府罗将相从那篇开始
为什么结婚要门当户对	为什么结婚要门当户对
一点五除二	一点五除二
康宁的盘子可以加热吗	康宁的盘子可以加热吗
宫颈糜烂治好会复发吗	宫颈糜烂治好会复发吗
外踝骨折严重	外踝骨折严重
五万兆流量等多少g	五万兆流量等多少g
涪陵旅游景点	涪陵旅游景点
戴隐形眼镜能睡觉	戴隐形眼镜能睡觉
打了利凡诺要注意什么	打了利凡诺要注意什么
女生会给男生看下面吗	女生会给男生看下面吗
感冒能吃葡萄	感冒能吃葡萄
小孩能吃冰淇淋	小孩能吃冰淇淋
新型肺炎对中小企业的影响	新型肺炎对中小企业的影响
旅游促销方案怎么写	旅游促销方案怎么写
坐月子可以做面膜	坐月子可以做面膜
招行信用卡卡片已寄出怎么查单号	招行信用卡卡片已寄出怎么查单号
脂肪肝能吃鸡肉	脂肪肝能吃鸡肉
过敏性皮炎能吃牛肉	过敏性皮炎能吃牛肉
跳绳可以减肥	跳绳可以减肥
多高的身高可以扣篮	多高的身高可以扣篮
南开文学院复试名单	南开文学院复试名单
十堰离武汉有多远	十堰离武汉有多远
孕妇吃葡萄干好	孕妇吃葡萄干好
你会不会打麻将	你会不会打麻将
孕妇能用炉甘石洗剂	孕妇能用炉甘石洗剂
月是故乡明作者在文中借月亮表达了什么	月是故乡明作者在文中借月亮表达了什么
删除u盘密码	删除u盘密码
苹果十一pages文稿闪退	苹果十一pages文稿闪退
四十七乘十五	四十七乘十五
黑色衬衫下面配什么好看	黑色衬衫下面配什么好看
企业定价时应考虑的因素	企业定价时应考虑的因素
狗狗能吃棒冰	狗狗能吃棒冰
西宁西川南路在哪个区	西宁西川南路在哪个区
你现在在干嘛呀	你现在在干嘛呀
天翼网关怎么关闭ipv六	天翼网关怎么关闭ipv六
多囊卵巢综合症能怀孕	多囊卵巢综合症能怀孕
爱玛电动车放了两个月无法用	爱玛电动车放了两个月无法用
郑州到济南汽车时刻表	郑州到济南汽车时刻表
最强nba教练属性加成有用吗	最强nba教练属性加成有用吗
电子厂学徒工资多少	电子厂学徒工资多少
如何设置语音唤醒	如何设置语音唤醒
周公解梦梦见自己在捡钱	周公解梦梦见自己在捡钱
肠胃炎能吃橙子	肠胃炎能吃橙子
通过丝绸之路传入中国的农作物或手工业品	通过丝绸之路传入中国的农作物或手工业品
九年的二手车能卖多少	九年的二手车能卖多少
怀孕能吃香蕉	怀孕能吃香蕉
十六岁还没有须佐能乎正常吗	十六岁还没有须佐能乎正常吗
美菱和半球热水壶哪个好	美菱和半球热水壶哪个好
你喜欢什么花	你喜欢什么花
怀孕能涂口红	怀孕能涂口红
脑出血前兆是什么反应	脑出血前兆是什么反应
晚上跑步减肥	晚上跑步减肥
一百二十五乘八十	一百二十五乘八十
九十除三十	九十除三十
美菱和半球热水壶哪个好	美菱和半球热水壶哪个好
你可不可以做我女朋友	你可不可以做我女朋友
巴楚到达喀什要隔离吗	巴楚到达喀什要隔离吗
清华第一校长	清华第一校长
我要玩词语王者	我要玩词语王者
四十八乘三	四十八乘三
怀孕可以吃提子	怀孕可以吃提子
近视眼贴有用	近视眼贴有用
猪是家禽	猪是家禽
国标凹凸面法兰标准	国标凹凸面法兰标准
糖尿病可以吃橙子	糖尿病可以吃橙子
三十mm是多少厘米	三十mm是多少厘米
白蜂蜡和小烛树蜡的区别	白蜂蜡和小烛树蜡的区别
孕妇可以吃鸡胗	孕妇可以吃鸡胗
婴宝湿疹膏有激素	婴宝湿疹膏有激素
小赢易贷怎么样靠谱吗	小赢易贷怎么样靠谱吗
雅美居装修公司电话	雅美居装修公司电话
david会变身成哪种动物	david会变身成哪种动物
咳嗽能游泳	咳嗽能游泳
人工客服在哪里	人工客服在哪里
十堰最好玩的地方	十堰最好玩的地方
来月经肚子特别疼怎么办啊	来月经肚子特别疼怎么办啊
辽宁各市城建排名	辽宁各市城建排名
形容春天雨夜的古诗词	形容春天雨夜的古诗词
植物大战僵尸两最强五阶植物	植物大战僵尸两最强五阶植物
秦皇岛到塘沽火车时刻表	秦皇岛到塘沽火车时刻表
阜新离锦州多远	阜新离锦州多远
白馒头是酸性还是碱性	白馒头是酸性还是碱性
脂肪肝可以买健康险吗	脂肪肝可以买健康险吗
不给你充电行不行	不给你充电行不行
二十年青木川古镇开放了吗	二十年青木川古镇开放了吗
黄浦是富人区	黄浦是富人区
泰州公积金查询电话	泰州公积金查询电话
美食的作文怎么写	美食的作文怎么写
橘子皮泡水是酸性还是碱性	橘子皮泡水是酸性还是碱性
玉米可以微波炉烤吗	玉米可以微波炉烤吗
抽完血能洗澡	抽完血能洗澡
我的手机还有多少g内存	我的手机还有多少g内存
小孩子能吃巧克力	小孩子能吃巧克力
经常性尿黄味道大是什么原因	经常性尿黄味道大是什么原因
报名厨师学校学费	报名厨师学校学费
书籍的装订方法有哪些	书籍的装订方法有哪些
嘴里长泡吃维生素几	嘴里长泡吃维生素几
药过期了还能吃	药过期了还能吃
阿司匹林和辛伐他丁什么时间吃	阿司匹林和辛伐他丁什么时间吃
德牧怕冷	德牧怕冷
每次提升成就等级时会获得什么额外奖励	每次提升成就等级时会获得什么额外奖励
在南方男生一百八十算不算高	在南方男生一百八十算不算高
转钱显示对方账户异常	转钱显示对方账户异常
宜昌建行营业时间	宜昌建行营业时间
北京女性平均身高	北京女性平均身高
牛奶可以和鸡蛋一起吃	牛奶可以和鸡蛋一起吃
药典规定制备注射用水的方法是	药典规定制备注射用水的方法是
肾结石可以吃豆芽	肾结石可以吃豆芽
办公楼窗户的常规尺寸	办公楼窗户的常规尺寸
学前教育和学前教育学的概念	学前教育和学前教育学的概念
怎么跟异地跟老公聊色话题	怎么跟异地跟老公聊色话题
王俊凯帅吗	王俊凯帅吗
小赢易贷怎么样靠谱吗	小赢易贷怎么样靠谱吗
招行账户管理费怎么取消	招行账户管理费怎么取消
女孩第一次会怀孕	女孩第一次会怀孕
怀孕可以吃白木耳	怀孕可以吃白木耳
慢性阑尾炎需要手术	慢性阑尾炎需要手术
孕五月尿频	孕五月尿频
月经期间能敷面膜	月经期间能敷面膜
爱玛电动车放了两个月无法用	爱玛电动车放了两个月无法用
孕妇可以吃核桃	孕妇可以吃核桃
怀孕能吃消炎药	怀孕能吃消炎药
长征一号是什么运载火箭	长征一号是什么运载火箭
逍遥在人间叹尘世妄言绝千恋什么意思	逍遥在人间叹尘世妄言绝千恋什么意思
日本aⅴ女星有那些	日本aⅴ女星有那些
嘴唇像枪舌头像剑形容争辩激烈	嘴唇像枪舌头像剑形容争辩激烈
我女儿叫什么	我女儿叫什么
带有政字的女孩名字	带有政字的女孩名字
来月经可以健身	来月经可以健身
经常性尿黄味道大是什么原因	经常性尿黄味道大是什么原因
试管婴儿的小孩是不是都是很健康的	试管婴儿的小孩是不是都是很健康的
你知道我的生日吗	你知道我的生日吗
皇沃汽车是什么品牌	皇沃汽车是什么品牌
主持人怎么介绍领导致辞	主持人怎么介绍领导致辞
k五如何长截图	k五如何长截图
痛风能吃饺子	痛风能吃饺子
比格巧克力草莓披萨的做法	比格巧克力草莓披萨的做法
justin是谁	justin是谁
主持人怎么介绍领导致辞	主持人怎么介绍领导致辞
血小板高是白血病	血小板高是白血病
刺激性物质存在于洋葱细胞的什么中	刺激性物质存在于洋葱细胞的什么中
湖南二十年四月自考时间	湖南二十年四月自考时间
等腰三角形旋转九十度的画法	等腰三角形旋转九十度的画法
胖的男人夏天怎么穿合适	胖的男人夏天怎么穿合适
药流后可以洗澡	药流后可以洗澡
苹果手机怎么删除id帐号	苹果手机怎么删除id帐号
景德镇枫树山林场领导	景德镇枫树山林场领导
鼻窦炎能治	鼻窦炎能治
怎样删掉电脑c盘中的文件	怎样删掉电脑c盘中的文件
肝硬化腹水严重应给予什么饮食	肝硬化腹水严重应给予什么饮食
有什么用呢	有什么用呢
减肥后面部憔悴怎么办	减肥后面部憔悴怎么办
怎样输入英语单词之间的空格	怎样输入英语单词之间的空格
签订建设工程合同应遵循的原则	签订建设工程合同应遵循的原则
腰间盘突出能练瑜伽	腰间盘突出能练瑜伽
隐私密码忘了怎么办	隐私密码忘了怎么办
喝水可以治疗感冒吗	喝水可以治疗感冒吗
工行算商业银行	工行算商业银行
你的偶像是谁	你的偶像是谁
排卵期胸会胀痛	排卵期胸会胀痛
k七支持红外线吗	k七支持红外线吗
宝马三百二十五仪表盘指示灯图解	宝马三百二十五仪表盘指示灯图解
飞机上能带生羊肉吗	飞机上能带生羊肉吗
甲状腺结节能吃海苔	甲状腺结节能吃海苔
月经能喝酒	月经能喝酒
二十年应用心理学考研国家线	二十年应用心理学考研国家线
狗狗能吃橘子	狗狗能吃橘子
来月经可以喝奶茶	来月经可以喝奶茶
八位数颜色代码	八位数颜色代码
智能家居房间管理功能	智能家居房间管理功能
富爸爸穷爸爸作者破产	富爸爸穷爸爸作者破产
闲鱼芝麻信用未授权的买家	闲鱼芝麻信用未授权的买家
吃苦瓜减肥	吃苦瓜减肥
押韵的八字口号	押韵的八字口号
子宫肌瘤能吃燕窝	子宫肌瘤能吃燕窝
幸运快三官方开奖结果	幸运快三官方开奖结果
孩子能吃蜂蜜	孩子能吃蜂蜜
月经期能喝茶	月经期能喝茶
如何关掉自动更新	如何关掉自动更新
类似一百二十三木头人的游戏	类似一百二十三木头人的游戏
怎么样形容一个女人不持家	怎么样形容一个女人不持家
人参健脾丸和平胃丸可以一起吃吗	人参健脾丸和平胃丸可以一起吃吗
水稳里可以用粉煤灰吗	水稳里可以用粉煤灰吗
我是不是要睡觉了	我是不是要睡觉了
小动物怎么过冬歌曲	小动物怎么过冬歌曲
甲亢能吃燕窝	甲亢能吃燕窝
三伏贴有用	三伏贴有用
有什么好看的电视剧	有什么好看的电视剧
怀孕可以吃提子	怀孕可以吃提子
世卫组织的作用	世卫组织的作用
体检怎样才能避免胸透	体检怎样才能避免胸透
开封东风小康四s店电话	开封东风小康四s店电话
先是声音嘶哑后咳嗽晚上加重	先是声音嘶哑后咳嗽晚上加重
崩坏学园两亲密度有什么用	崩坏学园两亲密度有什么用
支付宝里的小程序怎么做	支付宝里的小程序怎么做
有什么好看又有点污的漫画	有什么好看又有点污的漫画
女人多喝红枣枸杞水有什么好处	女人多喝红枣枸杞水有什么好处
社保自助经办平台使用时间	社保自助经办平台使用时间
月经前几天白带会增多	月经前几天白带会增多
梦到摸喜欢的人头发	梦到摸喜欢的人头发
如何去除书中的油墨味	如何去除书中的油墨味
孕妇吃紫薯好	孕妇吃紫薯好
年代热水器t十二m三十七价格	年代热水器t十二m三十七价格
四十二除六	四十二除六
今天是什么天气啊	今天是什么天气啊
你有没有哥哥	你有没有哥哥
我现在在什么地方	我现在在什么地方
脂肪肝可以吃猪肝	脂肪肝可以吃猪肝
半年工作总结结束语	半年工作总结结束语
是你美还是我美	是你美还是我美
经期可以拔牙	经期可以拔牙
一万二千一百二十三显示处理失败钱去哪里了	一万二千一百二十三显示处理失败钱去哪里了
这个很好笑吗	这个很好笑吗
空腹可以吃香蕉	空腹可以吃香蕉
什么生辰八字容易招鬼	什么生辰八字容易招鬼
孕四月不小心撞到肚子	孕四月不小心撞到肚子
二千零一十九内蒙古脱贫摘帽旗县名单	二千零一十九内蒙古脱贫摘帽旗县名单
男人对你说无语我该怎么回	男人对你说无语我该怎么回
感冒了还能给宝宝喂奶吗	感冒了还能给宝宝喂奶吗
怎样用电脑破解wifi	怎样用电脑破解wifi
oppowatch的价格	oppowatch的价格
肺上有个瘤子怎么治	肺上有个瘤子怎么治
我的妈妈早上六点钟起床的英文	我的妈妈早上六点钟起床的英文
你是什么呢	你是什么呢
磺酸的用途和注意事项	磺酸的用途和注意事项
龙舟的身体是什么颜色的	龙舟的身体是什么颜色的
一开始虐女主后来宠的小说	一开始虐女主后来宠的小说
孕妇可以吃鸭肉	孕妇可以吃鸭肉
电冰箱照明灯不亮什么原因	电冰箱照明灯不亮什么原因
肠胃炎可以喝蜂蜜水	肠胃炎可以喝蜂蜜水
你会法语吗	你会法语吗
怀孕初期可以吃火鸡面	怀孕初期可以吃火鸡面
贷款是转lpr好还是不转好	贷款是转lpr好还是不转好
联想电脑已重置应用默认设置	联想电脑已重置应用默认设置
来月经可以喝蜂蜜水	来月经可以喝蜂蜜水
白面少红薯多可以做出馒头	白面少红薯多可以做出馒头
先是声音嘶哑后咳嗽晚上加重	先是声音嘶哑后咳嗽晚上加重
在项目启动期间一名关键相关方	在项目启动期间一名关键相关方
十七乘十七	十七乘十七
滑石粉能吃	滑石粉能吃
化疗和靶向药物治疗效果哪个好	化疗和靶向药物治疗效果哪个好
农行信用卡怎么提前还款	农行信用卡怎么提前还款
有子宫肌瘤能吃燕窝	有子宫肌瘤能吃燕窝
怎么样形容一个女人不持家	怎么样形容一个女人不持家
拉肚子可以吃酸奶	拉肚子可以吃酸奶
你是不是想死	你是不是想死
哺乳期感冒可以喂奶	哺乳期感冒可以喂奶
请你写一句倡俭朴的宣传语	请你写一句倡俭朴的宣传语
艾滋病潜伏期能查出来	艾滋病潜伏期能查出来
红霉素软膏含有激素	红霉素软膏含有激素
减肥可以吃火锅	减肥可以吃火锅
帮我把音量调大一点	帮我把音量调大一点
生物之间物质和能量的传递主要是通过	生物之间物质和能量的传递主要是通过
智齿没长出来能拔	智齿没长出来能拔
新三界模式下退游的有多少	新三界模式下退游的有多少
你的希望是什么	你的希望是什么
开机无反应	开机无反应
面对面建群怎么拉人进来	面对面建群怎么拉人进来
月经期间能运动	月经期间能运动
申请公众号提示姓名不匹配	申请公众号提示姓名不匹配
什么不什么手成语有哪些	什么不什么手成语有哪些
在下图所示同一铸件的两种结构设计方案中哪一个方案是合理的为什么应分别	在下图所示同一铸件的两种结构设计方案中哪一个方案是合理的为什么应分别
感冒了能吃冰激凌	感冒了能吃冰激凌
海南住房公积金一年可以提取几次	海南住房公积金一年可以提取几次
一般拔牙之后要痛几小时	一般拔牙之后要痛几小时
戴避孕套会怀孕	戴避孕套会怀孕
请你写一句倡俭朴的宣传语	请你写一句倡俭朴的宣传语
吸毒后感觉下面在流水	吸毒后感觉下面在流水
吉林恒大温泉小镇在哪里	吉林恒大温泉小镇在哪里
医用酒精开启后有效期	医用酒精开启后有效期
避孕套有保质期	避孕套有保质期
感冒能喝啤酒	感冒能喝啤酒
熟牛蹄筋的蘸料怎么做	熟牛蹄筋的蘸料怎么做
韩红个人捐款多少钱了	韩红个人捐款多少钱了
孕妇能吃茶叶蛋	孕妇能吃茶叶蛋
南方人属于什么人种	南方人属于什么人种
女生说她哪里好看怎么回复	女生说她哪里好看怎么回复
融创乐园里面有吃饭的地方吗	融创乐园里面有吃饭的地方吗
胖的男人夏天怎么穿合适	胖的男人夏天怎么穿合适
二十年没有车船税吗	二十年没有车船税吗
丈夫的医保卡可以给老婆生孩子报销吗	丈夫的医保卡可以给老婆生孩子报销吗
九纳米光刻机是哪个公司生产	九纳米光刻机是哪个公司生产
六十五乘十五的竖式	六十五乘十五的竖式
十二和二十四的最大公因数是	十二和二十四的最大公因数是
甲亢能彻底治愈吗	甲亢能彻底治愈吗
月子里能吃蛋糕	月子里能吃蛋糕
一千加一千	一千加一千
六月怀孕几月生	六月怀孕几月生
描写边塞将士的诗句	描写边塞将士的诗句
疫苗都是病毒制成的吗	疫苗都是病毒制成的吗
拉肚子可以喝粥	拉肚子可以喝粥
淋巴严重	淋巴严重
借酒消愁的伤感句子	借酒消愁的伤感句子
鸡眼会自己好	鸡眼会自己好
怀孕可以吃龙眼	怀孕可以吃龙眼
重庆金辉城花样派房价	重庆金辉城花样派房价
龙舟的身体是什么颜色的	龙舟的身体是什么颜色的
我的手机号码是多少	我的手机号码是多少
招行如何定期转活期	招行如何定期转活期
台式无线网卡什么牌子的好	台式无线网卡什么牌子的好
月经期能吃西瓜	月经期能吃西瓜
什么病的人不能吃芹菜	什么病的人不能吃芹菜
直升飞机的样子作用和特点	直升飞机的样子作用和特点
肾衰竭能治好	肾衰竭能治好
吴亦凡在exo的地位	吴亦凡在exo的地位
吃完紧急避孕药可以喝酒	吃完紧急避孕药可以喝酒
孕妇可以吃兰花豆	孕妇可以吃兰花豆
可乐鸡翅怎么做	可乐鸡翅怎么做
怀孕能吃基围虾	怀孕能吃基围虾
剖腹产盆底肌训练什么时候开始	剖腹产盆底肌训练什么时候开始
连接wifi的软件	连接wifi的软件
五十四除三	五十四除三
与正和怀有关的成语	与正和怀有关的成语
到此为止用文言文怎么说	到此为止用文言文怎么说
妊娠糖尿病可以吃红薯	妊娠糖尿病可以吃红薯
经过一个角的顶点引这个角所在平面的斜线	经过一个角的顶点引这个角所在平面的斜线
武汉文一云水湾附近的规划	武汉文一云水湾附近的规划
你有什么技能	你有什么技能
刚怀孕会尿频	刚怀孕会尿频
了解的英文	了解的英文
农行员工人数	农行员工人数
爸爸妈妈是谁	爸爸妈妈是谁
斗罗大陆四为什么不更新了	斗罗大陆四为什么不更新了
便秘会导致痔疮	便秘会导致痔疮
ns怪物猎人gu怎么面联	ns怪物猎人gu怎么面联
常熟到濮阳的私家车	常熟到濮阳的私家车
水稳里可以用粉煤灰吗	水稳里可以用粉煤灰吗
韵达送到几点	韵达送到几点
万国上海维修地址	万国上海维修地址
如何去除书中的油墨味	如何去除书中的油墨味
葡萄糖分解成丙酮酸是什么反应	葡萄糖分解成丙酮酸是什么反应
网络主播是不是真的	网络主播是不是真的
oppo怎么打印	oppo怎么打印
微波炉能做蛋糕	微波炉能做蛋糕
卖零食赚钱	卖零食赚钱
斗罗大陆四为什么不更新了	斗罗大陆四为什么不更新了
梦幻西游手游强化打造项链需要哪种强化石	梦幻西游手游强化打造项链需要哪种强化石
家里的灯关灯后有时会闪一下	家里的灯关灯后有时会闪一下
钟南山的英语怎么读	钟南山的英语怎么读
糖尿病患者可以吃火龙果	糖尿病患者可以吃火龙果
打开相册	打开相册
二千零二十杭州小升初摇号结果	二千零二十杭州小升初摇号结果
你是不是想死	你是不是想死
湖北警官职业技术学校分数线	湖北警官职业技术学校分数线
学生复印件是什么意思	学生复印件是什么意思
普洱茶能减肥	普洱茶能减肥
农行卡网上怎么激活	农行卡网上怎么激活
重庆迈科唯待遇怎么样	重庆迈科唯待遇怎么样
哈尔滨正义街的位置	哈尔滨正义街的位置
胃不好能吃西瓜	胃不好能吃西瓜
oppo客服电话	oppo客服电话
铝的密度是多少	铝的密度是多少
黄体囊肿有什么危害	黄体囊肿有什么危害
还有什么意思	还有什么意思
牌照能换	牌照能换
肾炎能吃豆制品	肾炎能吃豆制品
明天有没有风	明天有没有风
酸梅汤能和牛奶一起吃吗	酸梅汤能和牛奶一起吃吗
交通事故赔护理费怎么算	交通事故赔护理费怎么算
御龙在天转国多少钱	御龙在天转国多少钱
十里春风不如你结局柳青	十里春风不如你结局柳青
怎么看出共同关注公众号的好友	怎么看出共同关注公众号的好友
膝盖可以拔罐	膝盖可以拔罐
pubg可以家庭共享吗	pubg可以家庭共享吗
可以设置来电秀	可以设置来电秀
南航是在机场北还是机场南	南航是在机场北还是机场南
你今年几岁	你今年几岁
么打电话	么打电话
西安到郑州多少公里	西安到郑州多少公里
农行咨询电话号码	农行咨询电话号码
为什么结婚要门当户对	为什么结婚要门当户对
今天是几号	今天是几号
喊出振兴中华最强音的是谁	喊出振兴中华最强音的是谁
眼底出血第二天还有扩散	眼底出血第二天还有扩散
洒布沥青材料时气温不应低于	洒布沥青材料时气温不应低于
孕五月宫高	孕五月宫高
十八乘九	十八乘九
今天天气怎么样啊	今天天气怎么样啊
子宫肌瘤影响怀孕	子宫肌瘤影响怀孕
驻马店格力空调总代理地址	驻马店格力空调总代理地址
鼻梁上有鸡皮疙瘩一样的小痘怎么办	鼻梁上有鸡皮疙瘩一样的小痘怎么办
家长不要对着孩子数一百二十三	家长不要对着孩子数一百二十三
大乐透六加二多少钱一注本金	大乐透六加二多少钱一注本金
你在思考什么	你在思考什么
连环画英文单词怎么写	连环画英文单词怎么写
无痛人流真的不痛	无痛人流真的不痛
试述生长素极性运输的机理	试述生长素极性运输的机理
明日之后料理包会不会掉落	明日之后料理包会不会掉落
黑米黑豆粥是不是不容易消化	黑米黑豆粥是不是不容易消化
海底两万里中里指什么	海底两万里中里指什么
哺乳期可以吃燕窝	哺乳期可以吃燕窝
古代皇子好听的字辈	古代皇子好听的字辈
你智商多少	你智商多少
广电是不是国企	广电是不是国企
原核细胞有没有复杂的细胞器	原核细胞有没有复杂的细胞器
孕妇可以吃海带丝	孕妇可以吃海带丝
现在该干嘛	现在该干嘛
离过年还有多久	离过年还有多久
春回大地风光好下联	春回大地风光好下联
还有多少天	还有多少天
经期可以喝中药	经期可以喝中药
今天有没有太阳	今天有没有太阳
交行网银转账限额	交行网银转账限额
陈情表出自哪位西晋文学家	陈情表出自哪位西晋文学家
家里突然来了一只鸟好不好	家里突然来了一只鸟好不好
有胃病能喝酸奶	有胃病能喝酸奶
大乐透六加二多少钱一注本金	大乐透六加二多少钱一注本金
荨麻疹可以吃红薯	荨麻疹可以吃红薯
全民宫斗怎么生孩子	全民宫斗怎么生孩子
嘴角痒脱皮发黑是怎么回事	嘴角痒脱皮发黑是怎么回事
黑枸杞孕妇能吃	黑枸杞孕妇能吃
你玩过王者	你玩过王者
哺乳期可以洗牙	哺乳期可以洗牙
江苏治疗肿瘤的医院排名	江苏治疗肿瘤的医院排名
为什么没有网	为什么没有网
怎样让水晶泥变硬一些	怎样让水晶泥变硬一些
如何调字体大小	如何调字体大小
莜面窝窝头的做法大全窍门	莜面窝窝头的做法大全窍门
三体系外审是指什么	三体系外审是指什么
身高一米八当啥兵种	身高一米八当啥兵种
新鲜竹笋怎么做不麻嘴	新鲜竹笋怎么做不麻嘴
北京s一线首末时刻表	北京s一线首末时刻表
后颈部长痘痘用什么药好	后颈部长痘痘用什么药好
睢宁县魏集中学怎么样	睢宁县魏集中学怎么样
中石化财务部主任	中石化财务部主任
我能帮你什么	我能帮你什么
申请公积金需要准备什么材料	申请公积金需要准备什么材料
清朝赔款实际支付总额	清朝赔款实际支付总额
怎么查残疾证被公司套用	怎么查残疾证被公司套用
甲亢严重	甲亢严重
中国交通最差的城市	中国交通最差的城市
建行购房贷款条件	建行购房贷款条件
我说的是普通话吗	我说的是普通话吗
吃榴莲上火	吃榴莲上火
a五十七t手机怎么分屏	a五十七t手机怎么分屏
三年级所有古诗	三年级所有古诗
清华比较好的专业	清华比较好的专业
张倩琳事件到底怎么样了	张倩琳事件到底怎么样了
四乘十四	四乘十四
修丽可的护肤品怎么样	修丽可的护肤品怎么样
狗狗拉稀出血怎么办	狗狗拉稀出血怎么办
厦大的热门专业	厦大的热门专业
你是人还是机器人	你是人还是机器人
电源键是哪一个	电源键是哪一个
屁股大用英文怎么说	屁股大用英文怎么说
视频会议软件把电脑卡死了	视频会议软件把电脑卡死了
常德有哪些厂招工	常德有哪些厂招工
身份证丢了能坐飞机	身份证丢了能坐飞机
充电宝要托运	充电宝要托运
串钩用什么线不缠绕	串钩用什么线不缠绕
嘿你是谁	嘿你是谁
高铁站是郑州东站吗	高铁站是郑州东站吗
北方四月应季水果	北方四月应季水果
三十厘米等多少立方厘米	三十厘米等多少立方厘米
卡超级加倍什么意思	卡超级加倍什么意思
痛风可以吃花生	痛风可以吃花生
十二乘五十	十二乘五十
深圳物价局客服电话	深圳物价局客服电话
四百八十除十二	四百八十除十二
剖腹产盆底肌训练什么时候开始	剖腹产盆底肌训练什么时候开始
身份证号码怎么	身份证号码怎么
什么是人生最早出现的认识过程是其他认识过程的基础	什么是人生最早出现的认识过程是其他认识过程的基础
怎么制作多链接海报	怎么制作多链接海报
直面惨淡的人生什么意思	直面惨淡的人生什么意思
燃气热水器温度下不来咋回事	燃气热水器温度下不来咋回事
怀孕可以游泳	怀孕可以游泳
两个月宝宝下颚有白点	两个月宝宝下颚有白点
感冒吐血是什么原因引起的	感冒吐血是什么原因引起的
我有多重	我有多重
站桩站着满肚子都是气怎么办	站桩站着满肚子都是气怎么办
房管局备案夫妻都要去吗	房管局备案夫妻都要去吗
这个手机是oppoa几	这个手机是oppoa几
今天是什么日子	今天是什么日子
你怎么管	你怎么管
胃不好可以吃桃胶	胃不好可以吃桃胶
猪脚扣肉的制作过程	猪脚扣肉的制作过程
牧原集团类似的企业	牧原集团类似的企业
氯雷他定片和盐酸西替利嗪片能一起服用吗	氯雷他定片和盐酸西替利嗪片能一起服用吗
西安六月份热吗	西安六月份热吗
怀孕可以吃黄骨鱼	怀孕可以吃黄骨鱼
还有什么	还有什么
一米五的身高标准体重应该是多少	一米五的身高标准体重应该是多少
女生月经推迟十天正常吗	女生月经推迟十天正常吗
怀孕可以吃冰淇淋	怀孕可以吃冰淇淋
你会说日语吗	你会说日语吗
小孩缺乏生长激素必须要打吗	小孩缺乏生长激素必须要打吗
圆锥体积的公式是什么	圆锥体积的公式是什么
月经来了可以吃橙子	月经来了可以吃橙子
女生来姨妈可以吃薯片	女生来姨妈可以吃薯片
猫粮自己做怎么配方	猫粮自己做怎么配方
铺开并向四周伸展成语	铺开并向四周伸展成语
拉肚子可以喂母乳	拉肚子可以喂母乳
昌平区兴寿镇半壁店书记	昌平区兴寿镇半壁店书记
红色枫叶歌词薛之谦	红色枫叶歌词薛之谦
三十五乘三	三十五乘三
孕妇血糖高可以吃橙子	孕妇血糖高可以吃橙子
飞行棋游戏规则图解	飞行棋游戏规则图解
手术后能吃海鲜	手术后能吃海鲜
孕妇可以用双氧水	孕妇可以用双氧水
视频会议软件把电脑卡死了	视频会议软件把电脑卡死了
committee的意思中文翻译	committee的意思中文翻译
城身份证开头	城身份证开头
帮我找找	帮我找找
十五乘四十二	十五乘四十二
牛肉和西瓜能一起吃	牛肉和西瓜能一起吃
西安属于历史古都吗	西安属于历史古都吗
北京甲状腺最好的医院	北京甲状腺最好的医院
会计人员应根据什么及有关资料编制记账凭证	会计人员应根据什么及有关资料编制记账凭证
先是声音嘶哑后咳嗽晚上加重	先是声音嘶哑后咳嗽晚上加重
发芽的姜能吃	发芽的姜能吃
经常洗手液洗手手背上小疙瘩有点痒	经常洗手液洗手手背上小疙瘩有点痒
怀孕可以吃芋头	怀孕可以吃芋头
比熊能吃红薯	比熊能吃红薯
负一的负一次方	负一的负一次方
感冒咳嗽可以吃蛋糕	感冒咳嗽可以吃蛋糕
昆曲传承的当代意义	昆曲传承的当代意义
哺乳期可以吃绿豆汤	哺乳期可以吃绿豆汤
化疗要住院	化疗要住院
零点一百七十五除零点二五	零点一百七十五除零点二五
小孩可以吃芒果	小孩可以吃芒果
下午能打预防针	下午能打预防针
粉象生活邀请一个人多少钱	粉象生活邀请一个人多少钱
胖的男人夏天怎么穿合适	胖的男人夏天怎么穿合适
chin是什么意思中文翻译	chin是什么意思中文翻译
浙大学号	浙大学号
来姨妈可以吃芒果	来姨妈可以吃芒果
孕妇可以吃烤地瓜	孕妇可以吃烤地瓜
拉肚子可以吃橘子	拉肚子可以吃橘子
samuelmorse发明了什么	samuelmorse发明了什么
慢性非萎缩性胃炎能吃方便面吗	慢性非萎缩性胃炎能吃方便面吗
广发信用卡好申请	广发信用卡好申请
一千零八十p高清画质的	一千零八十p高清画质的
怎样把循环小数化成分数方法	怎样把循环小数化成分数方法
膝盖能拔罐	膝盖能拔罐
华夏京东支付有积分	华夏京东支付有积分
豆浆能隔夜喝	豆浆能隔夜喝
支付宝账户可以注销	支付宝账户可以注销
六十四乘三点一四	六十四乘三点一四
次氯酸钠与盐酸反应生成什么	次氯酸钠与盐酸反应生成什么
中国的一号病人是谁	中国的一号病人是谁
孕妇可以吃烧仙草	孕妇可以吃烧仙草
你怎么还不睡	你怎么还不睡
广东七十岁以上老人补贴	广东七十岁以上老人补贴
吃鸡铂金一上面是什么段位	吃鸡铂金一上面是什么段位
哺乳期可以吃板蓝根颗粒	哺乳期可以吃板蓝根颗粒
相提什么什么救人四字成语	相提什么什么救人四字成语
大姨妈一个月来两次正常	大姨妈一个月来两次正常
御龙在天转国多少钱	御龙在天转国多少钱
怀孕可以吃草鱼	怀孕可以吃草鱼
多囊卵巢综合征好治	多囊卵巢综合征好治
神经性耳聋可以治愈	神经性耳聋可以治愈
公司降本增效的方法	公司降本增效的方法
华为手机反差色怎么调回来	华为手机反差色怎么调回来
仓鼠身上有跳蚤怎么办	仓鼠身上有跳蚤怎么办
两m的网速	两m的网速
做引产疼	做引产疼
小孩可以涂万金油吗	小孩可以涂万金油吗
三万七千一百三十二身份证是哪里的	三万七千一百三十二身份证是哪里的
枣仁安神胶囊的功效与作用	枣仁安神胶囊的功效与作用
痛风可以吃芋艿	痛风可以吃芋艿
你卖多少钱	你卖多少钱
孕妇可以吃紫薯	孕妇可以吃紫薯
从小不发烧是好事还是坏事	从小不发烧是好事还是坏事
哺乳期可以喝可乐雪碧	哺乳期可以喝可乐雪碧
快手怎么查看别人	快手怎么查看别人
东莞到杭州	东莞到杭州
陈情令的粉丝名是什么	陈情令的粉丝名是什么
来月经可以运动	来月经可以运动
散装酒可以快递	散装酒可以快递
关于非洲的高分电影	关于非洲的高分电影
微信图片打印机怎么打印	微信图片打印机怎么打印
科大分数线	科大分数线
红色枫叶歌词薛之谦	红色枫叶歌词薛之谦
痛风能吃豆芽	痛风能吃豆芽
慢性胃炎能治好	慢性胃炎能治好
皇沃汽车是什么品牌	皇沃汽车是什么品牌
河北省内异地就医备案流程	河北省内异地就医备案流程
喝水能减肥	喝水能减肥
风景唯美心情说说短句	风景唯美心情说说短句
怎么修改手机号	怎么修改手机号
乙肝会传染	乙肝会传染
训练德国牧羊犬的方法	训练德国牧羊犬的方法
起泡胶粘在裤子上怎么弄	起泡胶粘在裤子上怎么弄
你是中国人吗	你是中国人吗
番茄可以和豆奶一起吃吗	番茄可以和豆奶一起吃吗
询盘三天内回复旺旺几小时内回复的算及时回复率	询盘三天内回复旺旺几小时内回复的算及时回复率
怎么样能找到一个人的位置	怎么样能找到一个人的位置
瘦颧骨手术多少钱张笑天	瘦颧骨手术多少钱张笑天
bbc频率	bbc频率
邵阳内景点排名大全	邵阳内景点排名大全
公立医院为什么都没有男科	公立医院为什么都没有男科
中石化优惠时间	中石化优惠时间
昌平区兴寿镇半壁店书记	昌平区兴寿镇半壁店书记
三角形的周长	三角形的周长
乐曲名加书名号还是引号	乐曲名加书名号还是引号
五十二乘四	五十二乘四
瓷器对欧洲的影响	瓷器对欧洲的影响
霉菌性阴道炎能怀孕	霉菌性阴道炎能怀孕
知道八五七什么意思吗	知道八五七什么意思吗
一元二次函数求根公式一元二次方程怎么解	一元二次函数求根公式一元二次方程怎么解
心衰能治好	心衰能治好
汉赋九问兰草八章作者	汉赋九问兰草八章作者
婚姻法有破坏家庭罪吗	婚姻法有破坏家庭罪吗
裁剪视频区域的软件	裁剪视频区域的软件
梅毒是艾滋病	梅毒是艾滋病
一茶匙是多少毫升	一茶匙是多少毫升
演唱会在哪个软件可以看	演唱会在哪个软件可以看
你有喜欢的人	你有喜欢的人
乳腺增生能吃燕窝	乳腺增生能吃燕窝
灰指甲传染	灰指甲传染
keep下载后的运动视频在哪里删除	keep下载后的运动视频在哪里删除
清朝赔款实际支付总额	清朝赔款实际支付总额
吉利汽车三月份销量	吉利汽车三月份销量
微信收款码怎么删除收款记录	微信收款码怎么删除收款记录
大众suv车型大全斯柯达十万	大众suv车型大全斯柯达十万
怀孕了可以缝针线活吗	怀孕了可以缝针线活吗
abb的颜色	abb的颜色
常州最新防疫政策	常州最新防疫政策
白癜风能根治	白癜风能根治
健的大写字母怎么写	健的大写字母怎么写
咳嗽可以打预防针	咳嗽可以打预防针
全切双眼皮多久能戴隐形眼镜	全切双眼皮多久能戴隐形眼镜
拉肚子可以喝咖啡	拉肚子可以喝咖啡
你在干什么	你在干什么
一男两女三人唯美网名	一男两女三人唯美网名
俄罗斯清洁线好用吗	俄罗斯清洁线好用吗
八六版西游记白骨精的扮演者杨春霞	八六版西游记白骨精的扮演者杨春霞
胆固醇高能吃鸡蛋	胆固醇高能吃鸡蛋
肠胃炎可以吃香蕉	肠胃炎可以吃香蕉
包装设计的抄袭和借鉴界定	包装设计的抄袭和借鉴界定
保健品能治病	保健品能治病
日文怎么说	日文怎么说
我爱的人是谁	我爱的人是谁
婚姻法有破坏家庭罪吗	婚姻法有破坏家庭罪吗
怎么把领带系成蝴蝶结	怎么把领带系成蝴蝶结
二十年浙江哪天出梅	二十年浙江哪天出梅
故障灯用解码器解码后还亮	故障灯用解码器解码后还亮
本机电池容量	本机电池容量
剑来人间最得意是谁	剑来人间最得意是谁
什么都可以	什么都可以
声音怎么这么小	声音怎么这么小
苹果店里买可以刻字吗	苹果店里买可以刻字吗
勾线笔画到塑料桌子上怎么办	勾线笔画到塑料桌子上怎么办
怀孕能喝苹果醋	怀孕能喝苹果醋
产妇能吃茄子	产妇能吃茄子
糖尿病患者可以吃火龙果	糖尿病患者可以吃火龙果
便秘会便血	便秘会便血
怀二胎头疼是怎么回事	怀二胎头疼是怎么回事
卡在oppo界面无法开机	卡在oppo界面无法开机
做完骨扫描多久可以接触孩子	做完骨扫描多久可以接触孩子
电脑看不了百度文库	电脑看不了百度文库
吃橙子可以减肥	吃橙子可以减肥
初中求角度的方法总结	初中求角度的方法总结
六十二点八除三点一四	六十二点八除三点一四
明日之后料理包会不会掉落	明日之后料理包会不会掉落
泡脚能减肥	泡脚能减肥
熬夜会导致月经推迟	熬夜会导致月经推迟
来玩猜谜语吧	来玩猜谜语吧
株洲考驾照多少钱	株洲考驾照多少钱
二十五乘二十五	二十五乘二十五
印度带鼻环什么意思	印度带鼻环什么意思
鱼缸里睡莲的种植方法	鱼缸里睡莲的种植方法
按哪个穴位可以缓解头晕	按哪个穴位可以缓解头晕
身高一百八十的标准体重是多少	身高一百八十的标准体重是多少
紫砂工艺师职称等级	紫砂工艺师职称等级
游戏三个字情侣名字	游戏三个字情侣名字
日本aⅴ女星有那些	日本aⅴ女星有那些
眼睛怎样变大自然方法	眼睛怎样变大自然方法
肾结石面粉类可以吃	肾结石面粉类可以吃
吃黄瓜可以减肥	吃黄瓜可以减肥
哺乳期可以吃党参	哺乳期可以吃党参
眼镜店验光一般收费多少呢	眼镜店验光一般收费多少呢
姨妈快没了但是又来了	姨妈快没了但是又来了
孕妇可以吃香菇	孕妇可以吃香菇
怀孕可以吃黄豆	怀孕可以吃黄豆
三角函数四十度的正切值等多少	三角函数四十度的正切值等多少
一百一十平房子喷漆大概需要多少	一百一十平房子喷漆大概需要多少
怀孕初期能喝可乐	怀孕初期能喝可乐
肾结石可以吃豆制品	肾结石可以吃豆制品
大概在六七千年前在陶器上就能发现一些符号	大概在六七千年前在陶器上就能发现一些符号
哺乳期能吃松花蛋	哺乳期能吃松花蛋
生理期可以喝红糖水	生理期可以喝红糖水
word怎么一键生成表格	word怎么一键生成表格
盐酸萄糖胶囊的危害	盐酸萄糖胶囊的危害
嘴唇像枪舌头像剑形容争辩激烈	嘴唇像枪舌头像剑形容争辩激烈
蜂蜜对胃好	蜂蜜对胃好
喉咙发炎可以吃雪糕	喉咙发炎可以吃雪糕
来例假能喝酒	来例假能喝酒
痛风能吃馒头	痛风能吃馒头
广州服装批发市场的工资大概多少	广州服装批发市场的工资大概多少
猫妈妈为什么不管小猫	猫妈妈为什么不管小猫
泡面可以加生鸡蛋吗	泡面可以加生鸡蛋吗
幸运飞艇微信群那里有天香威三百三十九万一千八百四十一	幸运飞艇微信群那里有天香威三百三十九万一千八百四十一
植物晚上释放的是二氧化碳还是氧气	植物晚上释放的是二氧化碳还是氧气
临沂到丽水物流	临沂到丽水物流
抽血后可以洗澡	抽血后可以洗澡
锁屏密码是多少	锁屏密码是多少
肺水肿严重	肺水肿严重
深基坑和浅基坑的区别	深基坑和浅基坑的区别
哺乳期可以吃葡萄	哺乳期可以吃葡萄
苏州在浙江	苏州在浙江
重庆银行渝中区网点分布	重庆银行渝中区网点分布
混凝土抽样数量最低多少	混凝土抽样数量最低多少
鼻梁上有鸡皮疙瘩一样的小痘怎么办	鼻梁上有鸡皮疙瘩一样的小痘怎么办
不完全履行合同定金怎么算	不完全履行合同定金怎么算
孕妇能吃石榴	孕妇能吃石榴
生活如此美好用英文怎么说	生活如此美好用英文怎么说
裸车十万上路得多少钱	裸车十万上路得多少钱
番茄可以和豆奶一起吃吗	番茄可以和豆奶一起吃吗
八十除五	八十除五
白斑可以用激光治疗吗	白斑可以用激光治疗吗
宝宝发烧可以开空调	宝宝发烧可以开空调
孕后期可以吃冰淇淋	孕后期可以吃冰淇淋
孕妇感冒可以喝姜汤	孕妇感冒可以喝姜汤
三点一四乘四	三点一四乘四
蓝海吉祥切割片怎么样	蓝海吉祥切割片怎么样
我国的陆上邻国中面积最大的是什么人口最多的是什么	我国的陆上邻国中面积最大的是什么人口最多的是什么
我生日是多少	我生日是多少
建行养老理财产品	建行养老理财产品
已有社保异地还可以交吗	已有社保异地还可以交吗
阅读心电图的基本流程	阅读心电图的基本流程
恶性肿瘤是癌症	恶性肿瘤是癌症
渭南事业编制工资	渭南事业编制工资
keep下载后的运动视频在哪里删除	keep下载后的运动视频在哪里删除
李子吃多了会胖	李子吃多了会胖
人流手术后能吃小龙虾吗	人流手术后能吃小龙虾吗
中通北京到沈阳	中通北京到沈阳
番茄可以和豆奶一起吃吗	番茄可以和豆奶一起吃吗
标准的胸围腰围臀围是多少	标准的胸围腰围臀围是多少
ups不间断电源改逆变器	ups不间断电源改逆变器
甲亢能治愈	甲亢能治愈
天津离静海区有多远	天津离静海区有多远
火车进站前几分钟停止检票	火车进站前几分钟停止检票
我能抱你吗	我能抱你吗
荨麻疹可以吃桃子	荨麻疹可以吃桃子
怀孕能吃醋	怀孕能吃醋
猫虱子咬的包是啥样子	猫虱子咬的包是啥样子
凡尔赛体系形成的过程	凡尔赛体系形成的过程
鼻梁上有鸡皮疙瘩一样的小痘怎么办	鼻梁上有鸡皮疙瘩一样的小痘怎么办
家长代表感谢家长志愿者的话语	家长代表感谢家长志愿者的话语
你的希望是什么	你的希望是什么
来月经能吃火龙果	来月经能吃火龙果
两个名字的歌手有哪些	两个名字的歌手有哪些
周口什么时候开学	周口什么时候开学
日本经济什么时候开始腾飞	日本经济什么时候开始腾飞
甲哨唑注射夜的副作用	甲哨唑注射夜的副作用
真菌感染可以用碘伏	真菌感染可以用碘伏
十五乘五十六	十五乘五十六
三百除五十	三百除五十
苹果手机为什么一卡顿就重启	苹果手机为什么一卡顿就重启
二十四乘八	二十四乘八
无痛人流怎么样恢复快	无痛人流怎么样恢复快
网上兼职是真的	网上兼职是真的
正方体的体积	正方体的体积
眼药水有副作用	眼药水有副作用
五分加五分	五分加五分
黄钻消失了背景墙会消失吗	黄钻消失了背景墙会消失吗
kn九十五的牌子	kn九十五的牌子
南宁到郑州火车票	南宁到郑州火车票
在快手评论别人久久的话	在快手评论别人久久的话
胆囊炎能吃鸭蛋	胆囊炎能吃鸭蛋
如果是梦就好了日文歌	如果是梦就好了日文歌
花都君悦酒店在哪里	花都君悦酒店在哪里
醉后不知天在水满船清梦压星河什么意思	醉后不知天在水满船清梦压星河什么意思
怀孕可以吃鸭肠	怀孕可以吃鸭肠
你不困吗	你不困吗
孕妇可以喝茉莉绿茶	孕妇可以喝茉莉绿茶
项目资本金比例规定	项目资本金比例规定
人流后可以吃益母草	人流后可以吃益母草
怎么可以语音召唤	怎么可以语音召唤
网上如何问女生要微信	网上如何问女生要微信
孕妇可以吃草莓	孕妇可以吃草莓
哺乳期能吃薄荷糖	哺乳期能吃薄荷糖
九百九十九乘九十九	九百九十九乘九十九
乌鲁木齐到义乌的飞机几点到	乌鲁木齐到义乌的飞机几点到
鸡蛋和牛奶能一起吃吗	鸡蛋和牛奶能一起吃吗
社保自助经办平台使用时间	社保自助经办平台使用时间
激光祛斑疼	激光祛斑疼
风神h三十自动挡怎么样	风神h三十自动挡怎么样
朋友送自己假口红怎么办	朋友送自己假口红怎么办
怀孕能吃火鸡	怀孕能吃火鸡
该在河里死井里死不了	该在河里死井里死不了
u盘直接放iso文件能安装系统吗	u盘直接放iso文件能安装系统吗
左旋肉碱胶囊有用	左旋肉碱胶囊有用
蚕豆病发病怎么治疗	蚕豆病发病怎么治疗
酊剂的乙醇浓度是多少	酊剂的乙醇浓度是多少
正弦余弦函数最大值最小值	正弦余弦函数最大值最小值
标志杆厂家六千二百六十六一七百八十八沧州胜翔实体厂家电话	标志杆厂家六千二百六十六一七百八十八沧州胜翔实体厂家电话
斗罗大陆四为什么不更新了	斗罗大陆四为什么不更新了
都安到南宁拼车顺风车群	都安到南宁拼车顺风车群
男人对你说无语我该怎么回	男人对你说无语我该怎么回
你喜欢打王者	你喜欢打王者
语法分为哪两个部分	语法分为哪两个部分
解脲脲原体会自愈	解脲脲原体会自愈
孕妇可以吃荠菜	孕妇可以吃荠菜
根据劳动法第十四条规定	根据劳动法第十四条规定
痛风能吃橙子	痛风能吃橙子
今天什么时候	今天什么时候
宫颈炎可以治愈	宫颈炎可以治愈
去建行办etc需要什么	去建行办etc需要什么
易烊千玺帅吗	易烊千玺帅吗
浙江二千零二十交通事故赔偿标准	浙江二千零二十交通事故赔偿标准
怀孕能吃消炎药	怀孕能吃消炎药
二千零一十五的零次方	二千零一十五的零次方
厦大到鼓浪屿	厦大到鼓浪屿
dj一般说什	dj一般说什
吃烧烤会胖	吃烧烤会胖
二十六乘十二	二十六乘十二
最具催眠效果的音乐	最具催眠效果的音乐
m四百一十六怎么折	m四百一十六怎么折
你父母在哪儿	你父母在哪儿
南阳有几个县区	南阳有几个县区
怀孕能吃黄桃罐头	怀孕能吃黄桃罐头
儿童吹泡泡水简单配方比例	儿童吹泡泡水简单配方比例
你的创造人是谁	你的创造人是谁
赛龙舟有哪些准备活动阳光计划	赛龙舟有哪些准备活动阳光计划
姬存希精华水和修复精华的区别	姬存希精华水和修复精华的区别
舒筋健腰丸有效果	舒筋健腰丸有效果
慢性胃炎可以喝蜂蜜	慢性胃炎可以喝蜂蜜
脑血管堵塞能治好	脑血管堵塞能治好
国泰君安与银河比较	国泰君安与银河比较
自制凉皮为啥会炸口	自制凉皮为啥会炸口
语法分为哪两个部分	语法分为哪两个部分
喝完益母草颗粒肚子胀	喝完益母草颗粒肚子胀
无锡高校有哪些	无锡高校有哪些
妊娠糖尿病可以吃橘子	妊娠糖尿病可以吃橘子
爱普生进纸传感器在哪	爱普生进纸传感器在哪
穿什么衣服	穿什么衣服
成都有没有哥哥	成都有没有哥哥
我普通话不标准	我普通话不标准
怎么连蓝牙	怎么连蓝牙
大同道路运输管理处电话	大同道路运输管理处电话
世界上最傻的人是谁	世界上最傻的人是谁
厦门海警第三支队人员名单	厦门海警第三支队人员名单
小赢易贷怎么样靠谱吗	小赢易贷怎么样靠谱吗
咳嗽可以吃橙子	咳嗽可以吃橙子
完美同步的差速齿轮怎么制造	完美同步的差速齿轮怎么制造
手链掉河里了有没有打捞的工具	手链掉河里了有没有打捞的工具
防溢乳垫有用	防溢乳垫有用
打印机扫描不好用是电脑的问题吗	打印机扫描不好用是电脑的问题吗
荣威rx五有一键升窗功能吗	荣威rx五有一键升窗功能吗
全麦面包能减肥	全麦面包能减肥
荣耀小哨兵怎么安装	荣耀小哨兵怎么安装
湿疹可以打预防针	湿疹可以打预防针
天龙八部什么时装好看	天龙八部什么时装好看
surface的笔电池是什么型号	surface的笔电池是什么型号
初中求角度的方法总结	初中求角度的方法总结
带有政字的女孩名字	带有政字的女孩名字
孕妇能不能涂红药水	孕妇能不能涂红药水
应届大学毕业生找工作时应当最看重什么才能在工作中找到持久的动力	应届大学毕业生找工作时应当最看重什么才能在工作中找到持久的动力
安眠药药店能买到	安眠药药店能买到
大人最喜欢什么东西	大人最喜欢什么东西
删了前任他又加我啥意思	删了前任他又加我啥意思
坐月子可以吃藕粉	坐月子可以吃藕粉
驻马店格力空调总代理地址	驻马店格力空调总代理地址
喝绞股蓝头晕还能喝吗	喝绞股蓝头晕还能喝吗
蓬江哪里有鸡叫	蓬江哪里有鸡叫
一百六十专用武器伤害范围	一百六十专用武器伤害范围
长城m四变速箱油多久更换一次	长城m四变速箱油多久更换一次
春回大地风光好下联	春回大地风光好下联
tws耳机充电盒使用方法	tws耳机充电盒使用方法
现在几点钟	现在几点钟
嘉兴哪里有好玩的地方	嘉兴哪里有好玩的地方
大学选修心理学要求	大学选修心理学要求
有什么好看的电影	有什么好看的电影
苹果八充满电需要多长时间	苹果八充满电需要多长时间
整形医院回访电话话术	整形医院回访电话话术
冰箱里一个世界的电影	冰箱里一个世界的电影
choosefor和chooseas的区别	choosefor和chooseas的区别
三十六乘九	三十六乘九
梅毒检查有一项是阳性	梅毒检查有一项是阳性
痔疮可以吃鸡肉	痔疮可以吃鸡肉
utena正规品判定软件	utena正规品判定软件
石家庄到十堰飞机票	石家庄到十堰飞机票
驾驶员安全措施怎样写	驾驶员安全措施怎样写
四川哪个地方吃兔子有名	四川哪个地方吃兔子有名
菠萝和鸡蛋能一起吃	菠萝和鸡蛋能一起吃
戴避孕套会怀孕	戴避孕套会怀孕
跟地下城与勇士类似的手游	跟地下城与勇士类似的手游
是啥意思	是啥意思
三个字的游戏名字情侣	三个字的游戏名字情侣
梅毒检查有一项是阳性	梅毒检查有一项是阳性
建行怎么取消转账限额	建行怎么取消转账限额
体检前可以喝水	体检前可以喝水
药典规定制备注射用水的方法是	药典规定制备注射用水的方法是
在下图所示同一铸件的两种结构设计方案中哪一个方案是合理的为什么应分别	在下图所示同一铸件的两种结构设计方案中哪一个方案是合理的为什么应分别
打车会传染冠状病毒吗	打车会传染冠状病毒吗
二十二乘三	二十二乘三
电池会爆炸	电池会爆炸
怀孕可以喝豆浆	怀孕可以喝豆浆
李远庵为官清苦可以看出他怎样的品性	李远庵为官清苦可以看出他怎样的品性
女生会给男生看下面吗	女生会给男生看下面吗
款待的词语	款待的词语
湿疹可以吃生蚝	湿疹可以吃生蚝
新生儿鸟氨酸高复查通过率大吗	新生儿鸟氨酸高复查通过率大吗
乌龟喜欢干沙子还是湿沙子	乌龟喜欢干沙子还是湿沙子
三十六除二	三十六除二
a三十二的像素	a三十二的像素
晚上吃苹果好	晚上吃苹果好
华为畅享十怎么设置图形密码	华为畅享十怎么设置图形密码
有关万思维的电视剧	有关万思维的电视剧
工行密码输错三次怎么办	工行密码输错三次怎么办
湿度八十八是什么概念	湿度八十八是什么概念
上厕所时马桶圈要掀开上面的盖吗	上厕所时马桶圈要掀开上面的盖吗
怀孕的初期症状体重	怀孕的初期症状体重
或许我们之间太知己知彼是什么歌	或许我们之间太知己知彼是什么歌
cnp和hfp黑头鼻贴哪个好	cnp和hfp黑头鼻贴哪个好
火影忍者四代火影秽土转生哪一集	火影忍者四代火影秽土转生哪一集
表格怎么把sheet一起打印	表格怎么把sheet一起打印
莜面和小麦面粉的区别	莜面和小麦面粉的区别
心梗先兆症状吃什么药	心梗先兆症状吃什么药
小儿积食会发烧	小儿积食会发烧
oppo最好的手机是什么手机	oppo最好的手机是什么手机
ace两的呼吸灯	ace两的呼吸灯
现在还有多少电	现在还有多少电
我是你的头号粉丝用英语怎么说	我是你的头号粉丝用英语怎么说
怀孕后一个月吃什么好	怀孕后一个月吃什么好
手机听不到声音	手机听不到声音
表格怎么把sheet一起打印	表格怎么把sheet一起打印
紧张血压会高	紧张血压会高
四川哪个地方吃兔子有名	四川哪个地方吃兔子有名
胃溃疡可以吃红薯	胃溃疡可以吃红薯
四川快乐十二开奖结果四川福彩快乐十二开奖结果	四川快乐十二开奖结果四川福彩快乐十二开奖结果
省呗借钱必须要买会员吗	省呗借钱必须要买会员吗
至高广州企业管理有限公司	至高广州企业管理有限公司
三七粉上火	三七粉上火
糖尿病人能吃大蒜	糖尿病人能吃大蒜
山东农村无人居住的危房怎么处理	山东农村无人居住的危房怎么处理
邢台货车通行证高峰期	邢台货车通行证高峰期
衡水中学在临汾选址	衡水中学在临汾选址
企业所得税政策二千零一十九	企业所得税政策二千零一十九
经期能喝红茶	经期能喝红茶
孕妇可以吃鸭血	孕妇可以吃鸭血
赤峰有华夏	赤峰有华夏
避孕药会导致不孕	避孕药会导致不孕
qq网名女生有特殊符号	qq网名女生有特殊符号
对数字化加工公司的建议	对数字化加工公司的建议
高血压可以坐飞机	高血压可以坐飞机
具有泻而不藏的特点的是	具有泻而不藏的特点的是
农行忘记卡号怎么办	农行忘记卡号怎么办
怎么样看孩子有没有发育	怎么样看孩子有没有发育
oppo手环回复微信消息	oppo手环回复微信消息
一直响铃然后直接挂了	一直响铃然后直接挂了
天津安全员证在哪里报考	天津安全员证在哪里报考
网站攻击的常见方式	网站攻击的常见方式
你有爸爸吗	你有爸爸吗
谢娜追张杰追了多久	谢娜追张杰追了多久
怀二胎头疼是怎么回事	怀二胎头疼是怎么回事
充足的近义词可以是足够吗	充足的近义词可以是足够吗
苹果手机如何把图片放到电脑上	苹果手机如何把图片放到电脑上
ace两的价格	ace两的价格
胰腺炎可以吃雪糕	胰腺炎可以吃雪糕
长征一号是什么运载火箭	长征一号是什么运载火箭
富爸爸穷爸爸作者破产	富爸爸穷爸爸作者破产
你有对象吗	你有对象吗
明天有雨吗	明天有雨吗
训练德国牧羊犬的方法	训练德国牧羊犬的方法
尚品雪花粉是什么面粉	尚品雪花粉是什么面粉
患者女性二十七岁甲状腺肿大一年消瘦易疲劳失眠心悸怕热	患者女性二十七岁甲状腺肿大一年消瘦易疲劳失眠心悸怕热
孕妇可以吃银耳	孕妇可以吃银耳
a五支不支持闪充	a五支不支持闪充
临时过生日没有蛋糕怎么办	临时过生日没有蛋糕怎么办
来例假可以喝酸奶	来例假可以喝酸奶
嘴唇像枪舌头像剑形容争辩激烈	嘴唇像枪舌头像剑形容争辩激烈
打开快手	打开快手
鸡腿怎么做不油腻还好吃	鸡腿怎么做不油腻还好吃
我的心在哪里	我的心在哪里
月经提前半个月正常	月经提前半个月正常
吃什么水果会发胖	吃什么水果会发胖
浙大在中国的排名	浙大在中国的排名
春天来了校园里的花草树木有什么变化	春天来了校园里的花草树木有什么变化
我是什么星座	我是什么星座
十和十五的公因数有几个	十和十五的公因数有几个
在其他平台借款买房有影响吗	在其他平台借款买房有影响吗
十二星座里面谁打架最厉害	十二星座里面谁打架最厉害
月经突然提前六天怎么回事	月经突然提前六天怎么回事
你会长大	你会长大
怎么关注	怎么关注
七百二十除十二	七百二十除十二
磨砂玻璃开灯外面能看到里面吗	磨砂玻璃开灯外面能看到里面吗
荆芥性味归经功效主治	荆芥性味归经功效主治
红米五plus吃鸡灵敏度	红米五plus吃鸡灵敏度
如何呼唤你	如何呼唤你
大腿根部痱子一样的很痒	大腿根部痱子一样的很痒
吃什么补锌	吃什么补锌
上海公章网上备案流程	上海公章网上备案流程
梁下部有支座负筋吗	梁下部有支座负筋吗
孕妇可以吃燕麦片	孕妇可以吃燕麦片
女人多喝红枣枸杞水有什么好处	女人多喝红枣枸杞水有什么好处
今天有没有雨	今天有没有雨
糖尿病人能吃什么水果	糖尿病人能吃什么水果
经常带口罩会长黄褐斑吗	经常带口罩会长黄褐斑吗
贷款是转lpr好还是不转好	贷款是转lpr好还是不转好
你长什么样子	你长什么样子
三点一四乘八的平方	三点一四乘八的平方
乳腺结节是乳腺增生	乳腺结节是乳腺增生
焊接后产生角变形的原因是	焊接后产生角变形的原因是
睡眠障碍最常见的是	睡眠障碍最常见的是
描写边塞将士的诗句	描写边塞将士的诗句
糖尿病可以吃面食	糖尿病可以吃面食
重庆现有人口多少人	重庆现有人口多少人
母乳期可以喝红酒	母乳期可以喝红酒
女人还是呆呆的坐在院子里等他	女人还是呆呆的坐在院子里等他
痛风可以吃毛豆	痛风可以吃毛豆
荷兰猪能吃橘子	荷兰猪能吃橘子
涮羊肉怎么样	涮羊肉怎么样
厦门哪个医院做胆结石手术比较好	厦门哪个医院做胆结石手术比较好
面包里面可以包什么馅	面包里面可以包什么馅
类风湿能治愈	类风湿能治愈
猫咪眼睫毛可以剪吗	猫咪眼睫毛可以剪吗
跑步腿会粗	跑步腿会粗
减肥期间能吃茼蒿吗	减肥期间能吃茼蒿吗
硫酸钙是沉淀	硫酸钙是沉淀
三十二乘二十四	三十二乘二十四
别人问为什么把他删了	别人问为什么把他删了
快递费那么贵一些商家怎么赚钱	快递费那么贵一些商家怎么赚钱
何为严重侵害赠与人的情形	何为严重侵害赠与人的情形
哺乳期能喝菊花茶	哺乳期能喝菊花茶
咸丰庚午年是哪一年	咸丰庚午年是哪一年
我有什么优点	我有什么优点
天津离静海区有多远	天津离静海区有多远
描写乡村生活的段落	描写乡村生活的段落
两个乘数的末尾共有两个零积的末尾至少有两个零	两个乘数的末尾共有两个零积的末尾至少有两个零
西安属于历史古都吗	西安属于历史古都吗
周公解梦梦见自己在捡钱	周公解梦梦见自己在捡钱
北京新世界酒店属于什么集团	北京新世界酒店属于什么集团
你怎么可以这么笨	你怎么可以这么笨
拔智齿脸会变小	拔智齿脸会变小
减肥能吃馒头	减肥能吃馒头
来月经肚子特别疼怎么办啊	来月经肚子特别疼怎么办啊
火车进站前几分钟停止检票	火车进站前几分钟停止检票
ns怪物猎人gu怎么面联	ns怪物猎人gu怎么面联
crv本田二千零一十九款导航怎么关闭	crv本田二千零一十九款导航怎么关闭
大食堂用的烧电的灶	大食堂用的烧电的灶
四米高的房子可以做阁楼吗	四米高的房子可以做阁楼吗
小涵兼职账号如何解封	小涵兼职账号如何解封
香港的电邮是什么意思	香港的电邮是什么意思
一百除十五	一百除十五
刘昊然参加过什么综艺	刘昊然参加过什么综艺
surface的笔电池是什么型号	surface的笔电池是什么型号
你是不是想死	你是不是想死
春天来了校园里的花草树木有什么变化	春天来了校园里的花草树木有什么变化
会计人员应根据什么及有关资料编制记账凭证	会计人员应根据什么及有关资料编制记账凭证
为什么吃了藠头肚子痛	为什么吃了藠头肚子痛
可拉伸的爱心怎么叠	可拉伸的爱心怎么叠
齐齐哈尔到昂昂溪多少公里	齐齐哈尔到昂昂溪多少公里
一百二十除八	一百二十除八
乳房疼痛有哪些情况	乳房疼痛有哪些情况
两个名字的歌手有哪些	两个名字的歌手有哪些
上海交大在职研究生好考	上海交大在职研究生好考
没有工作党费怎么交	没有工作党费怎么交
孕妇可以喝杏仁露	孕妇可以喝杏仁露
我是你的谁	我是你的谁
都有什么功能	都有什么功能
工行预授信额度怎么查	工行预授信额度怎么查
哺乳期可以吃田螺	哺乳期可以吃田螺
做试管婴儿疼	做试管婴儿疼
转角处安全标志设在什么位置	转角处安全标志设在什么位置
适合酸性水养的观赏鱼	适合酸性水养的观赏鱼
脑出血前兆是什么反应	脑出血前兆是什么反应
拉肚子能吃苹果	拉肚子能吃苹果
花呗是不是自动还款	花呗是不是自动还款
吃鸡灵敏度怎么调最稳苹果十一	吃鸡灵敏度怎么调最稳苹果十一
充电的时候能玩手机吗	充电的时候能玩手机吗
评价一下易烊千玺	评价一下易烊千玺
龙胆泻肝丸小孩可以服用吗	龙胆泻肝丸小孩可以服用吗
自制凉皮为啥会炸口	自制凉皮为啥会炸口
为什么热可以缓解疼痛	为什么热可以缓解疼痛
正确处理改革发展稳定三者的结合点是	正确处理改革发展稳定三者的结合点是
天龙八部什么时装好看	天龙八部什么时装好看
健的大写字母怎么写	健的大写字母怎么写
乌市八路公交车路线图	乌市八路公交车路线图
在干什么	在干什么
高考历史第一次世界大战时间	高考历史第一次世界大战时间
建行职务等级	建行职务等级
建行满十六岁可以办银行卡	建行满十六岁可以办银行卡
减肥一直不成功怎么办	减肥一直不成功怎么办
小米八换个内屏要多少钱	小米八换个内屏要多少钱
下梦见自己的车坏了	下梦见自己的车坏了
毕业论文署名怎么写	毕业论文署名怎么写
新冠状病毒的症状头痛	新冠状病毒的症状头痛
你的名字叫什么	你的名字叫什么
听力九十五分贝能上学吗	听力九十五分贝能上学吗
尿液长期发黄是什么原因造成的	尿液长期发黄是什么原因造成的
冰箱冻冰块需要多长时间	冰箱冻冰块需要多长时间
现在移动办什么卡比较好	现在移动办什么卡比较好
嗓子疼能吃冰淇淋	嗓子疼能吃冰淇淋
土豆属于发物	土豆属于发物
吃避孕药会出血	吃避孕药会出血
红色枫叶歌词薛之谦	红色枫叶歌词薛之谦
去看电影用英语怎么说	去看电影用英语怎么说
王一博帅不帅	王一博帅不帅
一型糖尿病遗传	一型糖尿病遗传
加七	加七
经期能喝玫瑰花茶	经期能喝玫瑰花茶
成都建行周末上班	成都建行周末上班
时间水印照片怎么拍	时间水印照片怎么拍
麦滋林的作用是什么	麦滋林的作用是什么
男朋友要读博作为女朋友怎么办	男朋友要读博作为女朋友怎么办
十二乘十五	十二乘十五
你叫什么名字	你叫什么名字
给我说句粤语	给我说句粤语
位于吴江区的	位于吴江区的
苹果手机为什么一卡顿就重启	苹果手机为什么一卡顿就重启
小布打开旁白	小布打开旁白
吉林被称为什么药材之乡	吉林被称为什么药材之乡
鼻子干痒一扣就流鼻血	鼻子干痒一扣就流鼻血
肾虚是男生还是女生	肾虚是男生还是女生
哪个在攻击沉睡目标时不会让其苏醒	哪个在攻击沉睡目标时不会让其苏醒
上海闯红灯一次保费上浮吗	上海闯红灯一次保费上浮吗
发烧能开空调	发烧能开空调
安徽中考变化	安徽中考变化
你会吹牛逼	你会吹牛逼
苹果手机在哪里打开数据流量	苹果手机在哪里打开数据流量
电动车用驾照	电动车用驾照
学生复印件是什么意思	学生复印件是什么意思
北京到运城过路费多少钱	北京到运城过路费多少钱
神威参麦注射剂价格	神威参麦注射剂价格
药流后可以洗澡	药流后可以洗澡
马克思主义哲学考研排名	马克思主义哲学考研排名
你的名字叫什么	你的名字叫什么
ipad怎么检测屏幕	ipad怎么检测屏幕
肺上有个瘤子怎么治	肺上有个瘤子怎么治
人流后可以喝红糖水	人流后可以喝红糖水
设置充电提示音	设置充电提示音
白癜风会传染吗	白癜风会传染吗
血糖高可以吃玉米	血糖高可以吃玉米
痛风能喝绿豆汤	痛风能喝绿豆汤
中国服装上市公司第一品牌是	中国服装上市公司第一品牌是
武汉艳阳天酒店待遇怎么样	武汉艳阳天酒店待遇怎么样
教师资格证有有效期	教师资格证有有效期
三十九乘三	三十九乘三
明代有哪些诗人及作品	明代有哪些诗人及作品
红薯长芽了还能吃	红薯长芽了还能吃
湿疹能吃红枣	湿疹能吃红枣
杨幂陈奕迅参加的综艺节目	杨幂陈奕迅参加的综艺节目
驾驶员安全措施怎样写	驾驶员安全措施怎样写
怎么打开反向充电	怎么打开反向充电
丁雪糕的做法	丁雪糕的做法
仓鼠吃大米	仓鼠吃大米
哺乳期发烧可以打针	哺乳期发烧可以打针
白玉菇有臭味能吃吗	白玉菇有臭味能吃吗
人流可以直接上环	人流可以直接上环
老式热水器安装	老式热水器安装
三十五平方分米等多少立方米	三十五平方分米等多少立方米
在我们国家英语翻译	在我们国家英语翻译
奥迪a六的铭牌在哪里啊	奥迪a六的铭牌在哪里啊
仓鼠能吃蛋糕	仓鼠能吃蛋糕
跳绳能减肥	跳绳能减肥
福建海鲜米线的做法大全	福建海鲜米线的做法大全
我女儿漂亮吗	我女儿漂亮吗
经期前体温会升高	经期前体温会升高
尿酸高可以吃海带	尿酸高可以吃海带
机动车免上线年检流程	机动车免上线年检流程
等腰三角形旋转九十度的画法	等腰三角形旋转九十度的画法
打开计算器	打开计算器
孕妇能吃卤肉	孕妇能吃卤肉
早春呈水部张十八员外属于律诗还是绝句	早春呈水部张十八员外属于律诗还是绝句
十二星座里面谁打架最厉害	十二星座里面谁打架最厉害
西安的西南方向有哪些城市	西安的西南方向有哪些城市
剑灵副本里怎么开龙脉	剑灵副本里怎么开龙脉
苹果店里买可以刻字吗	苹果店里买可以刻字吗
郑州哪里买衣服性价比高	郑州哪里买衣服性价比高
海丰码头到镇海怎么走	海丰码头到镇海怎么走
嗖一圈安全吗选择导师安娜	嗖一圈安全吗选择导师安娜
事业单位管理岗位可以转公务员吗	事业单位管理岗位可以转公务员吗
都城的都的拼音是什么	都城的都的拼音是什么
孔雀钻石画适合挂哪里	孔雀钻石画适合挂哪里
陕西出省务工的健康证在哪里办理	陕西出省务工的健康证在哪里办理
驾照实习期能扣分	驾照实习期能扣分
现在几度	现在几度
多少价位的电脑能lol	多少价位的电脑能lol
福州狗市场在哪里	福州狗市场在哪里
失眠怎么办	失眠怎么办
你喜欢玩什么游戏	你喜欢玩什么游戏
二十年重庆限购政策	二十年重庆限购政策
ns怪物猎人gu怎么面联	ns怪物猎人gu怎么面联
请问需要什么帮助	请问需要什么帮助
鲁迅是八十一年发表的	鲁迅是八十一年发表的
陕西最好男科医院	陕西最好男科医院
苹果手机打开热点电脑连不上网怎么办	苹果手机打开热点电脑连不上网怎么办
一岁宝宝能吃火龙果	一岁宝宝能吃火龙果
怀孕可以吃当归	怀孕可以吃当归
孕妇可以吃青蛙	孕妇可以吃青蛙
莲子孕妇可以吃	莲子孕妇可以吃
怀孕初期能吃方便面	怀孕初期能吃方便面
是人工服务吗	是人工服务吗
上海建工集团属于什么性质	上海建工集团属于什么性质
芒果吃了会上火	芒果吃了会上火
月经期可以泡脚	月经期可以泡脚
吉林最低工资标准	吉林最低工资标准
科枫壁挂炉厂家电话	科枫壁挂炉厂家电话
减肥可以吃西瓜	减肥可以吃西瓜
乌鸦是怎么叫的文字	乌鸦是怎么叫的文字
绿园防疫站电话	绿园防疫站电话
杭州到赣州有多少公里	杭州到赣州有多少公里
旅游促销方案怎么写	旅游促销方案怎么写
月经来可以汗蒸	月经来可以汗蒸
身份证照片能贷款	身份证照片能贷款
surface的笔电池是什么型号	surface的笔电池是什么型号
怎么启动	怎么启动
nvidia控制面板怎么调出来	nvidia控制面板怎么调出来
什么品牌的护肤品补水保湿美白效果好	什么品牌的护肤品补水保湿美白效果好
华为freebuds悦享版和荣耀flypods哪个好	华为freebuds悦享版和荣耀flypods哪个好
支原体感染传染	支原体感染传染
腺肌症能怀孕	腺肌症能怀孕
你的爸爸是谁	你的爸爸是谁
姜子牙多大年龄得子	姜子牙多大年龄得子
零除零等几	零除零等几
武清杨村防疫站电话	武清杨村防疫站电话
潮汕桃粿的皮怎么做	潮汕桃粿的皮怎么做
喝绿茶能减肥	喝绿茶能减肥
蓝莓酱要熬多长时间	蓝莓酱要熬多长时间
验尿需要空腹	验尿需要空腹
建行的基金怎么赎回	建行的基金怎么赎回
你会做什么	你会做什么
k一屏幕价格	k一屏幕价格
体检抽血可以喝水	体检抽血可以喝水
充电器坏了怎么办	充电器坏了怎么办
支付宝怎么做公交车扫码	支付宝怎么做公交车扫码
小孩可以涂万金油吗	小孩可以涂万金油吗
孕妇能吃蛏子	孕妇能吃蛏子
验尿需要空腹	验尿需要空腹
对数字化加工公司的建议	对数字化加工公司的建议
李远庵为官清苦可以看出他怎样的品性	李远庵为官清苦可以看出他怎样的品性
中秋节的月相是什么样的	中秋节的月相是什么样的
学前教育和学前教育学的概念	学前教育和学前教育学的概念
贫血会死人	贫血会死人
整形医院回访电话话术	整形医院回访电话话术
设随机变量x服从二项分布bnp则ex等	设随机变量x服从二项分布bnp则ex等
肖战喜欢王一博吗	肖战喜欢王一博吗
望谟县复兴镇派出所电话	望谟县复兴镇派出所电话
河南防疫部门电话	河南防疫部门电话
那我可以叫你什么	那我可以叫你什么
苹果手机如何把图片放到电脑上	苹果手机如何把图片放到电脑上
不允许横屏在哪设置	不允许横屏在哪设置
先是声音嘶哑后咳嗽晚上加重	先是声音嘶哑后咳嗽晚上加重
三十六加三十六	三十六加三十六
陈情令的粉丝名是什么	陈情令的粉丝名是什么
七十六年的龙一生命运如何	七十六年的龙一生命运如何
郑州哪里买衣服性价比高	郑州哪里买衣服性价比高
招行明星理财产品	招行明星理财产品
湖北可以进出	湖北可以进出
我要怎么做	我要怎么做
哺乳期可以喝绿豆汤	哺乳期可以喝绿豆汤
建行网上修改银行预留手机号	建行网上修改银行预留手机号
妊娠糖尿病能吃菠萝	妊娠糖尿病能吃菠萝
上海闯红灯一次保费上浮吗	上海闯红灯一次保费上浮吗
你是女的还是男的	你是女的还是男的
在微信朋友圈里怎么发长视频	在微信朋友圈里怎么发长视频
九十五年大年三十是什么星座	九十五年大年三十是什么星座
皮肤有油脂粒怎么去除	皮肤有油脂粒怎么去除
samuelmorse发明了什么	samuelmorse发明了什么
井上雄彦死了	井上雄彦死了
桔片多少钱一盒	桔片多少钱一盒
家长不要对着孩子数一百二十三	家长不要对着孩子数一百二十三
狗癣传染人	狗癣传染人
孕妇可以吃甜瓜	孕妇可以吃甜瓜
气怎么样	气怎么样
为什么眼睛总是睡不醒的感觉	为什么眼睛总是睡不醒的感觉
今天谁最好看	今天谁最好看
小龙虾的做法和绝密配方	小龙虾的做法和绝密配方
做完人流可以吃巧克力	做完人流可以吃巧克力
水稻亩产量多少公斤	水稻亩产量多少公斤
月经期可以运动	月经期可以运动
三亚康莱德酒店多少钱一晚	三亚康莱德酒店多少钱一晚
拉肚子能吃蒜	拉肚子能吃蒜
痛风可以喝冰水	痛风可以喝冰水
喝完酒打哈欠睡不着怎么回事	喝完酒打哈欠睡不着怎么回事
肾结石能喝酸奶	肾结石能喝酸奶
衡阳中国人民银行上班时间	衡阳中国人民银行上班时间
睡眠障碍最常见的是	睡眠障碍最常见的是
手机进水一个月还能修好吗	手机进水一个月还能修好吗
千字文府罗将相从那篇开始	千字文府罗将相从那篇开始
通过丝绸之路传入中国的农作物或手工业品	通过丝绸之路传入中国的农作物或手工业品
研究发现字的顺序不影响阅读	研究发现字的顺序不影响阅读
嗖一圈安全吗选择导师安娜	嗖一圈安全吗选择导师安娜
研究生期间算工龄	研究生期间算工龄
整数乘法的方法是什么	整数乘法的方法是什么
有没有人喜欢我	有没有人喜欢我
怎么查残疾证被公司套用	怎么查残疾证被公司套用
来月经能吃海鲜	来月经能吃海鲜
福建海鲜米线的做法大全	福建海鲜米线的做法大全
正常人一天碳水和蛋白质摄入量	正常人一天碳水和蛋白质摄入量
浙大十九年录取分数线	浙大十九年录取分数线
猎人宝宝换不了天赋	猎人宝宝换不了天赋
银渐层能长到多少斤	银渐层能长到多少斤
磷酸奥司他韦颗粒是消炎药	磷酸奥司他韦颗粒是消炎药
校园广播系统如何设置时间	校园广播系统如何设置时间
abb词蓝	abb词蓝
人流后可以吹空调	人流后可以吹空调
七十二乘五	七十二乘五
你是男的还是女的	你是男的还是女的
分段函数不定积分的c如何确定	分段函数不定积分的c如何确定
历史上有薛葵这个人吗	历史上有薛葵这个人吗
寿命最长的血细胞是什么细胞	寿命最长的血细胞是什么细胞
学驾照刷学时什么意思	学驾照刷学时什么意思
我的名字叫什么	我的名字叫什么
我嫁给你好不好	我嫁给你好不好
舌尖上的中国有几个导演	舌尖上的中国有几个导演
东丽学校排行	东丽学校排行
什么花的花语是阳光	什么花的花语是阳光
这是什么歌	这是什么歌
河南有哪些学校开学了	河南有哪些学校开学了
皮炎平治脚气	皮炎平治脚气
魔兽怀旧服ah是什么意思	魔兽怀旧服ah是什么意思
什么内容	什么内容
下巴玻尿酸多久可以打第二针	下巴玻尿酸多久可以打第二针
高考历史第一次世界大战时间	高考历史第一次世界大战时间
孕妇能吃冰淇淋	孕妇能吃冰淇淋
原来自己什么也不是	原来自己什么也不是
撤退性出血算月经	撤退性出血算月经
西安反诈骗中心地址	西安反诈骗中心地址
糖尿病可以吃鱿鱼	糖尿病可以吃鱿鱼
科二约了几天可以看见结果	科二约了几天可以看见结果
糖尿病可以吃木瓜	糖尿病可以吃木瓜
如何自制史莱姆视频	如何自制史莱姆视频
痛风能吃甲鱼	痛风能吃甲鱼
四川快乐十二开奖结果四川福彩快乐十二开奖结果	四川快乐十二开奖结果四川福彩快乐十二开奖结果
坐月子能用足光粉泡脚吗	坐月子能用足光粉泡脚吗
省钱的秘诀是什	省钱的秘诀是什
生资驾校考试考场在哪	生资驾校考试考场在哪
上个润四月是哪一年	上个润四月是哪一年
汽油机抽水机怎么排空气	汽油机抽水机怎么排空气
白癜风能吃竹笋	白癜风能吃竹笋
分数是小数	分数是小数
三点五十六化成分数	三点五十六化成分数
签订建设工程合同应遵循的原则	签订建设工程合同应遵循的原则
你能做什么	你能做什么
焊接后产生角变形的原因是	焊接后产生角变形的原因是
宁波储能中学好不好	宁波储能中学好不好
孕妇可以吃乌梅	孕妇可以吃乌梅
苹果十一pages文稿闪退	苹果十一pages文稿闪退
你是什么oppo	你是什么oppo
孕妇可以吃薄荷糖	孕妇可以吃薄荷糖
什么品牌的护肤品补水保湿美白效果好	什么品牌的护肤品补水保湿美白效果好
经期可以吃感冒药	经期可以吃感冒药
水稳里可以用粉煤灰吗	水稳里可以用粉煤灰吗
电脑开机多次才能进入系统	电脑开机多次才能进入系统
怎样让水晶泥变硬一些	怎样让水晶泥变硬一些
哺乳期可以吃薏米	哺乳期可以吃薏米
初中求角度的方法总结	初中求角度的方法总结
社保自助经办平台使用时间	社保自助经办平台使用时间
零除零	零除零
深圳物价局客服电话	深圳物价局客服电话
浙江事业单位什么时候报名	浙江事业单位什么时候报名
可乐和雪碧哪个好喝	可乐和雪碧哪个好喝
今天多少号	今天多少号
十二乘五十五	十二乘五十五
怀孕可以吃咸鱼	怀孕可以吃咸鱼
嘉兴有什么好玩的地方	嘉兴有什么好玩的地方
一般拔牙之后要痛几小时	一般拔牙之后要痛几小时
雅美居装修公司电话	雅美居装修公司电话
在南方男生一百八十算不算高	在南方男生一百八十算不算高
海棠分布在什么区域	海棠分布在什么区域
月是故乡明作者在文中借月亮表达了什么	月是故乡明作者在文中借月亮表达了什么
那应该怎么回答	那应该怎么回答
支原体感染传染	支原体感染传染
iphone如何清除缓存数据	iphone如何清除缓存数据
十六岁还没有须佐能乎正常吗	十六岁还没有须佐能乎正常吗
产妇可以吃橙子	产妇可以吃橙子
孕妇可以吃香菜	孕妇可以吃香菜
跟情绪有关的四字词	跟情绪有关的四字词
梦幻西游敏捷动物套哪个最好	梦幻西游敏捷动物套哪个最好
你会做什么	你会做什么
支付宝可以转账到信用卡	支付宝可以转账到信用卡
例假期间可以按摩	例假期间可以按摩
瘦颧骨手术多少钱张笑天	瘦颧骨手术多少钱张笑天
中国与美国的文化差异有哪些英文	中国与美国的文化差异有哪些英文
北京最好的中医院	北京最好的中医院
有没有可以赚钱的游戏	有没有可以赚钱的游戏
爱过的人陪我多少天	爱过的人陪我多少天
怀孕了可以验光配眼镜吗	怀孕了可以验光配眼镜吗
十五乘十五	十五乘十五
洛克王国新手任务奖励宠物蛋是什么	洛克王国新手任务奖励宠物蛋是什么
湛江有什么好玩的	湛江有什么好玩的
我的手机是什么版本	我的手机是什么版本
小熊电砂锅出现eoo是何故障	小熊电砂锅出现eoo是何故障
了解的近义词是不是知道	了解的近义词是不是知道
oppo十一怎么截屏	oppo十一怎么截屏
四米高的房子可以做阁楼吗	四米高的房子可以做阁楼吗
心率不齐严重	心率不齐严重
石狮到万载的长途汽车	石狮到万载的长途汽车
榴莲吃了上火	榴莲吃了上火
十二乘十三	十二乘十三
白醋可以洗脸	白醋可以洗脸
印度带鼻环什么意思	印度带鼻环什么意思
孕妇的尿液与一般人的一样吗	孕妇的尿液与一般人的一样吗
华为密码忘记了怎么手动刷机	华为密码忘记了怎么手动刷机
江苏什么时候清零	江苏什么时候清零
现在公认为最好的杀毒软件是哪个	现在公认为最好的杀毒软件是哪个
你觉得我怎么样	你觉得我怎么样
吃中药可以吃芒果	吃中药可以吃芒果
大学选修心理学要求	大学选修心理学要求
孕妇能吃卤味	孕妇能吃卤味
形容亲密写出与手有关的成语	形容亲密写出与手有关的成语
猫能喝椰汁	猫能喝椰汁
g七十三可以用半径补偿吗	g七十三可以用半径补偿吗
表达离别之情的诗句有哪些	表达离别之情的诗句有哪些
皮皮虾的制作方法视频	皮皮虾的制作方法视频
咳嗽可以吃螃蟹	咳嗽可以吃螃蟹
qq网名女生有特殊符号	qq网名女生有特殊符号
企业支付的货物运输保险可以税前扣除吗	企业支付的货物运输保险可以税前扣除吗
这什么意思	这什么意思
感冒对体检有影响	感冒对体检有影响
宁河滨江锦园物业电话	宁河滨江锦园物业电话
没有幽门螺杆菌会得胃溃疡吗	没有幽门螺杆菌会得胃溃疡吗
小数有哪三部分组成	小数有哪三部分组成
验孕棒两条杠但是有来月经的感觉	验孕棒两条杠但是有来月经的感觉
六乘五	六乘五
固定构架的临时拉线应满足哪些	固定构架的临时拉线应满足哪些
洗衣机洗被套用多少水	洗衣机洗被套用多少水
二百八十乘四	二百八十乘四
酵素可以减肥	酵素可以减肥
江苏副主任医师考试时间	江苏副主任医师考试时间
同姓的人可以结婚	同姓的人可以结婚
冒险岛天使link有没必要	冒险岛天使link有没必要
尿液长期发黄是什么原因造成的	尿液长期发黄是什么原因造成的
在微信朋友圈里怎么发长视频	在微信朋友圈里怎么发长视频
梦幻西游敏捷动物套哪个最好	梦幻西游敏捷动物套哪个最好
你会打嗝吗	你会打嗝吗
四维彩超有必要做	四维彩超有必要做
乙烯使高锰酸钾溶液褪色的化学方程式	乙烯使高锰酸钾溶液褪色的化学方程式
简单又漂亮的小熊怎么画	简单又漂亮的小熊怎么画
三体系外审是指什么	三体系外审是指什么
五官破相会带来什么	五官破相会带来什么
来月经可以洗澡洗头	来月经可以洗澡洗头
玩成语接龙	玩成语接龙
丰润区法院电话	丰润区法院电话
一岁半宝宝能不能认字	一岁半宝宝能不能认字
胡桃木地板搭配什么颜色的家具	胡桃木地板搭配什么颜色的家具
直升飞机的样子作用和特点	直升飞机的样子作用和特点
上海互邦轮椅总部电话	上海互邦轮椅总部电话
土地证上是谁的名字土地就是谁的吗	土地证上是谁的名字土地就是谁的吗
大众suv车型大全斯柯达十万	大众suv车型大全斯柯达十万
天翼网关怎么关闭ipv六	天翼网关怎么关闭ipv六
经常性尿黄味道大是什么原因	经常性尿黄味道大是什么原因
工行社会招聘条件	工行社会招聘条件
你是谁呀	你是谁呀
安卓如何查看安装路径	安卓如何查看安装路径
联系不上	联系不上
停经三天能测出怀孕	停经三天能测出怀孕
bb霜排名	bb霜排名
郑州到济南汽车时刻表	郑州到济南汽车时刻表
新型肺炎对中小企业的影响	新型肺炎对中小企业的影响
六百一十八别墅聚会轰趴馆怎么样	六百一十八别墅聚会轰趴馆怎么样
你知道我是谁吗	你知道我是谁吗
现在多少点	现在多少点
孕妇吃火龙果好	孕妇吃火龙果好
给自己充电	给自己充电
建行前面几位数	建行前面几位数
痛风能吃馒头	痛风能吃馒头
金色的阳光穿过树林改为比喻句	金色的阳光穿过树林改为比喻句
河南有几个地市	河南有几个地市
经期能艾灸	经期能艾灸
屏幕固定显示的概念	屏幕固定显示的概念
六十四乘九	六十四乘九
那必须的	那必须的
哺乳期能用面膜	哺乳期能用面膜
什么游戏	什么游戏
哺乳期能吃桃	哺乳期能吃桃
中山防疫政策	中山防疫政策
子宫肌瘤能喝蜂蜜	子宫肌瘤能喝蜂蜜
莒南跑临沂客车时刻表	莒南跑临沂客车时刻表
喉咙痛可以吃橙子	喉咙痛可以吃橙子
电脑用手机热点打天龙八部	电脑用手机热点打天龙八部
结肠黑变病严重	结肠黑变病严重
怀孕初期能做阴超	怀孕初期能做阴超
头围正常双顶径偏小原因	头围正常双顶径偏小原因
偶像练习生每个人的名字	偶像练习生每个人的名字
孕妇喝纯牛奶好	孕妇喝纯牛奶好
江苏二建缴费	江苏二建缴费
燃气热水器温度下不来咋回事	燃气热水器温度下不来咋回事
我怎么舍得生你的气呢	我怎么舍得生你的气呢
养猫需要打疫苗	养猫需要打疫苗
空腹跑步好	空腹跑步好
肾虚会引起脱发	肾虚会引起脱发
经期可以吃感冒药	经期可以吃感冒药
肖战帅吗	肖战帅吗
怡养堂化妆品怎么样	怡养堂化妆品怎么样
香港用地紧张其原因是人口怎么样和地形怎么样	香港用地紧张其原因是人口怎么样和地形怎么样
世界十大动物儿童电影排名	世界十大动物儿童电影排名
经常抽万宝路的爆珠会怎么样	经常抽万宝路的爆珠会怎么样
如果岁月可回头是什么意思	如果岁月可回头是什么意思
怀孕可以吃豆腐	怀孕可以吃豆腐
世界上最帅的男人是谁呀	世界上最帅的男人是谁呀
感冒能吃芒果	感冒能吃芒果
马群有建行	马群有建行
怀孕可以吃苹果	怀孕可以吃苹果
紫癜病能治好	紫癜病能治好
来月经可以吃乌鸡白凤丸	来月经可以吃乌鸡白凤丸
前夫抚养费不给强制执行不了	前夫抚养费不给强制执行不了
page是什么意思中文	page是什么意思中文
咳嗽可以吃牛排	咳嗽可以吃牛排
还本销售缴纳增值税吗	还本销售缴纳增值税吗
你喜欢我哪里啊	你喜欢我哪里啊
江西中医院梁瑞宁怎么样	江西中医院梁瑞宁怎么样
跳绳能减肥	跳绳能减肥
初霜和御剑仙女杯怎么区分	初霜和御剑仙女杯怎么区分
广播电视播音员主持人资格证	广播电视播音员主持人资格证
屈原的千古名句是什么激励一代	屈原的千古名句是什么激励一代
还本销售缴纳增值税吗	还本销售缴纳增值税吗
心脏上有黑斑怎么回事	心脏上有黑斑怎么回事
上海互邦轮椅总部电话	上海互邦轮椅总部电话
我喜欢吃什么	我喜欢吃什么
二百除四十	二百除四十
宝宝鼻炎鼻塞晚上严重怎么办	宝宝鼻炎鼻塞晚上严重怎么办
怀孕可以吃沙琪玛	怀孕可以吃沙琪玛
你喜欢我哪里	你喜欢我哪里
工行app怎么查询开户行	工行app怎么查询开户行
你叫我什么	你叫我什么
三百五十八的立方根	三百五十八的立方根
糖尿病人可以吃地瓜	糖尿病人可以吃地瓜
怎么修改ipad名字	怎么修改ipad名字
冰淇淋厂冬天做什么	冰淇淋厂冬天做什么
解脲支原体阳性好治	解脲支原体阳性好治
经期可以喝益母草	经期可以喝益母草
苹果手机如何把图片放到电脑上	苹果手机如何把图片放到电脑上
小度今天的天气怎么样	小度今天的天气怎么样
强直性脊柱炎能治好	强直性脊柱炎能治好
新生儿可以吹风扇	新生儿可以吹风扇
怡宝是矿泉水	怡宝是矿泉水
患者女性二十七岁甲状腺肿大一年消瘦易疲劳失眠心悸怕热	患者女性二十七岁甲状腺肿大一年消瘦易疲劳失眠心悸怕热
空腹吃水果好	空腹吃水果好
湖北有多少个市县	湖北有多少个市县
怀孕可以吃橙子	怀孕可以吃橙子
那一年深圳成为了经济特区	那一年深圳成为了经济特区
点痣恢复期间颜色变化	点痣恢复期间颜色变化
你智力好	你智力好
湘潭到昭山坐几路公交车	湘潭到昭山坐几路公交车
如何分辨零线和火线	如何分辨零线和火线
玫瑰香有籽好没籽好	玫瑰香有籽好没籽好
怎么制作多链接海报	怎么制作多链接海报
满城尽带黄金甲在哪儿拍的	满城尽带黄金甲在哪儿拍的
年代热水器t十二m三十七价格	年代热水器t十二m三十七价格
湖北十八年高考人数	湖北十八年高考人数
串钩用什么线不缠绕	串钩用什么线不缠绕
我也想关机睡觉了	我也想关机睡觉了
手机定位怎么定啊	手机定位怎么定啊
经常抽万宝路的爆珠会怎么样	经常抽万宝路的爆珠会怎么样
金毛能吃菠萝	金毛能吃菠萝
四个月泰迪吃什么牌子狗粮	四个月泰迪吃什么牌子狗粮
眼睛里面一眨眼就疼	眼睛里面一眨眼就疼
郑州哪里买衣服性价比高	郑州哪里买衣服性价比高
胃不好可以吃葡萄	胃不好可以吃葡萄
什么物流可以运活鸡	什么物流可以运活鸡
洛阳到新蔡县多少公里	洛阳到新蔡县多少公里
整数乘法的方法是什么	整数乘法的方法是什么
蚕豆病可以吃荷兰豆	蚕豆病可以吃荷兰豆
磷酸奥司他韦颗粒是消炎药	磷酸奥司他韦颗粒是消炎药
邢台到聊城多少公里	邢台到聊城多少公里
六除二	六除二
带状疱疹严重	带状疱疹严重
北京海军大院地址	北京海军大院地址
你说你喜欢上了谁	你说你喜欢上了谁
成语接龙	成语接龙
血压低是贫血	血压低是贫血
九乘九等几	九乘九等几
word删除多页怎么删	word删除多页怎么删
杜鹃花可以净化空气吗	杜鹃花可以净化空气吗
子宫肌瘤能吃豆类	子宫肌瘤能吃豆类
角瓜生长周期多少天	角瓜生长周期多少天
怀孕初期白带多	怀孕初期白带多
湿疹可以吃西瓜	湿疹可以吃西瓜
梭子蟹孕妇能吃	梭子蟹孕妇能吃
宝宝拉肚子能吃酸奶	宝宝拉肚子能吃酸奶
七十除二	七十除二
鹤城小学排名	鹤城小学排名
脑梗塞一定会复发	脑梗塞一定会复发
咽炎会发烧	咽炎会发烧
吃小南瓜对身体有什么好处	吃小南瓜对身体有什么好处
科颜氏为什么放骷髅	科颜氏为什么放骷髅
三百五十乘二十	三百五十乘二十
插头正确接线方式图解	插头正确接线方式图解
华润万家属于国企吗	华润万家属于国企吗
西安属于历史古都吗	西安属于历史古都吗
小学五字古诗	小学五字古诗
怎么看出共同关注公众号的好友	怎么看出共同关注公众号的好友
哺乳期可以吃甘草片	哺乳期可以吃甘草片
你会说滚吗	你会说滚吗
湖南师大高考分数线二千零一十九	湖南师大高考分数线二千零一十九
小孩能吃冰淇淋	小孩能吃冰淇淋
江门皮肤医院是正规医院吗	江门皮肤医院是正规医院吗
十九点七六除五点二	十九点七六除五点二
了解的近义词是不是知道	了解的近义词是不是知道
成都疫情防控等级	成都疫情防控等级
癌症能治愈	癌症能治愈
快乐男声李炜现在在干嘛	快乐男声李炜现在在干嘛
三十除五	三十除五
大食堂用的烧电的灶	大食堂用的烧电的灶
制售假烟金额五百万以内什么罪	制售假烟金额五百万以内什么罪
从国内寄快递到伦敦多少钱	从国内寄快递到伦敦多少钱
人流手术后能吃小龙虾吗	人流手术后能吃小龙虾吗
液晶王tv九百九十设置不了	液晶王tv九百九十设置不了
南阳小麦收割时间	南阳小麦收割时间
十一月二十二是什么星座的	十一月二十二是什么星座的
逍遥在人间叹尘世妄言绝千恋什么意思	逍遥在人间叹尘世妄言绝千恋什么意思
西南交大校长级别	西南交大校长级别
厦大教授名单	厦大教授名单
有一只公鸡用什么成语来形容	有一只公鸡用什么成语来形容
近月少女的礼仪汉化补丁怎么用	近月少女的礼仪汉化补丁怎么用
吃冰糖会发胖	吃冰糖会发胖
诺基亚现在属于富士康	诺基亚现在属于富士康
特百惠果醋的做法大全	特百惠果醋的做法大全
五菱宏光后雾灯怎么开	五菱宏光后雾灯怎么开
慢性胃炎能喝酸奶	慢性胃炎能喝酸奶
你的工作是什么	你的工作是什么
结婚证能补办	结婚证能补办
死亡率是逐年变化的且变化幅度在不同的年龄段不同较年轻年龄段与较年老年龄	死亡率是逐年变化的且变化幅度在不同的年龄段不同较年轻年龄段与较年老年龄
老年人大脑供血不足吃什么好	老年人大脑供血不足吃什么好
痛风可以吃花生	痛风可以吃花生
十楼小高层买几楼最好	十楼小高层买几楼最好
来月经可以吃木瓜	来月经可以吃木瓜
眼睛里面有结石是怎么回事	眼睛里面有结石是怎么回事
什么不什么手成语有哪些	什么不什么手成语有哪些
防雾霾的n九十五口罩可以防病毒吗	防雾霾的n九十五口罩可以防病毒吗
炉甘石洗剂孕妇能用	炉甘石洗剂孕妇能用
江西共青城邮编多少	江西共青城邮编多少
你会嫌弃我吗	你会嫌弃我吗
凯美瑞新车味道散不掉	凯美瑞新车味道散不掉
波司登羽绒服公司在哪里	波司登羽绒服公司在哪里
怀孕初期白带多正常	怀孕初期白带多正常
枝江顺丰快递的电话	枝江顺丰快递的电话
宣政院什么时候设立的	宣政院什么时候设立的
简单又漂亮的小熊怎么画	简单又漂亮的小熊怎么画
快递费那么贵一些商家怎么赚钱	快递费那么贵一些商家怎么赚钱
五十四除三	五十四除三
减肥晚上可以吃橙子	减肥晚上可以吃橙子
婚姻法有破坏家庭罪吗	婚姻法有破坏家庭罪吗
物业管理费包括二次加压费吗	物业管理费包括二次加压费吗
oppo会员是干嘛的	oppo会员是干嘛的
拉肚子可以吃西瓜	拉肚子可以吃西瓜
武汉文一云水湾附近的规划	武汉文一云水湾附近的规划
今天是农历初几	今天是农历初几
阜阳办理健康证的地方在哪里	阜阳办理健康证的地方在哪里
牛肉丸浮起来就熟了吗	牛肉丸浮起来就熟了吗
虎皮鹦鹉能吃大米	虎皮鹦鹉能吃大米
月经来了可以吃榴莲	月经来了可以吃榴莲
郑州建行几点上班	郑州建行几点上班
六乘十五	六乘十五
农行pos刷卡限额	农行pos刷卡限额
印度带鼻环什么意思	印度带鼻环什么意思
怀孕能吃橄榄菜	怀孕能吃橄榄菜
设置语音唤醒	设置语音唤醒
郑爽张翰结婚了	郑爽张翰结婚了
喝了红酒可以吃榴莲	喝了红酒可以吃榴莲
鼻炎会引起耳鸣	鼻炎会引起耳鸣
西红柿苹果香蕉可以一起吃吗	西红柿苹果香蕉可以一起吃吗
上海有名的酒吧聚集地	上海有名的酒吧聚集地
怀孕可以吃豆芽	怀孕可以吃豆芽
建行app改手机号	建行app改手机号
月经期间可以吃雪蛤	月经期间可以吃雪蛤
镶嵌式煤气灶怎样换电池	镶嵌式煤气灶怎样换电池
适合酸性水养的观赏鱼	适合酸性水养的观赏鱼
老年人大脑供血不足吃什么好	老年人大脑供血不足吃什么好
学音乐难	学音乐难
多根网线同时接一个猫	多根网线同时接一个猫
设置一个七点半的闹钟	设置一个七点半的闹钟
我的手机可以无线充电	我的手机可以无线充电
开封的植物油能放多久	开封的植物油能放多久
小学如何做好学困生转化工作	小学如何做好学困生转化工作
上海农村危房鉴定标准	上海农村危房鉴定标准
术后可以吃牛肉	术后可以吃牛肉
联通员工总数数量	联通员工总数数量
重庆哪些是三甲医院	重庆哪些是三甲医院
人流后能吃葡萄	人流后能吃葡萄
咖啡拉花可以用速溶咖啡吗	咖啡拉花可以用速溶咖啡吗
牛仔裤口袋里有沙子正常吗	牛仔裤口袋里有沙子正常吗
贵州车牌号城市代号	贵州车牌号城市代号
小三挑事还如何处理	小三挑事还如何处理
泡脚可以去湿气	泡脚可以去湿气
支付宝怎么做公交车扫码	支付宝怎么做公交车扫码
德高防水开裂怎么处理	德高防水开裂怎么处理
描写少年意气风发的长篇诗词	描写少年意气风发的长篇诗词
卡超级加倍什么意思	卡超级加倍什么意思
硅胶奶瓶好	硅胶奶瓶好
借酒消愁的伤感句子	借酒消愁的伤感句子
经期可以喝桂圆红枣茶	经期可以喝桂圆红枣茶
你现在干什么	你现在干什么
烟台到安康多少公里	烟台到安康多少公里
什么门永远关不上呢	什么门永远关不上呢
卵巢囊肿能吃燕窝	卵巢囊肿能吃燕窝
三角形的面积	三角形的面积
民政局星期六上班	民政局星期六上班
拉肚子可以吃蛋	拉肚子可以吃蛋
长春在哪里补办身份证	长春在哪里补办身份证
角瓜生长周期多少天	角瓜生长周期多少天
的拼音	的拼音
兰州的邮箱	兰州的邮箱
洛克王国新手任务奖励宠物蛋是什么	洛克王国新手任务奖励宠物蛋是什么
重庆迈科唯待遇怎么样	重庆迈科唯待遇怎么样
请问三十二寸电视机什么牌子好	请问三十二寸电视机什么牌子好
你吃过屎吗	你吃过屎吗
大姨妈可以喝大麦茶	大姨妈可以喝大麦茶
乡下手工棉裤裁剪教程	乡下手工棉裤裁剪教程
妊娠糖尿病可以吃红枣	妊娠糖尿病可以吃红枣
招行只打印工资流水	招行只打印工资流水
唐军叶龙是什么电视	唐军叶龙是什么电视
镇康邮政编码	镇康邮政编码
使用微信时卡顿	使用微信时卡顿
液晶王tv九百九十设置不了	液晶王tv九百九十设置不了
失重条件下生长素可以横向	失重条件下生长素可以横向
九十六除四	九十六除四
六十九除三	六十九除三
孕妇可以用皮炎平	孕妇可以用皮炎平
咳嗽能吃水果	咳嗽能吃水果
梦遗正常	梦遗正常
你的爸爸妈妈是谁	你的爸爸妈妈是谁
牛仔裤口袋里有沙子正常吗	牛仔裤口袋里有沙子正常吗
王一博喜欢肖战吗	王一博喜欢肖战吗
聚维酮碘是碘伏	聚维酮碘是碘伏
喝水可以治疗感冒吗	喝水可以治疗感冒吗
哈尔滨正义街的位置	哈尔滨正义街的位置
沈阳铁路四小怎么样	沈阳铁路四小怎么样
乳癖舒胶囊有什么副作用	乳癖舒胶囊有什么副作用
痛风能吃芋头	痛风能吃芋头
怀孕一定会孕吐	怀孕一定会孕吐
为确保设计和开发的输出满足输入的要求应进行	为确保设计和开发的输出满足输入的要求应进行
驿站大概是什么意思	驿站大概是什么意思
工行生肖信用卡额度	工行生肖信用卡额度
乌鲁木齐仟叶学校怎样	乌鲁木齐仟叶学校怎样
左脑缺血灶的最好治疗方法	左脑缺血灶的最好治疗方法
鹿晗和黄子韬张艺兴关系	鹿晗和黄子韬张艺兴关系
孕妇可以吃土豆	孕妇可以吃土豆
怀孕能吃橘子	怀孕能吃橘子
u盘直接放iso文件能安装系统吗	u盘直接放iso文件能安装系统吗
今天天气怎么样	今天天气怎么样
御龙在天转国多少钱	御龙在天转国多少钱
五菱荣光v中门中控锁安装	五菱荣光v中门中控锁安装
清平乐表达了词人的什么感情	清平乐表达了词人的什么感情
怀孕能吃鳝鱼	怀孕能吃鳝鱼
你是男还是女	你是男还是女
你能为我做什么	你能为我做什么
过敏性鼻炎可以根治	过敏性鼻炎可以根治
零除零	零除零
胡桃木地板搭配什么颜色的家具	胡桃木地板搭配什么颜色的家具
十点三厘米等多少分米	十点三厘米等多少分米
胃炎可以喝酸奶	胃炎可以喝酸奶
子宫肌瘤可以吃燕窝	子宫肌瘤可以吃燕窝
三点一四乘八	三点一四乘八
睡前喝牛奶有助于睡眠	睡前喝牛奶有助于睡眠
亲你多大了	亲你多大了
公共管理专业的职称是什么	公共管理专业的职称是什么
会不会学猫叫	会不会学猫叫
石狮到万载的长途汽车	石狮到万载的长途汽车
工行卡异地注销流程	工行卡异地注销流程
月经期可以吃叶酸	月经期可以吃叶酸
强力枇杷露小孩能喝	强力枇杷露小孩能喝
怀孕初期可以吃火龙果	怀孕初期可以吃火龙果
手撕牛肉的做法大全	手撕牛肉的做法大全
oppowatch充电的方法	oppowatch充电的方法
中国交通最差的城市	中国交通最差的城市
篮球板到底线标准尺寸	篮球板到底线标准尺寸
我现在在什么位置	我现在在什么位置
宁河滨江锦园物业电话	宁河滨江锦园物业电话
一百二十乘七十三	一百二十乘七十三
我今天长得帅吗	我今天长得帅吗
绝地求生如何连续标点	绝地求生如何连续标点
后边牙齿坏了一个窟窿	后边牙齿坏了一个窟窿
身高一百八十的标准体重是多少	身高一百八十的标准体重是多少
泰安有哪些医院	泰安有哪些医院
洋葱和葱的功效区别	洋葱和葱的功效区别
身份证过期了还能乘坐飞机吗	身份证过期了还能乘坐飞机吗
浙江理工大学专业对选科的要求	浙江理工大学专业对选科的要求
生姜发芽还能吃	生姜发芽还能吃
葡萄糖分解成丙酮酸是什么反应	葡萄糖分解成丙酮酸是什么反应
贷款是转lpr好还是不转好	贷款是转lpr好还是不转好
你为什么不唱歌	你为什么不唱歌
跑步之后全身酸痛第二天还要跑吗	跑步之后全身酸痛第二天还要跑吗
经期可以吃地瓜	经期可以吃地瓜
有关万思维的电视剧	有关万思维的电视剧
明天天气怎么样	明天天气怎么样
在重庆买的医保在贵州可以使用么	在重庆买的医保在贵州可以使用么
宣政院什么时候设立的	宣政院什么时候设立的
黄体囊肿有什么危害	黄体囊肿有什么危害
寂寞寂寞就好歌词是什么意思	寂寞寂寞就好歌词是什么意思
香菜怎样保存时间长不腐烂	香菜怎样保存时间长不腐烂
ace两的上市停产时间	ace两的上市停产时间
制售假烟金额五百万以内什么罪	制售假烟金额五百万以内什么罪
乳胶枕头有味道	乳胶枕头有味道
微信图片打印机怎么打印	微信图片打印机怎么打印
糖尿病人能喝玉米粥	糖尿病人能喝玉米粥
子宫肌瘤可以顺产	子宫肌瘤可以顺产
患者女性二十七岁甲状腺肿大一年消瘦易疲劳失眠心悸怕热	患者女性二十七岁甲状腺肿大一年消瘦易疲劳失眠心悸怕热
豆腐渣白带能自愈	豆腐渣白带能自愈
卖水果赚钱	卖水果赚钱
手机划不动屏幕怎么办oppo	手机划不动屏幕怎么办oppo
白术和艾草一起煮水喝行吗	白术和艾草一起煮水喝行吗
海南买车上牌新政策	海南买车上牌新政策
你可以唱一首歌吗	你可以唱一首歌吗
中能瑞通科技有限公司怎么样	中能瑞通科技有限公司怎么样
空腹可以吃葡萄	空腹可以吃葡萄
面瘫治疗后能喝可乐吗	面瘫治疗后能喝可乐吗
新生儿两手抓的紧紧的	新生儿两手抓的紧紧的
有矮脚基因的长脚猫	有矮脚基因的长脚猫
丰台离石景山多远	丰台离石景山多远
平煤大庄矿历任矿长	平煤大庄矿历任矿长
来例假能洗澡	来例假能洗澡
结扎后能恢复	结扎后能恢复
六十三除九	六十三除九
ccdi深圳分公司怎么样	ccdi深圳分公司怎么样
孕妇能吃酸辣粉	孕妇能吃酸辣粉
你最喜欢哪个星座	你最喜欢哪个星座
那我可以娶你吗	那我可以娶你吗
乙肝大三阳会传染	乙肝大三阳会传染
蓝牙耳机可以修	蓝牙耳机可以修
头发老掉怎么办	头发老掉怎么办
怎么样检验黄金的真假	怎么样检验黄金的真假
花都君悦酒店在哪里	花都君悦酒店在哪里
糟糕的近义词是什	糟糕的近义词是什
零点一r五乘零点八	零点一r五乘零点八
人流后可以吃水果	人流后可以吃水果
电脑游戏里打字总是字母怎么办	电脑游戏里打字总是字母怎么办
读完上海戏剧学院要多少钱	读完上海戏剧学院要多少钱
鲁迅是八十一年发表的	鲁迅是八十一年发表的
护肝片有副作用	护肝片有副作用
白斑可以用激光治疗吗	白斑可以用激光治疗吗
惊天动地意思和造句	惊天动地意思和造句
牛仔裤口袋里有沙子正常吗	牛仔裤口袋里有沙子正常吗
怎么样看孩子有没有发育	怎么样看孩子有没有发育
胃不好能吃水果	胃不好能吃水果
你可以给我讲故事吗	你可以给我讲故事吗
鲁迅是八十一年发表的	鲁迅是八十一年发表的
原始凭证商品名称错误	原始凭证商品名称错误
咳嗽可以吃冰淇淋	咳嗽可以吃冰淇淋
数控车床子程序怎么编程	数控车床子程序怎么编程
河东人社局电话号码	河东人社局电话号码
北京五环的房价是多少	北京五环的房价是多少
你长胡子了吗	你长胡子了吗
五菱宏光后雾灯怎么开	五菱宏光后雾灯怎么开
二百八十乘四	二百八十乘四
毛囊炎是皮肤病	毛囊炎是皮肤病
成都就业服务管理局电话	成都就业服务管理局电话
创造与魔法礼包兑换码在哪里兑换	创造与魔法礼包兑换码在哪里兑换
肠炎能吃红薯	肠炎能吃红薯
广州服装批发市场的工资大概多少	广州服装批发市场的工资大概多少
散热风扇发热什么原因	散热风扇发热什么原因
月经流了一点点褐色就没有了	月经流了一点点褐色就没有了
今天星期几	今天星期几
水痘疫苗有必要打么	水痘疫苗有必要打么
根据劳动法第十四条规定	根据劳动法第十四条规定
福建宣传语	福建宣传语
健的大写字母怎么写	健的大写字母怎么写
猫虱子咬的包是啥样子	猫虱子咬的包是啥样子
孕妇可以喝可乐	孕妇可以喝可乐
浙江应急管理厅办公室主任是谁	浙江应急管理厅办公室主任是谁
吗啡片多长时间起效	吗啡片多长时间起效
感冒可以吃榴莲	感冒可以吃榴莲
化州属于哪个地级市	化州属于哪个地级市
乘三	乘三
招行开户行号	招行开户行号
最早的地理学著作是什么记录了我国古代地理历史民族神话生物水利等诸多方面内	最早的地理学著作是什么记录了我国古代地理历史民族神话生物水利等诸多方面内
乙肝能自愈	乙肝能自愈
你生病了吗	你生病了吗
喉咙痛可以吃橘子	喉咙痛可以吃橘子
西宁高铁站在哪里	西宁高铁站在哪里
乙肝病毒携带者能生孩子	乙肝病毒携带者能生孩子
清理内存	清理内存
长安社保中心电话	长安社保中心电话
八六版西游记白骨精的扮演者杨春霞	八六版西游记白骨精的扮演者杨春霞
迷你牛奶盲盒的制作方法	迷你牛奶盲盒的制作方法
五个月宝宝可以吹风吗	五个月宝宝可以吹风吗
简单又漂亮的小熊怎么画	简单又漂亮的小熊怎么画
ace两是否支持反向无线充电	ace两是否支持反向无线充电
关于二轮摩托车的年检新规	关于二轮摩托车的年检新规
a七十二几个卡槽	a七十二几个卡槽
怀孕能吃溜溜梅	怀孕能吃溜溜梅
等边三角形有三个锐角对吗	等边三角形有三个锐角对吗
石家庄花样年华小区怎么样	石家庄花样年华小区怎么样
齐齐哈尔的明星有哪些	齐齐哈尔的明星有哪些
怀孕痔疮肉球怎么办	怀孕痔疮肉球怎么办
苯甲酸钠抑制什么菌	苯甲酸钠抑制什么菌
面包里面可以包什么馅	面包里面可以包什么馅
tws耳机充电盒使用方法	tws耳机充电盒使用方法
阜阳办理健康证的地方在哪里	阜阳办理健康证的地方在哪里
蘑菇和菠菜能一起吃	蘑菇和菠菜能一起吃
结业证书有用	结业证书有用
四川哪个地方吃兔子有名	四川哪个地方吃兔子有名
三百六十除六	三百六十除六
你有爱人	你有爱人
生产成本账户按用途和结构分类	生产成本账户按用途和结构分类
现在的你在干嘛	现在的你在干嘛
广东七十岁以上老人补贴	广东七十岁以上老人补贴
狗粮猫能吃	狗粮猫能吃
多高的身高可以扣篮	多高的身高可以扣篮
快来月经体温会升高	快来月经体温会升高
胃炎能吃茄子	胃炎能吃茄子
beautiful是什么意思	beautiful是什么意思
