joshua什么意思中文	josh什么意思中文
什么歌最好听	两年前什么歌最好听
下电影一般用什么软件	前两年下电影一般用什么软件
苹果手机七p屏幕上的悬浮球怎么设置	苹果手机七屏幕上的悬浮球怎么设置
宝宝发烧拉肚子	宝宝不发烧拉肚子
不打开qq音乐	不打开音乐
三月三日是什么座	三月是什么座
怎样可以长高	怎样可以不长高
南非是国家吗	南非是中东国家吗
fightover是什么意思	是什么意思
如何设置电脑不自动下载软件	如何设置电脑自动下载软件
诗歌英文	中国诗歌英文
heer怎么读	wheer怎么读
不失眠的抑郁症	失眠的抑郁症
睡觉头痛怎么办	没睡觉头痛怎么办
发烧拉肚子怎么回事	没发烧拉肚子怎么回事
师范大学热门专业	赣南师范大学热门专业
热巴为什么被新浪限流	迪丽热巴为什么被新浪限流
正式关系是什么意思	非正式关系是什么意思
excel显示div零	excel不显示div零
观光车价格	重庆观光车价格
大便什么颜色正常	大便什么颜色不正常
微信显示名字	微信没显示名字
转移性支出不包括	转移性支出包括
你不懂英语吗	你懂英语吗
不正常体温是多少度	正常体温是多少度
手机怎么使用卡二流量	电信手机怎么使用卡二流量
南京天气怎样	南京下个月天气怎样
小孩皮肤好	小孩皮肤不好
正常白带是什么样的	非正常白带是什么样的
近几年房价走势图	近几年长沙房价走势图
k七有呼吸灯吗	k七没有呼吸灯吗
夏天手上起小水泡痒	夏天手上没起小水泡痒
苹果xmax前置摄像头像素	苹果前置摄像头像素
吐鲁番售后什么时候上班	售后什么时候上班
七月七日是什么星座	七月是什么星座
名爵多少钱一辆	名爵zs多少钱一辆
arrgh怎么读	argh怎么读
分等多少秒	十分等多少秒
北大录取分数线	河北北大录取分数线
美版手机电信卡能用吗	美版苹果手机电信卡能用吗
坚果手机怎么root	坚果手机怎么
人类的发展方向	未来人类的发展方向
中行客服	中央银行客服
怎么念	how怎么念
mee什么意思	mmee什么意思
中国新蜜蜂用英语怎么说	新蜜蜂用英语怎么说
a十一x是否支持息屏时钟	a十一是否支持息屏时钟
新大洲电瓶车座椅怎么打开	新大洲本田电瓶车座椅怎么打开
十二月二十二日是什么座	十二月是什么座
如何更换qq群管理员	如何更换群管理员
喜欢雨的植物	喜欢秋雨的植物
微信来信息亮屏	微信来信息不亮屏
肯德基最大股东	肯德基麦当劳最大股东
美金汇率	前三年美金汇率
狭义的卫生服务组织不包括	狭义的卫生服务组织包括
吃什么药可以让心电图正常	吃什么药可以让心电图不正常
产后月经不规律	产后三个月月经不规律
形容不好吃的句子	形容好吃的句子
0八年房价多少	0八年长沙房价多少
莫什么什么及成语	什么什么及成语
花洒喷出来的水不集中	花洒喷出来的水集中
何时开六合彩	何时开香港六合彩
whatsthematter是什么意思	是什么意思
什么音乐好听	什么音乐不好听
商业银行核心资本不包括	商业银行核心资本包括
梦见死去的姥姥说话	梦见死去的姥姥不说话
微信怎么查的聊天记录	微信怎么查去年的聊天记录
非萎缩是什么意思	萎缩是什么意思
howoldareyou是什么意思	是什么意思
月经来几天算正常	月经来几天算不正常
满五非唯一是什么意思	满五唯一是什么意思
科目一考多久过期	科目一没考多久过期
联通卡套餐	河南联通卡套餐
最稳定的自由基是	最不稳定的自由基是
vegetable怎么拼读	vegetables怎么拼读
二月三什么星座	二月什么星座
湖南二千零一十九中考分数线	湖南师大二千零一十九中考分数线
missingyoumust是什么意思	是什么意思
荣耀二十支持光学防抖吗	荣耀二十s支持光学防抖吗
形容工具好用	形容工具不好用
三十七点三℃算发烧吗	三十℃算发烧吗
走心的暗示什么意思	不走心的暗示什么意思
理财产品没有收益	理财产品昨天没有收益
op怎么查是不是正品	怎么查是不是正品
每天洗澡用热水对身体有作用嘛	每天洗澡用非热水对身体有作用嘛
鼻涕不粘稠不发黄	鼻涕粘稠不发黄
泌乳素高怎么办	泌乳素不高怎么办
非经常性的放屁好吗	经常性的放屁好吗
疫情为什么严重	疫情为什么不严重
中医药大学专业有哪些	广西中医药大学专业有哪些
慢性胃窦炎严重吗	非慢性胃窦炎严重吗
咽炎会咳嗽吗	咽炎会不咳嗽吗
我今年十二岁的英文	我十二岁的英文
什么无什么迹	什么什么迹
还有多少天	这个月还有多少天
cand怎么读	candle怎么读
十二号是星期几	十二月二号是星期几
c语言错误	语言错误
湖南的三本院校	湖南师大的三本院校
汽车关税	美国汽车关税
干咳是什么原因	睡前干咳是什么原因
便秘怎么办	不便秘怎么办
现在天气怎么样	现在武汉天气怎么样
身体不好的星座	身体好的星座
睡觉头痛怎么办	不睡觉头痛怎么办
形容不尊重别人的句子	形容尊重别人的句子
阳历八月二十三日是什么星座的	阳历八月二是什么星座的
二十年吉林高考时间	二十年吉林春季高考时间
月经前症状	月经前无症状
怀孕乳房变化	怀孕乳房无变化
没怀孕初期见红正常吗	怀孕初期见红正常吗
请问手机锁屏打不开怎么办	请问手机android锁屏打不开怎么办
河南有什么好玩的地方	河南西安有什么好玩的地方
oppo手机坏了怎么修	手机坏了怎么修
发烧咽喉痛吃什么药	不发烧咽喉痛吃什么药
二十年四月十七日吉时	二十年四月吉时
社会主义发达阶段	社会主义不发达阶段
我是歌手淘汰谁了	我是歌手昨天淘汰谁了
如何查询的航班信息	如何查询以往的航班信息
二手房利率是多少	深圳二手房利率是多少
宝宝胃酸反流症状	宝宝三个月胃酸反流症状
下载小红书没	下载小红书
a五支持全局吗	oppoa五支持全局吗
十一月一日是什么星座	一月一日是什么星座
不想去上学的句子	想去上学的句子
洛阳猪肉多少钱一斤	去年洛阳猪肉多少钱一斤
十五ml水等多少克	十五l水等多少克
如果美国赖掉外债会怎么样	如果美国赖掉中国外债会怎么样
苹果怎样不黑屏	苹果怎样黑屏
固液不加热型的化学方程式	固液加热型的化学方程式
y如何设置充电提示音	如何设置充电提示音
什么人适合穿汉服	什么人不适合穿汉服
形容东西少的成语	形容东西不少的成语
感冒为什么会咳嗽	不感冒为什么会咳嗽
如何追一个不认识的男生	如何追一个认识的男生
小孩扁桃体发炎发烧	小孩扁桃体发炎不发烧
叙利亚的样子	多年前叙利亚的样子
iamyourfather是什么意思	是什么意思
十六年最火的歌曲	十六年最火的韩国歌曲
成都天气怎么样	成都明天天气怎么样
最近好看的电影	最近好看的香港电影
南海区联通营业厅位置	联通营业厅位置
中国有多少大学生	去年中国有多少大学生
吃什么对皮肤好	吃什么对皮肤不好
家里养什么植物不好	家里养什么植物好
苏州有什么好吃的	苏州西山有什么好吃的
干净男孩讨女生喜欢吗	不干净男孩讨女生喜欢吗
经常做梦是因为什么原因	经常不做梦是因为什么原因
世界杯冠军是哪个国家	明年世界杯冠军是哪个国家
不整洁的英语单词	整洁的英语单词
理想信念坚定的例子	理想信念不坚定的例子
喂奶能不喝酒吗	喂奶能喝酒吗
梦到自己不穿裤子	梦到自己穿裤子
一号线地铁时间表	一号线北京地铁时间表
什么是人寿	什么是中国人寿
中国残联标志	残联标志
birthday怎么翻译	birthdaycake怎么翻译
屁多又臭是什么原因	屁多又不臭是什么原因
几种形状不健康大便图	几种形状健康大便图
一等几	熊熊加一等几
牙龈肿出血	牙龈肿不出血
西安普惠体检项目有哪些	西安体检项目有哪些
萨摩耶吃什么	萨摩耶不吃什么
nothanks是什么意思	是什么意思
excel匹配两个表格相同数据	excel匹配两个表格不相同数据
吃了紧急避孕药出血	吃了紧急避孕药不出血
你有爷爷吗	你没有爷爷吗
ps怎么调节图片的透明度	wps怎么调节图片的透明度
三十用英语怎么说	六点三十用英语怎么说
三分钟后关闭音乐	分钟后关闭音乐
天平女爱你的表现	天平女不爱你的表现
什么网游比较好玩	五年前什么网游比较好玩
不忘记过去的名言	忘记过去的名言
什么花对室内空气好	什么花对室内空气不好
手机号码欠费不注销	手机号码欠费注销
调个八点的闹钟	调个明天早上八点的闹钟
医大二院开诊了吗	沈阳医大二院开诊了吗
绝地求生刺激战场国际服怎么登进去	绝地求生刺激战场国际服怎么登不进去
是否写完作业	是否写不完作业
什么地方出现过龙卷风	昨天什么地方出现过龙卷风
二千零一十高考人数	二千零一十北京高考人数
喝酒头疼怎么回事	没喝酒头疼怎么回事
四季春维瓦尔第简谱	四季春简谱
身上好多红色的点点痒	身上好多红色的点点不痒
华南理工复试比重	华工复试比重
今天几年	今天几年几月几日
北京天气怎样	前天北京天气怎样
老年人吃什么好	老年人吃什么不好
一直出汗是什么原因	一直不出汗是什么原因
吉林农大占地面积排名	吉大占地面积排名
是十一的倍数有什么特点	是一的倍数有什么特点
新生儿老放屁是怎么回事	新生儿一个月老放屁是怎么回事
猫咪拉屎怎么办	猫咪没拉屎怎么办
吃水果发胖	吃水果不发胖
为什么怀孕不来月经	为什么没怀孕不来月经
感冒嗓子干痒咳嗽怎么办	没感冒嗓子干痒咳嗽怎么办
小布打开uc浏览器	小布打开浏览器
前后对称的成语	前后不对称的成语
不辜负自己的意思是什么	辜负自己的意思是什么
一元国辉硬币值钱吗	一元硬币值钱吗
r级排行榜	日本r级排行榜
南京信息工程大学代码	信息工程大学代码
武汉什么天气	武汉明天什么天气
不觉得无聊的成语	觉得无聊的成语
一用英文怎么说	十一用英文怎么说
大便的正常颜色	大便的不正常颜色
不大喊大叫的英文	大喊大叫的英文
水调歌头的意	苏轼水调歌头的意
万圣节前夕的英语怎么说	万圣节的英语怎么说
狗开心的表现	狗不开心的表现
下巴不尖适合什么发型	下巴尖适合什么发型
有说明书吗	没有说明书吗
白带不粘稠不发黄	白带粘稠不发黄
六月十三日是什么星座	六月是什么星座
八十九年十二月初七阳历是多少	阳历是多少
吃了避孕药这个月会怀孕吗	上个月吃了避孕药这个月会怀孕吗
手机root有什么用	手机有什么用
经常梦到的人和事	经常梦到过去的人和事
oppo有没有颜色反转功能	有没有颜色反转功能
客服热线	oppo客服热线
十月二十五日是什么星座	十月是什么星座
孕三十九周胎动减少正常吗	孕三十胎动减少正常吗
不流鼻涕喉咙不痛是什么感冒	流鼻涕喉咙不痛是什么感冒
疫情开什么厂挣钱	疫情前两年开什么厂挣钱
surge怎么读	surgeon怎么读
像我们姐这么帅的人有几个	像我这么帅的人有几个
东莞是什么区	东莞长安是什么区
怎样下载视频到手机上	怎样下载视频到苹果手机上
手环消息不提示	手环消息提示
双色球开奖号码	昨晚双色球开奖号码
什么数的平方等零点五	什么数的平方等五
rest什么意思中文	restless什么意思中文
正确佩戴口罩的方式	不正确佩戴口罩的方式
中山公园在哪里	北京中山公园在哪里
今天晚上有雨没	今天有雨没
今年农历	今年农历几月几日
新生儿需要多少纸尿裤	新生儿前三天需要多少纸尿裤
oppo系统啥时候更新	系统啥时候更新
野马有几座	福特野马有几座
打开gps工具箱	打开工具箱
形容不洗澡的词语	形容洗澡的词语
同学的英语	同班同学的英语
八十七年三月九日农历多少	三月九日农历多少
小孩咳嗽没有痰怎么办	小孩咳嗽有痰怎么办
明天有没有雪	有没有雪
沙特拉伯首都	沙特首都
residence是什么意思	是什么意思
晚上不吃饭对身体好吗	晚上吃饭对身体好吗
胡冰卿背景	胡背景
距离七月五日还有多少天	距离七月还有多少天
五月一日是什么星座	月一日是什么星座
法国风景名胜	法国巴黎风景名胜
vivi我们来玩词语接龙吧	我们来玩词语接龙吧
关是什么意思	无关是什么意思
南京晓庄学院美术生分数线	晓庄学院美术生分数线
白茶适合什么人喝	白茶不适合什么人喝
关系的英文	没关系的英文
爱出汗是怎么回事	不爱出汗是怎么回事
whatarethey是什么意思	是什么意思
四点八的平方是多少	八的平方是多少
喜欢喝冰水是什么体质	不喜欢喝冰水是什么体质
形容开心的成语是什么	形容不开心的成语是什么
梦见喜欢的小男孩	梦见不喜欢的小男孩
正确的饮食方式	不正确的饮食方式
快餐连锁品牌有哪些	中国快餐连锁品牌有哪些
月经周期多少天正常	月经周期多少天不正常
deli是什么牌子	delivery是什么牌子
手上起小水泡不痒是怎么回事	手上起小水泡痒是怎么回事
为什么会下雨	为什么会不下雨
明天北京天气怎么样	明天北京方山天气怎么样
a七十二的上市时间	a七十二n的上市时间
乙肝会传染吗	乙肝会不传染吗
我不喜欢足球用英语怎么读	我喜欢足球用英语怎么读
八十九年农历五月二十五日出生的人是什么星座	八十九年农历五月出生的人是什么星座
设置早上六点四十闹钟	设置明天早上六点四十闹钟
晚餐可以不吃主食吗	晚餐可以吃主食吗
tfboy三个人的身高	tfboys三个人的身高
播放beyond的歌曲	播放的歌曲
资产证券化对发起人的意义包括	资产证券化对发起人的意义不包括
股市怎么样	未来股市怎么样
欢乐谷日场两次票什么意思	成都欢乐谷日场两次票什么意思
hear过去式和过去	过去式和过去
三是几月几日	上个星期三是几月几日
增值税发票可以不抵扣吗	增值税发票可以抵扣吗
直邮要多久	美国直邮要多久
富士康所在地	深圳富士康所在地
mn开头的苹果手机	mwn开头的苹果手机
梦见大雪堆积如山	梦见大雪堆
中山公园在哪里	厦门中山公园在哪里
七号是星期几	十一月七号是星期几
六月二十八日是什么星座	六月是什么星座
迪斯尼乐园游玩项目	香港迪斯尼乐园游玩项目
联通移动电信哪个好	上海联通移动电信哪个好
北大二千零二十考研分数线	北京科大二千零二十考研分数线
用英文	out用英文
剪映如何不压缩	剪映如何压缩
不细心的英语怎么说	细心的英语怎么说
足球球员名单	日本足球球员名单
不自欺欺人是什么意思	自欺欺人是什么意思
picture是什么意思	是什么意思
二十年高考什么时候	二十年广州高考什么时候
三手机正常使用时出现自动锁屏的原因	手机正常使用时出现自动锁屏的原因
十月一日上升星座是什么	十月上升星座是什么
温岭夹屿在哪个地方	温岭在哪个地方
怀孕能吃吗	怀孕能吃白灵菇吗
女人好的说说	女人不好的说说
什么水果对肾好	什么水果对肾不好
习惯空腹喝豆浆好吗	习惯非空腹喝豆浆好吗
富士康年产值	郑州富士康年产值
北京天坛医院icu病房一天多少钱	北京医院icu病房一天多少钱
怀孕小腹坠疼	怀孕三个月小腹坠疼
二十年春节还有多少天	二十年还有多少天
我一直在做作业你呢	我昨天一直在做作业你呢
beleg什么意思	beeg什么意思
早上空腹喝牛奶好吗	早上非空腹喝牛奶好吗
七十年代人口	七十年代香港人口
眼睛发红发痒吃什么药	眼睛发痒吃什么药
keep下载后的运动视频在哪里删除	keep下载后的运动视频在youtube哪里删除
欢乐谷怎么收费的	上海欢乐谷怎么收费的
形容唱歌好听	形容唱歌不好听
后天学习论的代表人物	后天学习论的五代表人物
属猪的跟什么合	属猪的跟什么不合
常德有雨吗	常德明天有雨吗
西安五百强企业排名	西安百强企业排名
要不要喝茶你	要不要喝茶你们叔
re什么意思啊	repair什么意思啊
on是什么意思	online是什么意思
打开uc浏览器	打开浏览器
什么食物不含锌	什么食物含锌
孕妇不能吃什么	孕妇能吃什么
全国有多少个叫李馨的	全国有多少个叫李馨怡的
州庆是什么时候	是什么时候
re什么意思啊	repost什么意思啊
梦见不来月经	梦见来月经
境界不高什么意思	境界高什么意思
南昌天气如何	南昌明天天气如何
怎么样才能瘦脸	怎么样才能不瘦脸
打开qq打开	打开qq打开qq
whatis是什么意思	是什么意思
开车多的剧	开车多的韩剧
摩根大通证券股票代码	大通证券股票代码
月经流鼻血	月经前两天流鼻血
怎么让新生儿睡觉	怎么不让新生儿睡觉
什么样的征信是好的	什么样的征信是不好的
鼻痒打喷嚏不停流鼻涕	鼻不痒打喷嚏不停流鼻涕
二点五乘	二点五乘二点五
恐龙园学生证查得严吗	常州恐龙园学生证查得严吗
郑州天气怎么样	郑州明天天气怎么样
菌类白参怎么吃	菌类怎么吃
什么游戏最好玩	什么游戏最不好玩
尺度非常大的电影	尺度非常大的美国电影
来例假洗澡好吗	来例假不洗澡好吗
imfine是什么意思	是什么意思
张家港天气怎么样	明天张家港天气怎么样
宝马三百二十li的空调滤芯在哪	宝马三百二十的空调滤芯在哪
六十四g和二百五十六g的区别	六十四g和二百五十六的区别
好老师的特点	不好老师的特点
长城汽车怎么样	保定长城汽车怎么样
梦见自己的样子	梦见自己未来的样子
微信照片保存	微信照片不保存
关闭qq后台运行	关闭后台运行
不健康的表现	健康的表现
马达上面的齿轮怎么弄下来	马达上面d的齿轮怎么弄下来
剑桥大学在哪里	英国剑桥大学在哪里
急性支气管炎不发烧	急性支气管炎发烧
清华有多大	北大清华有多大
主人确实是我们妹的名字	主人确实是我的名字
空腹吃什么舒服	空腹吃什么不舒服
二十年农历七月份黄道吉日	二十年农历七月份
满天星可以不施肥吗	满天星可以施肥吗
头晕恶心不想吐	头晕不恶心不想吐
怎样在手机上下载视频	怎样在苹果手机上下载视频
小米十pro移动权益版什么意思	小米十移动权益版什么意思
不属于乒乓球三大国际赛事	属于乒乓球三大国际赛事
医科大学就业	温州医科大学就业
怀孕要吃叶酸吗	没怀孕要吃叶酸吗
郑州天气怎么样	郑州昨天天气怎么样
qq群宣传语怎么写	群宣传语怎么写
血气方正的读音	血气的读音
开空调为什么不滴水	开空调为什么滴水
十的英文翻译	十五天的英文翻译
小米怎么进去recovery模式	小米怎么进去recover模式
过春节的风俗习惯	古代过春节的风俗习惯
蓝牙耳机电量不显示	蓝牙耳机电量显示
柬埔寨是不是国家	柬埔寨是不是东南亚国家
宽容的反面事例简短	不宽容的反面事例简短
选择连续的相似颜色区域	选择不连续的相似颜色区域
johann怎么读	johan怎么读
猫拉屎臭正常吗	猫拉屎不臭正常吗
苹果手机怎么定位	苹果手机怎么不定位
错误代码十一是什么意思	错误代码一是什么意思
为什么人的体温不一样	为什么人的体温一样
梦到了去世亲人	昨天梦到了去世亲人
形容东西好的字	形容东西不好的字
息屏时间改为	息屏时间改为五分钟
iphone静音键不震动	iphone静音键震动
电动车刹车太灵	电动车刹车不太灵
手脚发热是怎么回事	手脚不发热是怎么回事
springfestival是什么意思	是什么意思
不讲信用的意思是什么	讲信用的意思是什么
把息屏时间调到	把息屏时间调到三十分钟
蓝色配什么颜色好看	蓝色配什么颜色不好看
孕妇可以吃冰淇淋吗	孕妇可以吃芒果冰淇淋吗
和叶有关的诗句	和秋叶有关的诗句
家里鱼缸不养鱼好吗	家里鱼缸养鱼好吗
水果花都有什么颜色	水果有什么颜色
怀孕不能吃什么	怀孕不能不吃什么
五行属火的吉利字	五行属火的字
晚上吃什么好	晚上吃什么不好
演员郭新馨	演员馨
石家庄到大寨多少公里	石家庄到山西大寨多少公里
爱洗澡对身体好吗	不爱洗澡对身体好吗
邮政国际邮费价格表	中国邮政国际邮费价格表
复旦成考录取分数线	上海复旦成考录取分数线
联通转套餐	上海联通转套餐
七月十八日是什么星座	七月是什么星座
哺乳期能吃春笋吗	哺乳期能吃笋吗
腰围七十六cm等多少尺	腰围七十六等多少尺
最便宜的oppo多少钱	最便宜的多少钱
多少度呢	明天多少度呢
摩托车加油熄火	摩托车没加油熄火
指南针sw是什么意思	指南针snew是什么意思
广东移动短号怎么取消	移动短号怎么取消
云台山今天人多吗	焦作云台山今天人多吗
发烧不咳嗽会是新型肺炎吗	不发烧不咳嗽会是新型肺炎吗
药流流干净几率大吗	药流流不干净几率大吗
吃减肥药口渴	吃减肥药口不渴
快手怎么才能让人看到	快手怎么才能不让人看到
长安在哪里	东莞长安在哪里
北京有什么地方可以去玩的	多年前北京有什么地方可以去玩的
精英律师中何塞的扮演者	精英律师中的扮演者
三省指什么	省指什么
swetheart是什么意思	是什么意思
怀孕挂什么科	没怀孕挂什么科
宝宝喜欢谁	宝宝不喜欢谁
我不喜欢猫英语	我喜欢猫英语
火锅包厢名字	重庆火锅包厢名字
排卵不正常月经推迟	排卵正常月经推迟
大便干燥出血	大便不干燥出血
久的近义词	天长地久的近义词
r十七pro充满电需要多久	r十七充满电需要多久
男的吧你们妹妹是不是啊	男的吧你是不是啊
不清醒什么意思	清醒什么意思
胃疼还拉肚子怎么回事	胃疼还不拉肚子怎么回事
五g多少兆	电信五g多少兆
天猫旗舰店有假货吗	苹果天猫旗舰店有假货吗
四月三十日是什么星座	日是什么星座
医院可以体检吗	医院下午可以体检吗
天气怎么样	明天天气怎么样
中午地震了吗	昨天中午地震了吗
病人所用药品的费用	昨天病人所用药品的费用
不发烧怎么办	发烧怎么办
蛀牙可以不治疗吗	蛀牙可以治疗吗
医院排名	广州医院排名
五月十九日是什么星座	五月是什么星座
矩阵可逆秩为多少	矩阵不可逆秩为多少
drf什么意思	dwarf什么意思
蒙台梭利教学法的特点	教学法的特点
品牌电器有哪些	日本品牌电器有哪些
八十七年三月九日是什么星座	三月九日是什么星座
微信怎么推荐qq好友	微信怎么不推荐qq好友
脾胃虚寒宜吃什么食物	脾胃虚寒不宜吃什么食物
六合彩什么时候来	香港六合彩什么时候来
走不动了	马都走不动了
富士康补办厂牌	成都富士康补办厂牌
宝宝不发烧出疹子	宝宝发烧出疹子
三星和苹果哪个耐用皮实	三星和苹果哪个耐用
正常大便颜色	不正常大便颜色
tvb电视剧在哪看	香港tvb电视剧在哪看
口腔溃疡吃什么好	口腔溃疡吃什么不好
马达上面的齿轮怎么弄下来	马达上面l的齿轮怎么弄下来
a七十二充电时长	a七十二阿德充电时长
打嗝怎么办	不打嗝怎么办
不化妆要擦隔离霜吗	化妆要擦隔离霜吗
可不可以给你换个名字	明天可不可以给你换个名字
平安银行的电话	中国平安银行的电话
北大招生分数线	北京科大招生分数线
为什么天天晚上做梦	为什么天天晚上不做梦
汉川月子中心在哪里	汉川月子中心在上海哪里
我今年十一岁了用英语怎么说	我十一岁了用英语怎么说
不运动瘦大腿	运动瘦大腿
三吨等几千克	吨等几千克
血压正常范围	血压不正常范围
两个月宝宝咳嗽有痰怎么办	两个月宝宝不咳嗽有痰怎么办
二百音浪多少钱	二百w音浪多少钱
早餐吃什么容易胖	早餐吃什么不容易胖
热巴的脚多大码	迪丽热巴的脚多大码
k七是否支持otg	k七x是否支持otg
吃瓜子会胖吗	吃黑南瓜子会胖吗
结膜炎怎么治好	结膜炎怎么治不好
满十六怎么办银行卡	不满十六怎么办银行卡
北京卫视频道节目表	明天北京卫视频道节目表
交强险可以不过户吗	交强险可以过户吗
谈恋爱有什么好	谈恋爱有什么不好
白细胞多少正常	白细胞多少不正常
电脑如何设置密码	电脑如何不设置密码
今年什么生意好做	今年什么生意不好做
社保局周末上班吗	双流社保局周末上班吗
行为训练的主要教学方法不包括	行为训练的主要教学方法包括
你们姐姐怎么不再换一个cd呢	你怎么不再换一个cd呢
firona是什么意思	是什么意思
什么食物对心脏好	什么食物对心脏不好
人保车险怎么样可靠吗	中国人保车险怎么样可靠吗
opporll换屏多少钱	oppo换屏多少钱
不发面面食的做法花样大全	发面面食的做法花样大全
北京发生啥事了	昨天北京发生啥事了
tonia怎么读	toni怎么读
什么歌曲好听	什么歌曲不好听
为什么每次怀孕反应都不一样	为什么每次怀孕反应都一样
移动宽带改密码	浙江移动宽带改密码
经常放屁好吗	不经常放屁好吗
广东什么地方疫情严重	广东什么地方疫情不严重
spy是什么意思	sp是什么意思
生理期吃什么好	生理期吃什么不好
wps不显示分页符	wps显示分页符
巢湖火车时刻表	巢湖合肥火车时刻表
肺炎吃什么好	肺炎吃什么不好
放邓丽君歌曲	放歌曲
北大哪个街道	北京科大哪个街道
找到删除的照片	找不到删除的照片
荣耀八x上市时间	荣耀八上市时间
你不用的英文	你用的英文
打开qq面对面快传	打开面对面快传
慈善事业发展状况	中国慈善事业发展状况
一百g南瓜的热量	一百南瓜的热量
四岁宝宝不憋尿怎么办	四岁宝宝憋尿怎么办
三d开什么	今晚三d开什么
好伤心是什么意思	好不伤心是什么意思
为什么总是不感觉饿	为什么总是感觉饿
胆固醇高的食物	胆固醇不高的食物
经常放屁好不好	经常不放屁好不好
身体怕冷是什么原因	身体不怕冷是什么原因
前置胎盘胎动明显吗	前置胎盘胎动不明显吗
形容显眼的词语	形容不显眼的词语
宁波是哪个省	宁波港是哪个省
手机如何快速充电	oppo手机如何快速充电
太和医院呼吸内科主任	十堰太和医院呼吸内科主任
什么单机游戏好玩	十年前什么单机游戏好玩
喝酒为什么痛风	不喝酒为什么痛风
属于非活性混合材料的是	属于活性混合材料的是
明基台灯有实体店吗	明基台灯南京有实体店吗
会不会下雨啊	下周会不会下雨啊
口腔黏膜磨砂感痛	口腔黏膜磨砂感不痛
近几年房价走势图	近几年成都房价走势图
奉贤区联通营业厅地址	联通营业厅地址
overthebridge是什么意思	是什么意思
re什么意思啊	remind什么意思啊
二千零一十高考人数	二千零一十广东高考人数
sayyouagain是什么意思	是什么意思
肉芽组织触之易出血	肉芽组织触之不易出血
雌激素高吃什么好	雌激素不高吃什么好
来例假拉肚子	不来例假拉肚子
excuseme是什么意思	是什么意思
哪些食物含淀粉	哪些食物不含淀粉
happyteam是什么意思	是什么意思
四特东方韵弘韵四十五度价格	四特东方韵四十五度价格
什么茶是苦的	什么茶是无苦的
不什么什么心	什么什么心
怎样死的痛快	怎样死的不痛快
脚长二十五cm穿多大码	脚长二十五穿多大码
有关的诗句	有关秋天的诗句
手机的辐射大吗	oppo手机的辐射大吗
语言分为哪几种	c语言分为哪几种
冰箱两边热是怎么回事	冰箱两边不热是怎么回事
setdefault什么意思	setupdefault什么意思
好看的同性电视剧	好看的韩国同性电视剧
联通流量套餐介绍	上海联通流量套餐介绍
什么时间吃姜	什么时间不吃姜
来月经前胸疼正常吗	来月经前胸不疼正常吗
鸡不下蛋的原因	鸡下蛋的原因
手心脚心出汗是什么原因	手心脚心不出汗是什么原因
二千零一十九地产排名	二千零一十九广州地产排名
oppo手机有录音功能吗	手机有录音功能吗
马达上面的齿轮怎么弄下来	马达上面c的齿轮怎么弄下来
按焊条的用途分类不包括	按焊条的用途分类包括
火机油成分	zippo火机油成分
新生儿打嗝怎么办	新生儿不打嗝怎么办
护理法的内容不包括	护理法的内容包括
我忘记我的oppo密码了	我忘记我的密码了
北京会下雨吗	北京后天会下雨吗
丹东最低温度	丹东冬季最低温度
打个电话八	打个电话
黑人自杀率	美国黑人自杀率
oppowatch防水吗	watch防水吗
a七十二n的上市时间	a七十二的上市时间
小规模纳税人可以不开发票吗	小规模纳税人可以开发票吗
不正确的减肥方法	正确的减肥方法
什么数的平方是十六	什么数的平方是二千零一十六
xr多少g	苹果xr多少g
苹果的说说	洛川苹果的说说
你几点起床	明天你几点起床
三百一十天等几个月	三等几个月
你们弟咋这么烦人呢	你咋这么烦人呢
北大研究生复试比例	北京科大研究生复试比例
夏天怕热冬天怕冷是什么体质	夏天怕热冬天不怕冷是什么体质
春笋吃多了会胖吗	笋吃多了会胖吗
过期的药能吃吗	没过期的药能吃吗
税金中不计入存货成本的有	税金中计入存货成本的有
aight怎么读	alight怎么读
什么时间比较吉利	明天什么时间比较吉利
absb什么意思	absorb什么意思
省简称是什么	内蒙古省简称是什么
怎样才能发烧	怎样才能不发烧
vr体验馆怎么样	北京vr体验馆怎么样
下载不多多	下载多多
r十一s充电提示音	r十一s充电无提示音
a九x充电速度	a九充电速度
小布天气咋样	小布明天天气咋样
什么韩剧最好看	前两年什么韩剧最好看
父母关系好对子女的影响	父母关系不好对子女的影响
夸克是不是是最小的	夸克是不是不是最小的
找回oppo账号密码	找回账号密码
中国名将	中国近代名将
捷豹xkrs多少钱	捷豹多少钱
充电充不满	充电充满
iiloveyou是什么意思	是什么意思
笋生吃有毒吗	春笋生吃有毒吗
今年高考出成绩时间	今年河南高考出成绩时间
怀孕了吐怎么回事	怀孕了没吐怎么回事
手机信息怎么弹不出来	手机信息怎么弹出来
富士康补办厂牌	深圳富士康补办厂牌
我好是什么意思	我不好是什么意思
理发店价格	深圳理发店价格
打开qq音乐放歌	打开音乐放歌
中国高速公路何时收费	中国高速公路何时不收费
山东开学	山东不开学
一开始贴面膜有点刺痛	贴面膜有点刺痛
放屁臭是什么原因	放屁不臭是什么原因
形容人开窍的歇后语	形容人不开窍的歇后语
同仁堂乌鸡白凤丸有几种包装	北京同仁堂乌鸡白凤丸有几种包装
淘口令不识别	淘口令识别
最近有什么好看的电影啊	最近有什么好看的韩国电影啊
a九停产时间	a九x停产时间
医科大学有二本吗	大连医科大学有二本吗
今天过得怎么样	大乔今天过得怎么样
ipone八plus上市时间	ipone八上市时间
四川广电数字电视节目表	广电数字电视节目表
四mah什么意思	mah什么意思
不会不会不会	会不会不会
三十二解锁方式	a三十二解锁方式
是什么意思	google是什么意思
草莓花属于完全花吗	草莓花属于不完全花吗
肚子疼不拉稀恶心想吐	肚子不疼不拉稀恶心想吐
怎么在网上交网费	怎么在网上交电信网费
月经推迟几天算正常	月经推迟几天算不正常
是什么意思	江南是什么意思
排卵后症状	排卵后无症状
今天早上用英语怎么说	今天用英语怎么说
珠海港潮汐时间表	珠海潮汐时间表
沈阳到英国多少公里	沈阳到英国伦敦多少公里
iamsohappy是什么意思	是什么意思
抽血看孕酮	抽血不看孕酮
宋茜择偶标准	择偶标准
感冒鼻子不通气	不感冒鼻子不通气
符号排行榜	中国符号排行榜
喝酒脸红的人能喝酒吗	喝酒不脸红的人能喝酒吗
机械能不包括哪些能	机械能包括哪些能
人的体温多少度算正常	人的体温多少度不算正常
最好笑的笑话	最不好笑的笑话
宝宝爱玩脚	宝宝不爱玩脚
吃完避孕药多久出血	吃完避孕药多久不出血
吕叔潜是谁	吕是谁
十一月十五号是星期几	十五号是星期几
属于产品成本的是	不属于产品成本的是
师范大学热门专业	云南师范大学热门专业
不怀孕的白带是什么样的	怀孕的白带是什么样的
国外怎么看待疫情	国外怎么看待中国疫情
演员黄澄澄的父亲	演员的父亲
areyousure是什么意思	是什么意思
autumn怎么读	wautumn怎么读
双鱼座的幸运颜色是什么	双鱼座的不幸运颜色是什么
痛风能吃什么药	痛风不能吃什么药
感冒咳嗽有痰	不感冒咳嗽有痰
怀孕的症状有哪些	没怀孕的症状有哪些
可以设置充电提示音吗	oppo可以设置充电提示音吗
廉洁的重要意义	清正廉洁的重要意义
不喜欢吃什么	喜欢吃什么
怎么还不来电	怎么还来电
清华的校训是什么	北大清华的校训是什么
猫头鹰叫预示着什么	猫头鹰不叫预示着什么
老觉得饿是怎么回事	老不觉得饿是怎么回事
铃木新奥拓重量	新奥拓重量
不消去的意思	消去的意思
什么星座长大有钱	什么星座长大没有钱
怎么控制发火	怎么控制不发火
观光车价格	香港观光车价格
上海明天有雨吗	上海有雨吗
长海医院怎么走	上海长海医院怎么走
京东白条怎么限制额度	京东白条怎么不限制额度
美国现在几点了	美国加州现在几点了
尿酮高是怎么回事	尿酮不高是怎么回事
北京明天有雨吗	北京有雨吗
买不起房子怎么办	买不起上海房子怎么办
吸烟的好处	不吸烟的好处
什么水果对肝好	什么水果对肝不好
sillage什么意思	silage什么意思
五点二十的计数单位是	十的计数单位是
怀女孩什么反应	怀女孩三个月什么反应
不绝什么四字成语	绝什么四字成语
不想吃甜的是怎么回事	想吃甜的是怎么回事
cad二千零一十四卸载干净	cad二千零一十四卸载不干净
宝宝发烧手脚烫	宝宝发烧手脚不烫
centur怎么读	centr怎么读
膝盖红肿疼痛怎么回事	膝盖红肿不疼痛怎么回事
尿液不臭不黄是什么原因	尿液臭不黄是什么原因
来大姨妈能测出怀孕吗	来大姨妈前两天能测出怀孕吗
吃头孢能喝酒吗	不吃头孢能喝酒吗
喉咙有痰咳嗽是什么原因	喉咙有痰不咳嗽是什么原因
做什么行业赚钱	将来做什么行业赚钱
二十一年一月一日是星期几	一月一日是星期几
令不什么什么成语	令什么什么成语
交强险可以过户吗	交强险可以不过户吗
intresting是什么意思	是什么意思
怎样会怀孕	怎样会不怀孕
proudofit是什么意思	是什么意思
距离台湾最近的岛屿	距离台湾最近的日本岛屿
笔记本怎么解密码	苹果笔记本怎么解密码
申通电话	无锡申通电话
手机进水了怎么办	oppo手机进水了怎么办
三d开奖什么号	昨天三d开奖什么号
大便干燥拉不出来怎么办	大便不干燥拉不出来怎么办
散的返义词	四散的返义词
宝宝发烧拉肚子	宝宝发烧不拉肚子
医科大学有二本吗	广西医科大学有二本吗
是什么意思	atteract是什么意思
一百七十八cm的明星	一百七十八的明星
美国的面积	美国华盛顿的面积
咳嗽喉咙有痰吃什么药	不咳嗽喉咙有痰吃什么药
youdabaddest是什么意思	dest是什么意思
买什么股票好	明天买什么股票好
马达上面的齿轮怎么弄下来	马达上面t的齿轮怎么弄下来
胡祗遹怎么读音	胡怎么读音
怀孕肚子上有一条线	没怀孕肚子上有一条线
胃疼拉肚子怎么回事	胃疼没拉肚子怎么回事
宫体肌层回声均匀是什么意思	宫体肌层回声不均匀是什么意思
副主席现任	中国副主席现任
宜川三村邮编	宜川邮编
怎样才能长胖	怎样才能长不胖
今天晚上的英文	晚上的英文
芙荃玫瑰花的折法	玫瑰花的折法
k七的型号名称介绍	k七x的型号名称介绍
电子科大考研复试占比	西安电子科大考研复试占比
stronger是什么意思	是什么意思
鬓角血管跳动疼	鬓角血管跳动不疼
世界上最厉害的武器是什么	世界上最不厉害的武器是什么
刷牙牙龈出血是什么原因	没刷牙牙龈出血是什么原因
微信零钱如何不显示金额	微信零钱如何显示金额
宝宝嗓子有痰怎么办	宝宝三个月嗓子有痰怎么办
宫外孕手术痛吗	宫外孕手术无痛吗
微信聊天记录怎么不显示日期	微信聊天记录怎么显示日期
把闹钟调到早上六点	把闹钟调到明天早上六点
我怎么说话	我怎么不说话
六合彩开盘了吗	香港六合彩开盘了吗
宝鸡区号	西安宝鸡区号
后天什么天气	明天后天什么天气
感冒打喷嚏怎么办	没感冒打喷嚏怎么办
英文名lin	英文名linux
一日英语怎么写	八月一日英语怎么写
酸奶结块还能喝吗	酸奶不结块还能喝吗
明天有没有下雪	有没有下雪
小孩哭声响亮	小孩哭声不响亮
空腹吃西红柿好吗	非空腹吃西红柿好吗
今天喝酒明天可以献血吗	今天星期三喝酒明天可以献血吗
同型半胱氨酸高	同型半胱氨酸不高
新兴领域的国家安全包括	新兴领域的国家安全不包括
上海师大附中有初中部吗	师大附中有初中部吗
同仁堂祛湿茶成分	北京同仁堂祛湿茶成分
每天掉多少头发算正常	每天掉多少头发算不正常
零点零二十五小时等多少分钟	五小时等多少分钟
怀孕多久胸会不疼	怀孕多久胸会疼
人为什么会胖	人为什么会不胖
烟台南山学院咋样	南山学院咋样
适合干洗的衣服	不适合干洗的衣服
手机没有	手机没有四
不自动连接音频是什么意思	自动连接音频是什么意思
imissyousomuch是什么意思	是什么意思
r十七多少钱	r十七cpu多少钱
临工二十装载机参数	山东临工二十装载机参数
拔罐痒是怎么回事	拔罐不痒是怎么回事
本田xrv型号	东风本田xrv型号
梦见被蛇咬	没梦见被蛇咬
笔记本电脑屏幕开不了	笔记本电脑屏幕开了
怀孕多久才想吐	怀孕多久才不想吐
售后电话	揭阳售后电话
不尽的意思是什么	尽的意思是什么
oppo手机怎样录屏	手机怎样录屏
yan字开头的歌词	yuan字开头的歌词
通讯公司有哪些	中国通讯公司有哪些
民政局星期六上班吗	方城民政局星期六上班吗
虾米音乐锁屏显示	虾米音乐锁屏不显示
颜值高的霸道总裁剧	颜值高的霸道总裁韩剧
正常白带是什么样的	不正常白带是什么样的
台湾是地区吗	台湾是东南亚地区吗
西安交大录取分数线	去年西安交大录取分数线
柯尼卡美能达客服	美能达客服
脂肪高的食物有哪些	脂肪不高的食物有哪些
他们去上学了吗英语	他们昨天去上学了吗英语
你不会玩捉迷藏吗	你们妹不会玩捉迷藏吗
tp是什么意思	trup是什么意思
我说的是vpn不是vip哦	我说的是vpn不是vp哦
感冒了怎么办	没感冒了怎么办
腊八蒜为什么变绿	腊八蒜为什么不变绿
