美国总统是谁	美国总统现在是谁
滴滴app无法使用	滴滴无法使用
今年距离春节还有多少天	距离春节还有多少天
我可以睡觉吗	我现在可以睡觉吗
帮我设置明天八点半的闹钟	帮我设置明天早上八点半的闹钟
现在几点了几点了	现在几点了现在几点了
什么节日	今天什么节日
关音乐关音乐	关音乐
你认识小薇吗	你认识小薇小薇吗
今天农历几号了	农历几号了
你在哪个国家	你现在在哪个国家
今天天气怎样今天天气怎样	天气怎样今天天气怎样
今天天气怎么样今天天气怎么样	今天天气怎么样天气怎么样
设置明天七点五十的闹钟	设置明天早上七点五十的闹钟
你现在能飞吗	你能飞吗
oppo最新款是什么型号	oppo现在最新款是什么型号
今天上海有雨吗	上海有雨吗
什么游戏	现在什么游戏
哈尔滨多少度	哈尔滨现在多少度
最近有没有好玩的游戏	有没有好玩的游戏
更新了不好用	现在更新了不好用
你到底怎么了	你现在到底怎么了
今天农历多少日	农历多少日
晚上适合吃什么饭	今天晚上适合吃什么饭
不今天天气怎么样	不小布今天天气怎么样
脂肪肝严重	脂肪肝严重不
现在疫情怎么样了	疫情怎么样了
六月那天日子好	今年六月那天日子好
早上吃的什么	吃的什么
农历是多少	现在农历是多少
下雨了没有	今天下雨了没有
最近有没有人找我	有没有人找我
上海今天有雨吗	上海有雨吗
怎么进去	现在怎么进去
你想谈恋爱吗	你现在想谈恋爱吗
银行也放假吗	银行今天也放假吗
不几点了	不现在几点了
吃饭了吗	现在吃饭了吗
本机可以语音唤醒吗	本机可以语音唤醒小布吗
后天下不下雨	后天下不下雨后天
不帮我打开手电筒	帮我打开手电筒
孕妇可以吃芒果不	孕妇可以吃芒果
为什么我的手机充电这么慢	为什么我的手机现在充电这么慢
中午多少度	今天中午多少度
什么手机最好	现在什么手机最好
好看的电影	最近好看的电影
设置明天七点四十的闹钟	设置明天早上七点四十的闹钟
有人打我没有	目前有人打我没有
今天外面有风吗	外面有风吗
洛阳高速收费不	洛阳高速收费
你家到底几口人	你家现在到底几口人
张杰今年多少岁了	张杰多少岁了
中午吃什么呀	今天中午吃什么呀
今天美元和人民币的汇率	美元和人民币的汇率
北京时间几点了	北京时间现在几点了
oppowatch不能回复微信了	oppowatch现在不能回复微信了
小布几点钟了	小布现在几点钟了
姨妈期间可以染发不	姨妈期间可以染发
oppo最新款手机是什么	现在oppo最新款手机是什么
我没有用耳机	我现在没有用耳机
设置明天十点的闹钟	设置明天早上十点的闹钟
几点了现在几点了	现在几点了现在几点了
今天美元的汇率	美元的汇率
孕妇可以吃兔子肉不	孕妇可以吃兔子肉
附近最近的餐厅	附近的餐厅
现在还有几度电	还有几度电
高速公路收费吗	高速公路今天收费吗
我问你几点了	我问你现在几点了
请问几点	请问现在几点
现在能否设置充电提示音	能否设置充电提示音
