joshua什么意思中文	josh什么意思中文
什么歌最好听	两年前什么歌最好听
下电影一般用什么软件	前两年下电影一般用什么软件
苹果手机七p屏幕上的悬浮球怎么设置	苹果手机七屏幕上的悬浮球怎么设置
宝宝发烧拉肚子	宝宝不发烧拉肚子
不打开qq音乐	不打开音乐
三月三日是什么座	三月是什么座
怎样可以长高	怎样可以不长高
南非是国家吗	南非是中东国家吗
fightover是什么意思	是什么意思
如何设置电脑不自动下载软件	如何设置电脑自动下载软件
诗歌英文	中国诗歌英文
heer怎么读	wheer怎么读
不失眠的抑郁症	失眠的抑郁症
睡觉头痛怎么办	没睡觉头痛怎么办
发烧拉肚子怎么回事	没发烧拉肚子怎么回事
师范大学热门专业	赣南师范大学热门专业
热巴为什么被新浪限流	迪丽热巴为什么被新浪限流
正式关系是什么意思	非正式关系是什么意思
excel显示div零	excel不显示div零
观光车价格	重庆观光车价格
大便什么颜色正常	大便什么颜色不正常
微信显示名字	微信没显示名字
转移性支出不包括	转移性支出包括
你不懂英语吗	你懂英语吗
不正常体温是多少度	正常体温是多少度
手机怎么使用卡二流量	电信手机怎么使用卡二流量
南京天气怎样	南京下个月天气怎样
小孩皮肤好	小孩皮肤不好
正常白带是什么样的	非正常白带是什么样的
近几年房价走势图	近几年长沙房价走势图
k七有呼吸灯吗	k七没有呼吸灯吗
夏天手上起小水泡痒	夏天手上没起小水泡痒
苹果xmax前置摄像头像素	苹果前置摄像头像素
吐鲁番售后什么时候上班	售后什么时候上班
七月七日是什么星座	七月是什么星座
名爵多少钱一辆	名爵zs多少钱一辆
arrgh怎么读	argh怎么读
分等多少秒	十分等多少秒
北大录取分数线	河北北大录取分数线
美版手机电信卡能用吗	美版苹果手机电信卡能用吗
坚果手机怎么root	坚果手机怎么
人类的发展方向	未来人类的发展方向
中行客服	中央银行客服
怎么念	how怎么念
mee什么意思	mmee什么意思
中国新蜜蜂用英语怎么说	新蜜蜂用英语怎么说
a十一x是否支持息屏时钟	a十一是否支持息屏时钟
新大洲电瓶车座椅怎么打开	新大洲本田电瓶车座椅怎么打开
十二月二十二日是什么座	十二月是什么座
如何更换qq群管理员	如何更换群管理员
喜欢雨的植物	喜欢秋雨的植物
微信来信息亮屏	微信来信息不亮屏
肯德基最大股东	肯德基麦当劳最大股东
美金汇率	前三年美金汇率
狭义的卫生服务组织不包括	狭义的卫生服务组织包括
吃什么药可以让心电图正常	吃什么药可以让心电图不正常
产后月经不规律	产后三个月月经不规律
形容不好吃的句子	形容好吃的句子
0八年房价多少	0八年长沙房价多少
莫什么什么及成语	什么什么及成语
花洒喷出来的水不集中	花洒喷出来的水集中
何时开六合彩	何时开香港六合彩
whatsthematter是什么意思	是什么意思
什么音乐好听	什么音乐不好听
商业银行核心资本不包括	商业银行核心资本包括
梦见死去的姥姥说话	梦见死去的姥姥不说话
微信怎么查的聊天记录	微信怎么查去年的聊天记录
非萎缩是什么意思	萎缩是什么意思
howoldareyou是什么意思	是什么意思
月经来几天算正常	月经来几天算不正常
满五非唯一是什么意思	满五唯一是什么意思
科目一考多久过期	科目一没考多久过期
联通卡套餐	河南联通卡套餐
最稳定的自由基是	最不稳定的自由基是
vegetable怎么拼读	vegetables怎么拼读
二月三什么星座	二月什么星座
湖南二千零一十九中考分数线	湖南师大二千零一十九中考分数线
missingyoumust是什么意思	是什么意思
荣耀二十支持光学防抖吗	荣耀二十s支持光学防抖吗
形容工具好用	形容工具不好用
三十七点三℃算发烧吗	三十℃算发烧吗
走心的暗示什么意思	不走心的暗示什么意思
理财产品没有收益	理财产品昨天没有收益
op怎么查是不是正品	怎么查是不是正品
每天洗澡用热水对身体有作用嘛	每天洗澡用非热水对身体有作用嘛
鼻涕不粘稠不发黄	鼻涕粘稠不发黄
泌乳素高怎么办	泌乳素不高怎么办
非经常性的放屁好吗	经常性的放屁好吗
疫情为什么严重	疫情为什么不严重
中医药大学专业有哪些	广西中医药大学专业有哪些
慢性胃窦炎严重吗	非慢性胃窦炎严重吗
咽炎会咳嗽吗	咽炎会不咳嗽吗
我今年十二岁的英文	我十二岁的英文
什么无什么迹	什么什么迹
还有多少天	这个月还有多少天
cand怎么读	candle怎么读
十二号是星期几	十二月二号是星期几
c语言错误	语言错误
湖南的三本院校	湖南师大的三本院校
汽车关税	美国汽车关税
干咳是什么原因	睡前干咳是什么原因
便秘怎么办	不便秘怎么办
现在天气怎么样	现在武汉天气怎么样
身体不好的星座	身体好的星座
睡觉头痛怎么办	不睡觉头痛怎么办
形容不尊重别人的句子	形容尊重别人的句子
阳历八月二十三日是什么星座的	阳历八月二是什么星座的
二十年吉林高考时间	二十年吉林春季高考时间
月经前症状	月经前无症状
怀孕乳房变化	怀孕乳房无变化
没怀孕初期见红正常吗	怀孕初期见红正常吗
请问手机锁屏打不开怎么办	请问手机android锁屏打不开怎么办
河南有什么好玩的地方	河南西安有什么好玩的地方
oppo手机坏了怎么修	手机坏了怎么修
发烧咽喉痛吃什么药	不发烧咽喉痛吃什么药
二十年四月十七日吉时	二十年四月吉时
社会主义发达阶段	社会主义不发达阶段
我是歌手淘汰谁了	我是歌手昨天淘汰谁了
如何查询的航班信息	如何查询以往的航班信息
二手房利率是多少	深圳二手房利率是多少
宝宝胃酸反流症状	宝宝三个月胃酸反流症状
下载小红书没	下载小红书
a五支持全局吗	oppoa五支持全局吗
十一月一日是什么星座	一月一日是什么星座
不想去上学的句子	想去上学的句子
洛阳猪肉多少钱一斤	去年洛阳猪肉多少钱一斤
十五ml水等多少克	十五l水等多少克
如果美国赖掉外债会怎么样	如果美国赖掉中国外债会怎么样
苹果怎样不黑屏	苹果怎样黑屏
固液不加热型的化学方程式	固液加热型的化学方程式
y如何设置充电提示音	如何设置充电提示音
什么人适合穿汉服	什么人不适合穿汉服
形容东西少的成语	形容东西不少的成语
感冒为什么会咳嗽	不感冒为什么会咳嗽
如何追一个不认识的男生	如何追一个认识的男生
小孩扁桃体发炎发烧	小孩扁桃体发炎不发烧
叙利亚的样子	多年前叙利亚的样子
iamyourfather是什么意思	是什么意思
十六年最火的歌曲	十六年最火的韩国歌曲
成都天气怎么样	成都明天天气怎么样
最近好看的电影	最近好看的香港电影
南海区联通营业厅位置	联通营业厅位置
中国有多少大学生	去年中国有多少大学生
吃什么对皮肤好	吃什么对皮肤不好
家里养什么植物不好	家里养什么植物好
苏州有什么好吃的	苏州西山有什么好吃的
干净男孩讨女生喜欢吗	不干净男孩讨女生喜欢吗
经常做梦是因为什么原因	经常不做梦是因为什么原因
世界杯冠军是哪个国家	明年世界杯冠军是哪个国家
不整洁的英语单词	整洁的英语单词
理想信念坚定的例子	理想信念不坚定的例子
喂奶能不喝酒吗	喂奶能喝酒吗
梦到自己不穿裤子	梦到自己穿裤子
一号线地铁时间表	一号线北京地铁时间表
什么是人寿	什么是中国人寿
中国残联标志	残联标志
birthday怎么翻译	birthdaycake怎么翻译
屁多又臭是什么原因	屁多又不臭是什么原因
几种形状不健康大便图	几种形状健康大便图
一等几	熊熊加一等几
牙龈肿出血	牙龈肿不出血
西安普惠体检项目有哪些	西安体检项目有哪些
萨摩耶吃什么	萨摩耶不吃什么
nothanks是什么意思	是什么意思
excel匹配两个表格相同数据	excel匹配两个表格不相同数据
吃了紧急避孕药出血	吃了紧急避孕药不出血
你有爷爷吗	你没有爷爷吗
ps怎么调节图片的透明度	wps怎么调节图片的透明度
三十用英语怎么说	六点三十用英语怎么说
三分钟后关闭音乐	分钟后关闭音乐
天平女爱你的表现	天平女不爱你的表现
什么网游比较好玩	五年前什么网游比较好玩
不忘记过去的名言	忘记过去的名言
什么花对室内空气好	什么花对室内空气不好
手机号码欠费不注销	手机号码欠费注销
调个八点的闹钟	调个明天早上八点的闹钟
医大二院开诊了吗	沈阳医大二院开诊了吗
绝地求生刺激战场国际服怎么登进去	绝地求生刺激战场国际服怎么登不进去
是否写完作业	是否写不完作业
什么地方出现过龙卷风	昨天什么地方出现过龙卷风
二千零一十高考人数	二千零一十北京高考人数
喝酒头疼怎么回事	没喝酒头疼怎么回事
四季春维瓦尔第简谱	四季春简谱
身上好多红色的点点痒	身上好多红色的点点不痒
华南理工复试比重	华工复试比重
今天几年	今天几年几月几日
北京天气怎样	前天北京天气怎样
老年人吃什么好	老年人吃什么不好
一直出汗是什么原因	一直不出汗是什么原因
吉林农大占地面积排名	吉大占地面积排名
是十一的倍数有什么特点	是一的倍数有什么特点
新生儿老放屁是怎么回事	新生儿一个月老放屁是怎么回事
猫咪拉屎怎么办	猫咪没拉屎怎么办
吃水果发胖	吃水果不发胖
为什么怀孕不来月经	为什么没怀孕不来月经
感冒嗓子干痒咳嗽怎么办	没感冒嗓子干痒咳嗽怎么办
小布打开uc浏览器	小布打开浏览器
前后对称的成语	前后不对称的成语
不辜负自己的意思是什么	辜负自己的意思是什么
一元国辉硬币值钱吗	一元硬币值钱吗
r级排行榜	日本r级排行榜
南京信息工程大学代码	信息工程大学代码
武汉什么天气	武汉明天什么天气
不觉得无聊的成语	觉得无聊的成语
一用英文怎么说	十一用英文怎么说
大便的正常颜色	大便的不正常颜色
不大喊大叫的英文	大喊大叫的英文
水调歌头的意	苏轼水调歌头的意
万圣节前夕的英语怎么说	万圣节的英语怎么说
狗开心的表现	狗不开心的表现
下巴不尖适合什么发型	下巴尖适合什么发型
有说明书吗	没有说明书吗
白带不粘稠不发黄	白带粘稠不发黄
六月十三日是什么星座	六月是什么星座
八十九年十二月初七阳历是多少	阳历是多少
吃了避孕药这个月会怀孕吗	上个月吃了避孕药这个月会怀孕吗
手机root有什么用	手机有什么用
经常梦到的人和事	经常梦到过去的人和事
oppo有没有颜色反转功能	有没有颜色反转功能
客服热线	oppo客服热线
十月二十五日是什么星座	十月是什么星座
孕三十九周胎动减少正常吗	孕三十胎动减少正常吗
不流鼻涕喉咙不痛是什么感冒	流鼻涕喉咙不痛是什么感冒
疫情开什么厂挣钱	疫情前两年开什么厂挣钱
surge怎么读	surgeon怎么读
像我们姐这么帅的人有几个	像我这么帅的人有几个
东莞是什么区	东莞长安是什么区
怎样下载视频到手机上	怎样下载视频到苹果手机上
手环消息不提示	手环消息提示
双色球开奖号码	昨晚双色球开奖号码
什么数的平方等零点五	什么数的平方等五
rest什么意思中文	restless什么意思中文
正确佩戴口罩的方式	不正确佩戴口罩的方式
中山公园在哪里	北京中山公园在哪里
今天晚上有雨没	今天有雨没
今年农历	今年农历几月几日
新生儿需要多少纸尿裤	新生儿前三天需要多少纸尿裤
oppo系统啥时候更新	系统啥时候更新
野马有几座	福特野马有几座
打开gps工具箱	打开工具箱
形容不洗澡的词语	形容洗澡的词语
同学的英语	同班同学的英语
八十七年三月九日农历多少	三月九日农历多少
小孩咳嗽没有痰怎么办	小孩咳嗽有痰怎么办
明天有没有雪	有没有雪
沙特拉伯首都	沙特首都
residence是什么意思	是什么意思
晚上不吃饭对身体好吗	晚上吃饭对身体好吗
胡冰卿背景	胡背景
距离七月五日还有多少天	距离七月还有多少天
五月一日是什么星座	月一日是什么星座
法国风景名胜	法国巴黎风景名胜
vivi我们来玩词语接龙吧	我们来玩词语接龙吧
关是什么意思	无关是什么意思
南京晓庄学院美术生分数线	晓庄学院美术生分数线
白茶适合什么人喝	白茶不适合什么人喝
关系的英文	没关系的英文
爱出汗是怎么回事	不爱出汗是怎么回事
whatarethey是什么意思	是什么意思
四点八的平方是多少	八的平方是多少
喜欢喝冰水是什么体质	不喜欢喝冰水是什么体质
形容开心的成语是什么	形容不开心的成语是什么
梦见喜欢的小男孩	梦见不喜欢的小男孩
正确的饮食方式	不正确的饮食方式
快餐连锁品牌有哪些	中国快餐连锁品牌有哪些
月经周期多少天正常	月经周期多少天不正常
deli是什么牌子	delivery是什么牌子
手上起小水泡不痒是怎么回事	手上起小水泡痒是怎么回事
为什么会下雨	为什么会不下雨
明天北京天气怎么样	明天北京方山天气怎么样
a七十二的上市时间	a七十二n的上市时间
乙肝会传染吗	乙肝会不传染吗
我不喜欢足球用英语怎么读	我喜欢足球用英语怎么读
八十九年农历五月二十五日出生的人是什么星座	八十九年农历五月出生的人是什么星座
设置早上六点四十闹钟	设置明天早上六点四十闹钟
晚餐可以不吃主食吗	晚餐可以吃主食吗
tfboy三个人的身高	tfboys三个人的身高
播放beyond的歌曲	播放的歌曲
资产证券化对发起人的意义包括	资产证券化对发起人的意义不包括
股市怎么样	未来股市怎么样
欢乐谷日场两次票什么意思	成都欢乐谷日场两次票什么意思
hear过去式和过去	过去式和过去
三是几月几日	上个星期三是几月几日
增值税发票可以不抵扣吗	增值税发票可以抵扣吗
直邮要多久	美国直邮要多久
富士康所在地	深圳富士康所在地
mn开头的苹果手机	mwn开头的苹果手机
梦见大雪堆积如山	梦见大雪堆
中山公园在哪里	厦门中山公园在哪里
七号是星期几	十一月七号是星期几
六月二十八日是什么星座	六月是什么星座
迪斯尼乐园游玩项目	香港迪斯尼乐园游玩项目
联通移动电信哪个好	上海联通移动电信哪个好
北大二千零二十考研分数线	北京科大二千零二十考研分数线
用英文	out用英文
剪映如何不压缩	剪映如何压缩
不细心的英语怎么说	细心的英语怎么说
足球球员名单	日本足球球员名单
不自欺欺人是什么意思	自欺欺人是什么意思
picture是什么意思	是什么意思
二十年高考什么时候	二十年广州高考什么时候
三手机正常使用时出现自动锁屏的原因	手机正常使用时出现自动锁屏的原因
十月一日上升星座是什么	十月上升星座是什么
温岭夹屿在哪个地方	温岭在哪个地方
怀孕能吃吗	怀孕能吃白灵菇吗
女人好的说说	女人不好的说说
什么水果对肾好	什么水果对肾不好
习惯空腹喝豆浆好吗	习惯非空腹喝豆浆好吗
富士康年产值	郑州富士康年产值
北京天坛医院icu病房一天多少钱	北京医院icu病房一天多少钱
怀孕小腹坠疼	怀孕三个月小腹坠疼
二十年春节还有多少天	二十年还有多少天
我一直在做作业你呢	我昨天一直在做作业你呢
beleg什么意思	beeg什么意思
早上空腹喝牛奶好吗	早上非空腹喝牛奶好吗
七十年代人口	七十年代香港人口
眼睛发红发痒吃什么药	眼睛发痒吃什么药
keep下载后的运动视频在哪里删除	keep下载后的运动视频在youtube哪里删除
欢乐谷怎么收费的	上海欢乐谷怎么收费的
形容唱歌好听	形容唱歌不好听
后天学习论的代表人物	后天学习论的五代表人物
属猪的跟什么合	属猪的跟什么不合
常德有雨吗	常德明天有雨吗
西安五百强企业排名	西安百强企业排名
要不要喝茶你	要不要喝茶你们叔
re什么意思啊	repair什么意思啊
on是什么意思	online是什么意思
打开uc浏览器	打开浏览器
什么食物不含锌	什么食物含锌
孕妇不能吃什么	孕妇能吃什么
全国有多少个叫李馨的	全国有多少个叫李馨怡的
州庆是什么时候	是什么时候
re什么意思啊	repost什么意思啊
梦见不来月经	梦见来月经
境界不高什么意思	境界高什么意思
南昌天气如何	南昌明天天气如何
怎么样才能瘦脸	怎么样才能不瘦脸
打开qq打开	打开qq打开qq
whatis是什么意思	是什么意思
开车多的剧	开车多的韩剧
摩根大通证券股票代码	大通证券股票代码
月经流鼻血	月经前两天流鼻血
怎么让新生儿睡觉	怎么不让新生儿睡觉
什么样的征信是好的	什么样的征信是不好的
鼻痒打喷嚏不停流鼻涕	鼻不痒打喷嚏不停流鼻涕
二点五乘	二点五乘二点五
恐龙园学生证查得严吗	常州恐龙园学生证查得严吗
郑州天气怎么样	郑州明天天气怎么样
菌类白参怎么吃	菌类怎么吃
什么游戏最好玩	什么游戏最不好玩
尺度非常大的电影	尺度非常大的美国电影
来例假洗澡好吗	来例假不洗澡好吗
imfine是什么意思	是什么意思
张家港天气怎么样	明天张家港天气怎么样
宝马三百二十li的空调滤芯在哪	宝马三百二十的空调滤芯在哪
六十四g和二百五十六g的区别	六十四g和二百五十六的区别
好老师的特点	不好老师的特点
长城汽车怎么样	保定长城汽车怎么样
梦见自己的样子	梦见自己未来的样子
微信照片保存	微信照片不保存
关闭qq后台运行	关闭后台运行
不健康的表现	健康的表现
马达上面的齿轮怎么弄下来	马达上面d的齿轮怎么弄下来
剑桥大学在哪里	英国剑桥大学在哪里
急性支气管炎不发烧	急性支气管炎发烧
清华有多大	北大清华有多大
主人确实是我们妹的名字	主人确实是我的名字
空腹吃什么舒服	空腹吃什么不舒服
二十年农历七月份黄道吉日	二十年农历七月份
满天星可以不施肥吗	满天星可以施肥吗
头晕恶心不想吐	头晕不恶心不想吐
怎样在手机上下载视频	怎样在苹果手机上下载视频
小米十pro移动权益版什么意思	小米十移动权益版什么意思
不属于乒乓球三大国际赛事	属于乒乓球三大国际赛事
医科大学就业	温州医科大学就业
怀孕要吃叶酸吗	没怀孕要吃叶酸吗
郑州天气怎么样	郑州昨天天气怎么样
qq群宣传语怎么写	群宣传语怎么写
血气方正的读音	血气的读音
开空调为什么不滴水	开空调为什么滴水
十的英文翻译	十五天的英文翻译
小米怎么进去recovery模式	小米怎么进去recover模式
过春节的风俗习惯	古代过春节的风俗习惯
蓝牙耳机电量不显示	蓝牙耳机电量显示
柬埔寨是不是国家	柬埔寨是不是东南亚国家
宽容的反面事例简短	不宽容的反面事例简短
选择连续的相似颜色区域	选择不连续的相似颜色区域
johann怎么读	johan怎么读
猫拉屎臭正常吗	猫拉屎不臭正常吗
苹果手机怎么定位	苹果手机怎么不定位
错误代码十一是什么意思	错误代码一是什么意思
为什么人的体温不一样	为什么人的体温一样
梦到了去世亲人	昨天梦到了去世亲人
形容东西好的字	形容东西不好的字
息屏时间改为	息屏时间改为五分钟
iphone静音键不震动	iphone静音键震动
电动车刹车太灵	电动车刹车不太灵
手脚发热是怎么回事	手脚不发热是怎么回事
springfestival是什么意思	是什么意思
不讲信用的意思是什么	讲信用的意思是什么
把息屏时间调到	把息屏时间调到三十分钟
蓝色配什么颜色好看	蓝色配什么颜色不好看
孕妇可以吃冰淇淋吗	孕妇可以吃芒果冰淇淋吗
和叶有关的诗句	和秋叶有关的诗句
家里鱼缸不养鱼好吗	家里鱼缸养鱼好吗
水果花都有什么颜色	水果有什么颜色
怀孕不能吃什么	怀孕不能不吃什么
五行属火的吉利字	五行属火的字
晚上吃什么好	晚上吃什么不好
演员郭新馨	演员馨
石家庄到大寨多少公里	石家庄到山西大寨多少公里
爱洗澡对身体好吗	不爱洗澡对身体好吗
邮政国际邮费价格表	中国邮政国际邮费价格表
复旦成考录取分数线	上海复旦成考录取分数线
联通转套餐	上海联通转套餐
七月十八日是什么星座	七月是什么星座
哺乳期能吃春笋吗	哺乳期能吃笋吗
腰围七十六cm等多少尺	腰围七十六等多少尺
最便宜的oppo多少钱	最便宜的多少钱
多少度呢	明天多少度呢
摩托车加油熄火	摩托车没加油熄火
指南针sw是什么意思	指南针snew是什么意思
广东移动短号怎么取消	移动短号怎么取消
云台山今天人多吗	焦作云台山今天人多吗
发烧不咳嗽会是新型肺炎吗	不发烧不咳嗽会是新型肺炎吗
药流流干净几率大吗	药流流不干净几率大吗
吃减肥药口渴	吃减肥药口不渴
快手怎么才能让人看到	快手怎么才能不让人看到
长安在哪里	东莞长安在哪里
北京有什么地方可以去玩的	多年前北京有什么地方可以去玩的
精英律师中何塞的扮演者	精英律师中的扮演者
三省指什么	省指什么
swetheart是什么意思	是什么意思
怀孕挂什么科	没怀孕挂什么科
宝宝喜欢谁	宝宝不喜欢谁
我不喜欢猫英语	我喜欢猫英语
火锅包厢名字	重庆火锅包厢名字
排卵不正常月经推迟	排卵正常月经推迟
大便干燥出血	大便不干燥出血
久的近义词	天长地久的近义词
r十七pro充满电需要多久	r十七充满电需要多久
男的吧你们妹妹是不是啊	男的吧你是不是啊
不清醒什么意思	清醒什么意思
胃疼还拉肚子怎么回事	胃疼还不拉肚子怎么回事
五g多少兆	电信五g多少兆
天猫旗舰店有假货吗	苹果天猫旗舰店有假货吗
四月三十日是什么星座	日是什么星座
医院可以体检吗	医院下午可以体检吗
天气怎么样	明天天气怎么样
中午地震了吗	昨天中午地震了吗
病人所用药品的费用	昨天病人所用药品的费用
不发烧怎么办	发烧怎么办
蛀牙可以不治疗吗	蛀牙可以治疗吗
医院排名	广州医院排名
五月十九日是什么星座	五月是什么星座
矩阵可逆秩为多少	矩阵不可逆秩为多少
drf什么意思	dwarf什么意思
蒙台梭利教学法的特点	教学法的特点
品牌电器有哪些	日本品牌电器有哪些
八十七年三月九日是什么星座	三月九日是什么星座
微信怎么推荐qq好友	微信怎么不推荐qq好友
脾胃虚寒宜吃什么食物	脾胃虚寒不宜吃什么食物
六合彩什么时候来	香港六合彩什么时候来
走不动了	马都走不动了
富士康补办厂牌	成都富士康补办厂牌
宝宝不发烧出疹子	宝宝发烧出疹子
三星和苹果哪个耐用皮实	三星和苹果哪个耐用
正常大便颜色	不正常大便颜色
tvb电视剧在哪看	香港tvb电视剧在哪看
口腔溃疡吃什么好	口腔溃疡吃什么不好
马达上面的齿轮怎么弄下来	马达上面l的齿轮怎么弄下来
a七十二充电时长	a七十二阿德充电时长
打嗝怎么办	不打嗝怎么办
不化妆要擦隔离霜吗	化妆要擦隔离霜吗
可不可以给你换个名字	明天可不可以给你换个名字
平安银行的电话	中国平安银行的电话
北大招生分数线	北京科大招生分数线
为什么天天晚上做梦	为什么天天晚上不做梦
汉川月子中心在哪里	汉川月子中心在上海哪里
我今年十一岁了用英语怎么说	我十一岁了用英语怎么说
不运动瘦大腿	运动瘦大腿
三吨等几千克	吨等几千克
血压正常范围	血压不正常范围
两个月宝宝咳嗽有痰怎么办	两个月宝宝不咳嗽有痰怎么办
二百音浪多少钱	二百w音浪多少钱
早餐吃什么容易胖	早餐吃什么不容易胖
热巴的脚多大码	迪丽热巴的脚多大码
k七是否支持otg	k七x是否支持otg
吃瓜子会胖吗	吃黑南瓜子会胖吗
结膜炎怎么治好	结膜炎怎么治不好
满十六怎么办银行卡	不满十六怎么办银行卡
北京卫视频道节目表	明天北京卫视频道节目表
交强险可以不过户吗	交强险可以过户吗
谈恋爱有什么好	谈恋爱有什么不好
白细胞多少正常	白细胞多少不正常
电脑如何设置密码	电脑如何不设置密码
今年什么生意好做	今年什么生意不好做
社保局周末上班吗	双流社保局周末上班吗
行为训练的主要教学方法不包括	行为训练的主要教学方法包括
你们姐姐怎么不再换一个cd呢	你怎么不再换一个cd呢
firona是什么意思	是什么意思
什么食物对心脏好	什么食物对心脏不好
人保车险怎么样可靠吗	中国人保车险怎么样可靠吗
opporll换屏多少钱	oppo换屏多少钱
不发面面食的做法花样大全	发面面食的做法花样大全
北京发生啥事了	昨天北京发生啥事了
tonia怎么读	toni怎么读
什么歌曲好听	什么歌曲不好听
为什么每次怀孕反应都不一样	为什么每次怀孕反应都一样
移动宽带改密码	浙江移动宽带改密码
经常放屁好吗	不经常放屁好吗
广东什么地方疫情严重	广东什么地方疫情不严重
spy是什么意思	sp是什么意思
生理期吃什么好	生理期吃什么不好
wps不显示分页符	wps显示分页符
巢湖火车时刻表	巢湖合肥火车时刻表
肺炎吃什么好	肺炎吃什么不好
放邓丽君歌曲	放歌曲
北大哪个街道	北京科大哪个街道
找到删除的照片	找不到删除的照片
荣耀八x上市时间	荣耀八上市时间
你不用的英文	你用的英文
打开qq面对面快传	打开面对面快传
慈善事业发展状况	中国慈善事业发展状况
一百g南瓜的热量	一百南瓜的热量
四岁宝宝不憋尿怎么办	四岁宝宝憋尿怎么办
三d开什么	今晚三d开什么
好伤心是什么意思	好不伤心是什么意思
为什么总是不感觉饿	为什么总是感觉饿
胆固醇高的食物	胆固醇不高的食物
经常放屁好不好	经常不放屁好不好
身体怕冷是什么原因	身体不怕冷是什么原因
前置胎盘胎动明显吗	前置胎盘胎动不明显吗
形容显眼的词语	形容不显眼的词语
宁波是哪个省	宁波港是哪个省
手机如何快速充电	oppo手机如何快速充电
太和医院呼吸内科主任	十堰太和医院呼吸内科主任
什么单机游戏好玩	十年前什么单机游戏好玩
喝酒为什么痛风	不喝酒为什么痛风
属于非活性混合材料的是	属于活性混合材料的是
明基台灯有实体店吗	明基台灯南京有实体店吗
会不会下雨啊	下周会不会下雨啊
口腔黏膜磨砂感痛	口腔黏膜磨砂感不痛
近几年房价走势图	近几年成都房价走势图
奉贤区联通营业厅地址	联通营业厅地址
overthebridge是什么意思	是什么意思
re什么意思啊	remind什么意思啊
二千零一十高考人数	二千零一十广东高考人数
sayyouagain是什么意思	是什么意思
肉芽组织触之易出血	肉芽组织触之不易出血
雌激素高吃什么好	雌激素不高吃什么好
来例假拉肚子	不来例假拉肚子
excuseme是什么意思	是什么意思
哪些食物含淀粉	哪些食物不含淀粉
happyteam是什么意思	是什么意思
四特东方韵弘韵四十五度价格	四特东方韵四十五度价格
什么茶是苦的	什么茶是无苦的
不什么什么心	什么什么心
怎样死的痛快	怎样死的不痛快
脚长二十五cm穿多大码	脚长二十五穿多大码
有关的诗句	有关秋天的诗句
手机的辐射大吗	oppo手机的辐射大吗
语言分为哪几种	c语言分为哪几种
冰箱两边热是怎么回事	冰箱两边不热是怎么回事
setdefault什么意思	setupdefault什么意思
好看的同性电视剧	好看的韩国同性电视剧
联通流量套餐介绍	上海联通流量套餐介绍
什么时间吃姜	什么时间不吃姜
来月经前胸疼正常吗	来月经前胸不疼正常吗
鸡不下蛋的原因	鸡下蛋的原因
手心脚心出汗是什么原因	手心脚心不出汗是什么原因
二千零一十九地产排名	二千零一十九广州地产排名
oppo手机有录音功能吗	手机有录音功能吗
马达上面的齿轮怎么弄下来	马达上面c的齿轮怎么弄下来
按焊条的用途分类不包括	按焊条的用途分类包括
火机油成分	zippo火机油成分
新生儿打嗝怎么办	新生儿不打嗝怎么办
护理法的内容不包括	护理法的内容包括
我忘记我的oppo密码了	我忘记我的密码了
北京会下雨吗	北京后天会下雨吗
丹东最低温度	丹东冬季最低温度
打个电话八	打个电话
黑人自杀率	美国黑人自杀率
oppowatch防水吗	watch防水吗
a七十二n的上市时间	a七十二的上市时间
小规模纳税人可以不开发票吗	小规模纳税人可以开发票吗
不正确的减肥方法	正确的减肥方法
什么数的平方是十六	什么数的平方是二千零一十六
xr多少g	苹果xr多少g
苹果的说说	洛川苹果的说说
你几点起床	明天你几点起床
三百一十天等几个月	三等几个月
你们弟咋这么烦人呢	你咋这么烦人呢
北大研究生复试比例	北京科大研究生复试比例
夏天怕热冬天怕冷是什么体质	夏天怕热冬天不怕冷是什么体质
春笋吃多了会胖吗	笋吃多了会胖吗
过期的药能吃吗	没过期的药能吃吗
税金中不计入存货成本的有	税金中计入存货成本的有
aight怎么读	alight怎么读
什么时间比较吉利	明天什么时间比较吉利
absb什么意思	absorb什么意思
省简称是什么	内蒙古省简称是什么
怎样才能发烧	怎样才能不发烧
vr体验馆怎么样	北京vr体验馆怎么样
下载不多多	下载多多
r十一s充电提示音	r十一s充电无提示音
a九x充电速度	a九充电速度
小布天气咋样	小布明天天气咋样
什么韩剧最好看	前两年什么韩剧最好看
父母关系好对子女的影响	父母关系不好对子女的影响
夸克是不是是最小的	夸克是不是不是最小的
找回oppo账号密码	找回账号密码
中国名将	中国近代名将
捷豹xkrs多少钱	捷豹多少钱
充电充不满	充电充满
iiloveyou是什么意思	是什么意思
笋生吃有毒吗	春笋生吃有毒吗
今年高考出成绩时间	今年河南高考出成绩时间
怀孕了吐怎么回事	怀孕了没吐怎么回事
手机信息怎么弹不出来	手机信息怎么弹出来
富士康补办厂牌	深圳富士康补办厂牌
我好是什么意思	我不好是什么意思
理发店价格	深圳理发店价格
打开qq音乐放歌	打开音乐放歌
中国高速公路何时收费	中国高速公路何时不收费
山东开学	山东不开学
一开始贴面膜有点刺痛	贴面膜有点刺痛
放屁臭是什么原因	放屁不臭是什么原因
形容人开窍的歇后语	形容人不开窍的歇后语
同仁堂乌鸡白凤丸有几种包装	北京同仁堂乌鸡白凤丸有几种包装
淘口令不识别	淘口令识别
最近有什么好看的电影啊	最近有什么好看的韩国电影啊
a九停产时间	a九x停产时间
医科大学有二本吗	大连医科大学有二本吗
今天过得怎么样	大乔今天过得怎么样
ipone八plus上市时间	ipone八上市时间
四川广电数字电视节目表	广电数字电视节目表
四mah什么意思	mah什么意思
不会不会不会	会不会不会
三十二解锁方式	a三十二解锁方式
是什么意思	google是什么意思
草莓花属于完全花吗	草莓花属于不完全花吗
肚子疼不拉稀恶心想吐	肚子不疼不拉稀恶心想吐
怎么在网上交网费	怎么在网上交电信网费
月经推迟几天算正常	月经推迟几天算不正常
是什么意思	江南是什么意思
排卵后症状	排卵后无症状
今天早上用英语怎么说	今天用英语怎么说
珠海港潮汐时间表	珠海潮汐时间表
沈阳到英国多少公里	沈阳到英国伦敦多少公里
iamsohappy是什么意思	是什么意思
抽血看孕酮	抽血不看孕酮
宋茜择偶标准	择偶标准
感冒鼻子不通气	不感冒鼻子不通气
符号排行榜	中国符号排行榜
喝酒脸红的人能喝酒吗	喝酒不脸红的人能喝酒吗
机械能不包括哪些能	机械能包括哪些能
人的体温多少度算正常	人的体温多少度不算正常
最好笑的笑话	最不好笑的笑话
宝宝爱玩脚	宝宝不爱玩脚
吃完避孕药多久出血	吃完避孕药多久不出血
吕叔潜是谁	吕是谁
十一月十五号是星期几	十五号是星期几
属于产品成本的是	不属于产品成本的是
师范大学热门专业	云南师范大学热门专业
不怀孕的白带是什么样的	怀孕的白带是什么样的
国外怎么看待疫情	国外怎么看待中国疫情
演员黄澄澄的父亲	演员的父亲
areyousure是什么意思	是什么意思
autumn怎么读	wautumn怎么读
双鱼座的幸运颜色是什么	双鱼座的不幸运颜色是什么
痛风能吃什么药	痛风不能吃什么药
感冒咳嗽有痰	不感冒咳嗽有痰
怀孕的症状有哪些	没怀孕的症状有哪些
可以设置充电提示音吗	oppo可以设置充电提示音吗
廉洁的重要意义	清正廉洁的重要意义
不喜欢吃什么	喜欢吃什么
怎么还不来电	怎么还来电
清华的校训是什么	北大清华的校训是什么
猫头鹰叫预示着什么	猫头鹰不叫预示着什么
老觉得饿是怎么回事	老不觉得饿是怎么回事
铃木新奥拓重量	新奥拓重量
不消去的意思	消去的意思
什么星座长大有钱	什么星座长大没有钱
怎么控制发火	怎么控制不发火
观光车价格	香港观光车价格
上海明天有雨吗	上海有雨吗
长海医院怎么走	上海长海医院怎么走
京东白条怎么限制额度	京东白条怎么不限制额度
美国现在几点了	美国加州现在几点了
尿酮高是怎么回事	尿酮不高是怎么回事
北京明天有雨吗	北京有雨吗
买不起房子怎么办	买不起上海房子怎么办
吸烟的好处	不吸烟的好处
什么水果对肝好	什么水果对肝不好
sillage什么意思	silage什么意思
五点二十的计数单位是	十的计数单位是
怀女孩什么反应	怀女孩三个月什么反应
不绝什么四字成语	绝什么四字成语
不想吃甜的是怎么回事	想吃甜的是怎么回事
cad二千零一十四卸载干净	cad二千零一十四卸载不干净
宝宝发烧手脚烫	宝宝发烧手脚不烫
centur怎么读	centr怎么读
膝盖红肿疼痛怎么回事	膝盖红肿不疼痛怎么回事
尿液不臭不黄是什么原因	尿液臭不黄是什么原因
来大姨妈能测出怀孕吗	来大姨妈前两天能测出怀孕吗
吃头孢能喝酒吗	不吃头孢能喝酒吗
喉咙有痰咳嗽是什么原因	喉咙有痰不咳嗽是什么原因
做什么行业赚钱	将来做什么行业赚钱
二十一年一月一日是星期几	一月一日是星期几
令不什么什么成语	令什么什么成语
交强险可以过户吗	交强险可以不过户吗
intresting是什么意思	是什么意思
怎样会怀孕	怎样会不怀孕
proudofit是什么意思	是什么意思
距离台湾最近的岛屿	距离台湾最近的日本岛屿
笔记本怎么解密码	苹果笔记本怎么解密码
申通电话	无锡申通电话
手机进水了怎么办	oppo手机进水了怎么办
三d开奖什么号	昨天三d开奖什么号
大便干燥拉不出来怎么办	大便不干燥拉不出来怎么办
散的返义词	四散的返义词
宝宝发烧拉肚子	宝宝发烧不拉肚子
医科大学有二本吗	广西医科大学有二本吗
是什么意思	atteract是什么意思
一百七十八cm的明星	一百七十八的明星
美国的面积	美国华盛顿的面积
咳嗽喉咙有痰吃什么药	不咳嗽喉咙有痰吃什么药
youdabaddest是什么意思	dest是什么意思
买什么股票好	明天买什么股票好
马达上面的齿轮怎么弄下来	马达上面t的齿轮怎么弄下来
胡祗遹怎么读音	胡怎么读音
怀孕肚子上有一条线	没怀孕肚子上有一条线
胃疼拉肚子怎么回事	胃疼没拉肚子怎么回事
宫体肌层回声均匀是什么意思	宫体肌层回声不均匀是什么意思
副主席现任	中国副主席现任
宜川三村邮编	宜川邮编
怎样才能长胖	怎样才能长不胖
今天晚上的英文	晚上的英文
芙荃玫瑰花的折法	玫瑰花的折法
k七的型号名称介绍	k七x的型号名称介绍
电子科大考研复试占比	西安电子科大考研复试占比
stronger是什么意思	是什么意思
鬓角血管跳动疼	鬓角血管跳动不疼
世界上最厉害的武器是什么	世界上最不厉害的武器是什么
刷牙牙龈出血是什么原因	没刷牙牙龈出血是什么原因
微信零钱如何不显示金额	微信零钱如何显示金额
宝宝嗓子有痰怎么办	宝宝三个月嗓子有痰怎么办
宫外孕手术痛吗	宫外孕手术无痛吗
微信聊天记录怎么不显示日期	微信聊天记录怎么显示日期
把闹钟调到早上六点	把闹钟调到明天早上六点
我怎么说话	我怎么不说话
六合彩开盘了吗	香港六合彩开盘了吗
宝鸡区号	西安宝鸡区号
后天什么天气	明天后天什么天气
感冒打喷嚏怎么办	没感冒打喷嚏怎么办
英文名lin	英文名linux
一日英语怎么写	八月一日英语怎么写
酸奶结块还能喝吗	酸奶不结块还能喝吗
明天有没有下雪	有没有下雪
小孩哭声响亮	小孩哭声不响亮
空腹吃西红柿好吗	非空腹吃西红柿好吗
今天喝酒明天可以献血吗	今天星期三喝酒明天可以献血吗
同型半胱氨酸高	同型半胱氨酸不高
新兴领域的国家安全包括	新兴领域的国家安全不包括
上海师大附中有初中部吗	师大附中有初中部吗
同仁堂祛湿茶成分	北京同仁堂祛湿茶成分
每天掉多少头发算正常	每天掉多少头发算不正常
零点零二十五小时等多少分钟	五小时等多少分钟
怀孕多久胸会不疼	怀孕多久胸会疼
人为什么会胖	人为什么会不胖
烟台南山学院咋样	南山学院咋样
适合干洗的衣服	不适合干洗的衣服
手机没有	手机没有四
不自动连接音频是什么意思	自动连接音频是什么意思
imissyousomuch是什么意思	是什么意思
r十七多少钱	r十七cpu多少钱
临工二十装载机参数	山东临工二十装载机参数
拔罐痒是怎么回事	拔罐不痒是怎么回事
本田xrv型号	东风本田xrv型号
梦见被蛇咬	没梦见被蛇咬
笔记本电脑屏幕开不了	笔记本电脑屏幕开了
怀孕多久才想吐	怀孕多久才不想吐
售后电话	揭阳售后电话
不尽的意思是什么	尽的意思是什么
oppo手机怎样录屏	手机怎样录屏
yan字开头的歌词	yuan字开头的歌词
通讯公司有哪些	中国通讯公司有哪些
民政局星期六上班吗	方城民政局星期六上班吗
虾米音乐锁屏显示	虾米音乐锁屏不显示
颜值高的霸道总裁剧	颜值高的霸道总裁韩剧
正常白带是什么样的	不正常白带是什么样的
台湾是地区吗	台湾是东南亚地区吗
西安交大录取分数线	去年西安交大录取分数线
柯尼卡美能达客服	美能达客服
脂肪高的食物有哪些	脂肪不高的食物有哪些
他们去上学了吗英语	他们昨天去上学了吗英语
你不会玩捉迷藏吗	你们妹不会玩捉迷藏吗
tp是什么意思	trup是什么意思
我说的是vpn不是vip哦	我说的是vpn不是vp哦
感冒了怎么办	没感冒了怎么办
腊八蒜为什么变绿	腊八蒜为什么不变绿
南宁人少的公园	成都人少的公园
成都有清华吗	成都有西华大学吗
三月十六日是什么星座	三月一日是什么星座
我是不是真的有点烦人	我是不是真的很烦人
防灾科技学院在哪	安徽科技学院在哪
九和六最大的公因数是多少	九和十五最大的公因数是多少
嵩山北路属于哪个区	环城北路属于哪个区
河南管辖城市	陕西管辖城市
马里兰州的大学有哪些	中国的大学有哪些
广州到上海的	贵阳到上海的
一千除二十八等几	一千除一等几
湖北工业大学二千零一十九研究生录取名单	北工大二千零一十九研究生录取名单
七月三十日是什么星座	七月一日是什么星座
六百零九除六等	十二除六等
广西的文化习俗	青海的文化习俗
河南初中升高中升学率	广西初中升高中升学率
十九年沭阳房价	十九年重庆房价
现在中国有几大家族	近代中国有几大家族
成年人心率五十正常吗	成年人心率一百二十正常吗
江苏离青海有多远	江苏离山东有多远
九个月宝宝太胖怎么办	九个月宝宝不胖怎么办
北京交大好不好	北京联合大学好不好
姓闫的名人都有哪些	姓胡的名人都有哪些
停经三天能测出怀孕吗	停经六天能测出怀孕吗
江苏科技大学怎么样	华中科大怎么样
雷克萨斯二千零一十八新款车型	雷克萨斯二千零一十九新款车型
仙居县书记	凤翔县书记
泸州至重庆多少公里	哈尔滨至重庆多少公里
兔子可以一直关在笼子里吗	兔子可以不关在笼子里吗
北京农学院怎么样就业前景	北京印刷学院怎么样就业前景
海口至宜昌航班时刻表	海口至成都航班时刻表
周涛飞是谁	沈鸿飞是谁
云南艺术学院在江西招多少人	云南艺术学院在贵州招多少人
二级建造师教材十二年与十三年一样吗	二级建造师教材十二年与十四年一样吗
三沙市有多少机场	日本有多少机场
北京胡同的由来	灵境胡同的由来
商丘到延安有多少公里	商丘到哈尔滨有多少公里
小米十前置摄像头进灰	小米六前置摄像头进灰
西南交大二千零二十研究生分数线	西安交大二千零二十研究生分数线
沂水一中怎么样	沂南一中怎么样
五十三乘十七等多少	五十三乘一百等多少
蓝芩口服液可以饭前空腹喝吗	蓝芩口服液可以早上空腹喝吗
厦门到合肥航班	厦门到南宁航班
四十乘九	四十乘四十
柬埔寨飞福州需要隔离吗	柬埔寨飞昆明需要隔离吗
六岁儿童身高偏矮怎么办	四岁儿童身高偏矮怎么办
九十八年六月初五是什么星座	九十九年六月初五是什么星座
西安狗粮批发市场在哪里	南京狗粮批发市场在哪里
怀化学院在哪个区	绥化学院在哪个区
湖州师范学院二千零一十九分数线	杭州师范学院二千零一十九分数线
中行办卡年龄要求	工行办卡年龄要求
雷克萨斯ls怎么样	雷克萨斯lc怎么样
安徽属于哪个地区	河南属于哪个地区
八说的成语	四说的成语
长春到张掖多少公里	北京到张掖多少公里
南航就业方向	北航就业方向
乌鲁木齐至大庆航班	乌鲁木齐至厦门航班
大疆app闪退怎么办	华为app闪退怎么办
云南有几个机场	湖南有几个机场
高压一百三十低压九十正常吗	高压一百二十低压九十正常吗
西安到成都高铁票多钱	秦安到成都高铁票多钱
南理工录取分数线	武汉理工录取分数线
一百除零等多少	一百除十一等多少
五千三百写作什么	六千三百写作什么
一千一百五十的两种表达方式	三百五十的两种表达方式
打电话给老郭	打电话给郭
华西医学院院长	华西医院院长
科目二怎么预约	科目四怎么预约
张家港有名的律师事务所	三亚有名的律师事务所
郑州黄金回收多少钱联络zhuocui六十六	重庆黄金回收多少钱联络zhuocui六十六
河南科技大学是几本	河南农业大学是几本
总是头晕目眩怎么回事	偶尔头晕目眩怎么回事
广东是不是地震带	安徽是不是地震带
运城到广西飞机票	运城到新疆飞机票
什么工作最挣钱	什么工作不挣钱
小孩经常咳嗽	小孩偶尔咳嗽
梧州学院占地面积多少亩	九江学院占地面积多少亩
温州跑货拉拉怎么样	成都跑货拉拉怎么样
云南师范大学研究生补助	山东师范大学研究生补助
孕囊二十四乘十四是男是女	孕囊二十四乘十二是男是女
八百四十角等多少元	七角等多少元
十六加几等二十五	九加几等二十五
重庆有多大面积和人口	南京有多大面积和人口
中国四大钻探公司	中国五大钻探公司
心跳一百二十正常吗	心跳一百七十正常吗
我为什么不信基督教	我为什么不再信基督教
孟子的名言	高尔基的名言
十五万以内的七座车有哪些	十五万以内的六座车有哪些
天津体育学院教师待遇	天津医大教师待遇
西藏第二大城市	美国第二大城市
重庆有什么好吃的	石家庄有什么好吃的
哈尔滨师范大学黑龙江录取分数线	湖南师大黑龙江录取分数线
江西口罩出口白名单	陕西口罩出口白名单
南通etc人工客服电话	盐城etc人工客服电话
厦门旅游住哪里	西宁旅游住哪里
江苏占地面积是多少平方千米	澳门占地面积是多少平方千米
沈阳到天津快递要多久	大连到天津快递要多久
福州到哈尔滨特价机票	福州到天津特价机票
南京今天天气怎么样	济南今天天气怎么样
乌兰浩特到锡林郭勒多少公里	乌兰浩特到沈阳多少公里
成都到昆山多少公里	成都到上海多少公里
开封离郑州有多少公里	成都离郑州有多少公里
一到一百的英语序数词	一到十二的英语序数词
吉安到铜仁火车票	吉安到珠海火车票
西湖大学研究生好考吗	广西大学研究生好考吗
河北房价走势	淮北房价走势
鹰潭到横峰火车票	鹰潭到北京火车票
离章丘最近的火车站	离成都最近的火车站
三个月宝宝感冒鼻塞怎么办	六月宝宝感冒鼻塞怎么办
南宁到贵阳的动车时刻表	长沙到贵阳的动车时刻表
四十八和三十二最大公因数是	二十八和三十二最大公因数是
钱塘江有多长	曲江有多长
三除二	二除二
南师大难考吗	湖南师大难考吗
深圳和南京哪个大	上海和南京哪个大
湛江是不是一线城市	昆明是不是一线城市
吉林行政级别	晋江市行政级别
上周日是几号	惊蛰是几号
it's十二o'clock什么意思	it's五o'clock什么意思
一百天婴儿头围四十四	一百天婴儿头围三十四
oppoa五支持语音唤醒吗	oppoa十一支持语音唤醒吗
低压六十高压一百一十正常吗	低压六十高压一百二十正常吗
十一的的英文	十五的的英文
七除五十六	七除三
平顶山学院有多少人	三亚学院有多少人
fda是什么意思	fbi是什么意思
天津到成都的物流	西安到成都的物流
乌鲁木齐到圣彼得堡多少公里	乌鲁木齐到南昌多少公里
常州是哪个省	温州是哪个省
北京有什么好吃	香港有什么好吃
文化的三大特点	文化的七大特点
呼和浩特文玩市场在哪里	昆明文玩市场在哪里
哈工业大学排名	浙江工业大学排名
合肥十七年社保缴费基数	西安十七年社保缴费基数
二十四码等多少米	五码等多少米
湖南大学十六年分数线	湖南大学十七年分数线
一千元美金等多少人民币	十元美金等多少人民币
云南民族大学属于几本	云南农业大学属于几本
太原到吕梁的火车时刻表	太原到郑州的火车时刻表
祝儿子十六岁生日祝福语	祝儿子十七岁生日祝福语
阿拉斯加到俄罗斯	阿拉斯加到北京
北京到威尼斯机票	北京到芝加哥机票
北京地坛医院新址在哪	天坛医院新址在哪
九十一年五月十三日生的人是什么命	九十二年五月十三日生的人是什么命
三月廿九是什么意思	三月廿五是什么意思
月经推迟七天能测出怀孕吗	月经推迟五天能测出怀孕吗
关节总是疼	关节偶尔疼
四十二年生的人是什么生肖	四十三年生的人是什么生肖
邢台至长治火车站列车时刻表	济南至长治火车站列车时刻表
上海到沈阳的动车	呼和浩特到沈阳的动车
0两年阳历九月十一什么星座	0两年阳历九月初九什么星座
换手率超过四十说明什么	换手率超过二十说明什么
二十年江苏高考生有多少人	二十年湖南高考生有多少人
商朝是哪年	晋朝是哪年
大连大学啥时候开学	郑大啥时候开学
湖南到衡阳多少公里	湖南到岳阳多少公里
十三款天籁大灯灯泡型号	十四款天籁大灯灯泡型号
小灵儿的小说	小荷的小说
湖北大学二千零二十研究生分数线	湖南大学二千零二十研究生分数线
盐城中学几个校区	舒城中学几个校区
斐讯有什么产品	科大讯飞有什么产品
骆驼祥子第四章的人物形象	骆驼祥子第一章的人物形象
零点一乘十	零点三乘十
铁岭到乌鲁木齐火车票	上海到乌鲁木齐火车票
乌鲁木齐水上乐园开门了吗	石家庄水上乐园开门了吗
郑州到长沙的高铁	郑州到郑州的高铁
新生儿老是吐奶怎么回事	新生儿偶尔吐奶怎么回事
0两年阳历九月十一什么星座	0两年阳历今年九月什么星座
0一年农历十月十日是什么星座	0一年农历十月一日是什么星座
0六年俄罗斯车臣电影都有什么	七年俄罗斯车臣电影都有什么
三月二十三日是什么星座	三月九日是什么星座
四十四乘五十六的竖式	三十四乘五十六的竖式
招行江山支行电话	浙商银行江山支行电话
三月两日什么星座	三月九日什么星座
阜阳到首都机场的航班	阜阳到西安的航班
现代蔺姓名人	现代邹姓名人
s是什么意思	whatcanyoudo是什么意思
郑州轻工业学院好不好	郑州轻工业大学好不好
重庆下水管道堵了怎么疏通	郑州下水管道堵了怎么疏通
南昌批发雪糕的地方	许昌批发雪糕的地方
韶关日报社社长	新华日报社社长
哪里和中国时差一小时	哪里和中国时差八小时
南京林业大学开设专业	南京工业大学开设专业
邮政编码金华	邮政编码中国
上海海关学院的录取分数线	上海音乐学院的录取分数线
南阳至新乡高铁时刻表	南阳至北京高铁时刻表
锁屏时间调为三十秒	锁屏时间调为五分钟
第一个字是令的四字成语	第二个字是令的四字成语
零字有几种写法	贰字有几种写法
心率一百一十正常吗	心率一百四十正常吗
美国距离台湾多少公里	美国距离泰国多少公里
阳江到茂名开车要多久	阳江到广州开车要多久
r十七换内屏多少钱	r九换内屏多少钱
二十年四月十七日吉时	二十年四月六日吉时
八十二年十一月初九是几月几号	八十三年十一月初九是几月几号
今年阴历五月十六是几号	今年阴历五月十七是几号
昆明至西安	昆明至美国
二十八乘十五等	二十八乘十八等
美国现在几点了	美国晚上几点了
衡水中学是哪的	百度是哪的
上海停车多少钱一小时	上海中心停车多少钱一小时
三个月宝宝睡觉老是摇头怎么回事	三个月宝宝睡觉偶尔摇头怎么回事
山西到山东开车几个小时	北京到山东开车几个小时
丹阳市旅游景点有哪些	保山旅游景点有哪些
甘肃农业大学什么时候开学	湖南农业大学什么时候开学
二十年河北计算机考试时间	二十年贵州计算机考试时间
深圳和上海哪个经济更发达	深圳和香港哪个经济更发达
六分之一大于八分之一吗	六分之一大于三分之一吗
香港四级片有那些	香港一级片有那些
吃鸡灵敏度怎么调最稳苹果十一	吃鸡灵敏度怎么调最稳苹果八
定一个五点半的表	定一个五点的表
安徽师范大学全国排名二千零一十九	安徽财经大学全国排名二千零一十九
三加九	九加九
成都到贵阳北站	成都站到贵阳北站
柳州到兖州火车时刻表	商丘到兖州火车时刻表
四点五乘三百零二等多少	四点五乘十八等多少
四和十五的公因数有	四和七的公因数有
鼻子总是发酸	鼻子有点发酸
西湖公园开放了吗	莲花池公园开放了吗
燕山大学二千零一十九各专业录取分数线	东华大学二千零一十九各专业录取分数线
十九年全年考试安排	二十年全年考试安排
农历九十二年二月十五是属什么星座	农历九十二年二月二是属什么星座
宁波到庆阳多少公里	宁波到重庆多少公里
菏泽离深圳多少公里	菏泽离兰州多少公里
女人四十岁后需要补什么	女人五十岁后需要补什么
五十九是吉利数字吗	六是吉利数字吗
梅艳芳芳的夕阳之歌	梅艳芳的夕阳之歌
广西民族大学需要多少分	广西大学需要多少分
农历六月十四是几月几日	农历六月十六是几月几日
揭阳到昆明的机票	重庆到昆明的机票
怀孕三十八周胎动减少正常吗	怀孕二十八周胎动减少正常吗
今天适合洗车吗	明天适合洗车吗
二千零五是闰年还是平年	二千零一十三是闰年还是平年
二千零二十南阳最新开学时间	二千零二十香港最新开学时间
邵阳县有多少人口	桂阳县有多少人口
上外邮政编码	上海交大邮政编码
云南高考志愿填报时间	内蒙古高考志愿填报时间
菏泽到天水火车时刻表	深圳到天水火车时刻表
西华大学地址	西江大学地址
江苏疫情期间验车怎么办	山东疫情期间验车怎么办
长春有哪些县	合肥有哪些县
京东北京到西安	京东北京到北京
反贪局举报电话是多少	百度举报电话是多少
衡阳到西安飞机	衡阳到南昌飞机
广西大学二千零一十九复试名单	山西大学二千零一十九复试名单
洛阳师范学院专升本学费	玉林师范学院专升本学费
含九的成语有哪些	含一的成语有哪些
用短除法求十八和六的最小公倍数	用短除法求七和六的最小公倍数
三十美元等多少人民币	五美元等多少人民币
北方民族大学校歌	中国民航大学校歌
东兴证券怎么充值	广发证券怎么充值
五除十二乘六十	五除十二乘一
八岁小孩吃什么钙片好	六岁小孩吃什么钙片好
四川地名由来	山东地名由来
九百零六除四的竖式计算	九百零六除九的竖式计算
山东理工大学甘肃录取分数线	南理工甘肃录取分数线
郑州交通设施生产厂家	天津交通设施生产厂家
九十七年的今年多大了	九十八年的今年多大了
一千二百零四这个房号好吗	一千二百一十四这个房号好吗
孕妇尿碘小于五十	孕妇尿碘小于三十
打电话给林欣	打电话给陈萌
经常胸闷喘不上气	偶尔胸闷喘不上气
芝麻信用七百四十五什么水平	芝麻信用七百五十五什么水平
一公里多少分钟	三公里多少分钟
西北大学行政管理考研分数线	西北政法大学行政管理考研分数线
中信铜仁网点	中信广东网点
东营至济南距离	郑州至济南距离
江苏副主任医师考试时间	江西副主任医师考试时间
福州装什么宽带好	石家庄装什么宽带好
八拍子怎么打	五拍子怎么打
平顶山学院有多少人	毕节学院有多少人
苹果八系统无法更新	苹果十一系统无法更新
杭州到余姚的高铁	杭州东站到余姚的高铁
华农录取分数	中国农大录取分数
帮我设置五点半的闹钟	帮我设置四点半的闹钟
西华师大属于哪个区	陕西师大属于哪个区
上海有个什么小镇	深圳有个什么小镇
汕头到惠安有多少公里	汕头到东莞有多少公里
百字怎么写视频	五字怎么写视频
郑州到卫辉大巴	郑州到重庆大巴
郑州到柘城大巴时间和票价	郑州机场到柘城大巴时间和票价
防灾科技学院在哪	南昌科技学院在哪
十六年南宁中考人数	十六年广东中考人数
沧州职业技术学院好吗	永州职业技术学院好吗
四十天来一次月经正常吗	四十五天来一次月经正常吗
许昌市委书记	江油市市委书记
一万四千六百一十怎么算等二十四点	一万三千六百一十怎么算等二十四点
平壤属于哪里	中国属于哪里
新疆结婚年龄	江苏结婚年龄
当涂的邮政编码	杭州的邮政编码
湖南科技大学领导	太原科技大学领导
枣庄至日照高铁票价	枣庄至厦门高铁票价
虎丘邮政编码	苏州邮政编码
九和十八的最大公因数是几	十六和十八的最大公因数是几
山东合格考范围	湖北合格考范围
上海到内江火车时刻表	上海到南京火车时刻表
在韩国买手表便宜吗	在印度买手表便宜吗
陕西简称什么	宁夏简称什么
十三万零七百零三开头的身份证是哪里的	十三万零二百零三开头的身份证是哪里的
河南职工住院报销比例	河北职工住院报销比例
乔安娜的第一次妇科检查	乔安娜的第二次妇科检查
安徽疫情咨询电话	吉林疫情咨询电话
北师二十年考研分数线	河北师范大学二十年考研分数线
三门峡至太原火车时刻表	三门峡至石家庄火车时刻表
兰州到积石山	兰州到深圳
河南啤酒品牌	湖南啤酒品牌
第一字是二的成语	第一字是八的成语
胶州一中录取分数线二千零一十九	胶南一中录取分数线二千零一十九
洛阳二套房首付比例二千零一十九	乌鲁木齐二套房首付比例二千零一十九
十年上海人口数量	十一年上海人口数量
昆明好的初中排名	呼和浩特好的初中排名
海大什么专业最好	济南大学什么专业最好
梅州有什么好玩的地方吗	荆州有什么好玩的地方吗
六十一岁属啥	五十一岁属啥
宝鸡文理学院属于几本	西安文理学院属于几本
今天天气怎么样	明天天气怎么样
海大什么专业好	南昌大学什么专业好
合肥到恩施飞机	天津到恩施飞机
淮安到沧州汽车时刻表	淮安到济南汽车时刻表
四到七岁是什么阶段	三到七岁是什么阶段
仁化县属于哪个省	芦山县属于哪个省
十九年仁寿一中录取分数线	十九年寿县一中录取分数线
手机怎么拍出一百kb的照片	手机怎么拍出十kb的照片
汝箕沟到银川火车时刻表	长沙到银川火车时刻表
属狗水瓶座二十年运势	属狗水瓶座二十一年运势
石家庄到张家口火车票多少钱	石家庄到合肥火车票多少钱
临川一中什么时候开学二千零二十	临川二中什么时候开学二千零二十
四十五乘二	四十五乘四
贵阳到上海高铁票价	贵阳到杭州高铁票价
苹果五原装耳机多少钱	苹果七原装耳机多少钱
韶关学院专业分数线	肇庆学院专业分数线
漯河多大面积	汕头多大面积
最有意义的四个字	最有意义的一个字
喝了咖啡反而困	喝了咖啡很困
西安去苏州需要隔离吗	长沙去苏州需要隔离吗
大连鞍山路属于哪个街道	青岛鞍山路属于哪个街道
青海师范大学艺术生录取分数线	青海民族大学艺术生录取分数线
承德是哪个省的	沈阳是哪个省的
德邦快递一斤多少钱	德邦快递九斤多少钱
五年老鸭功效	三年老鸭功效
西北政法大学学生处电话	西北师大附中学生处电话
合肥公积金贷款最高能贷多少	洛阳公积金贷款最高能贷多少
圣杯三逆位对方看法	圣杯一逆位对方看法
大庆到绥化多少公里	大庆到深圳多少公里
北齐在哪里	冀北在哪里
沈阳到成都是否需要隔离	重庆到成都是否需要隔离
早上跑步的最佳时间	下午跑步的最佳时间
西安至三门峡	石家庄至三门峡
为什么沈阳是新一线城市	为什么西安是新一线城市
山西师范大学编号	山西财经大学编号
彭欣怡是谁	刘慈欣是谁
南昌小学什么时候报名	许昌小学什么时候报名
辽宁到浙江需要隔离吗	辽宁到广西需要隔离吗
江阴市市长是谁	高碑店市市长是谁
山大各省录取分数线	燕山大学各省录取分数线
洛阳到焦作多少公里	洛阳到哈尔滨多少公里
农历七月初三出生的人	农历十月初三出生的人
江岸区属于哪里	西山区属于哪里
月坛中学高考成绩	三台中学高考成绩
扬州人口二千零二十	广东人口二千零二十
天津膝盖核磁共振多少钱	乌鲁木齐膝盖核磁共振多少钱
为什么现在的人越来越离不开手机	为什么现在的人都离不开手机
六十乘六	六十乘十二
三个月断奶可以吗	六月断奶可以吗
四十一乘二	四十一乘八
六的九次方是多少	六的一百次方是多少
郑州个人档案存放在哪里	广州个人档案存放在哪里
山西师范大学是一本吗	山西大学是一本吗
新疆的特产有哪些水果	河北的特产有哪些水果
苹果六可以越狱吗	苹果八可以越狱吗
苹果八后玻璃碎了多少钱	苹果四后玻璃碎了多少钱
四除十七	四除十六
昆明到石屏高铁路线	昆明到西安高铁路线
辽宁师范大学历任校长	湖南师大历任校长
昆明到乐业汽车时刻表	南宁到乐业汽车时刻表
内眼角经常痒	内眼角有点痒
我是唱作人第二季第五期补位歌手	我是唱作人第二季第八期补位歌手
为什么第二个孩子聪明	为什么第三个孩子聪明
六除五等多少	六除十二等多少
防灾科技学院在哪	湖南科技学院在哪
怀孕一个月可以药流吗	怀孕七个月可以药流吗
血压一百三十除一百正常吗	血压一百六十除一百正常吗
十二年房价还会上涨吗	十三年房价还会上涨吗
毛囊炎太疼了	毛囊炎不疼了
河南卫视新台标	山西卫视新台标
小鸡宝宝考考你今天的答案是什么四月四日	小鸡宝宝考考你今天的答案是什么五月四日
二千零一十九黑龙江一本投档线	二千零一十九广东一本投档线
现在疫情能去天津吗	现在疫情能去昆明吗
重庆医科大学复试线二千零二十	南方医科大学复试线二千零二十
拉萨情侣约会的地方	合肥情侣约会的地方
广州高速开始收费了吗	广州高速路开始收费了吗
今天成都气温	今天北京气温
二十乘七等多少	二十乘二十等多少
八十七年婚配什么生肖	八十八年婚配什么生肖
重庆到沈阳机票	长沙到沈阳机票
本田摩托车尾箱怎么开	五羊本田摩托车尾箱怎么开
长江大学代码	江苏大学代码
淄博和济南哪个城市好	长沙和济南哪个城市好
张家口到福州	重庆到福州
姓麦的男孩名字大全	姓杨的男孩名字大全
工行两年定期存款利率	农行两年定期存款利率
西北农大研究生毕业要求	西工大研究生毕业要求
三百五十八人民币大写	三百四十八人民币大写
衡水到襄阳多少公里	安徽到襄阳多少公里
呼兰河传第四章句子赏析	呼兰河传第一章句子赏析
吃头孢后六小时我喝酒了	吃头孢后六分钟我喝酒了
十四和十三的最小公倍数	十五和十三的最小公倍数
五十二和十九的最大公因数	一和十九的最大公因数
七除四减三除八等几分之几	七除四减一除八等几分之几
重庆都有哪些好玩的地方	银川都有哪些好玩的地方
传祺gm八评测	传祺gs八评测
麻城到上海	麻城到新疆
深圳金洲花园房价	深圳金达花园房价
十四岁女生身高体重标准	十三岁女生身高体重标准
南京大学优秀专业	南开优秀专业
连平县领导	连城县领导
七十九年的今年多大了年龄了	八十年的今年多大了年龄了
cos二分之一	cos三分之一
浙大历年分数线	浙江工商大学历年分数线
东北的旅游景点有哪些	新加坡的旅游景点有哪些
十三万二千四百二十一开头的身份证是哪里的	十三万零五百二十一开头的身份证是哪里的
六百除八竖式计算	一除八竖式计算
聊城到沈阳	聊城到成都
申通从广州到湖南要多久	申通从广州到天津要多久
八十三年一百美元等多少人民币	八十四年一百美元等多少人民币
怀孕三个月可以做人流吗	怀孕一个月可以做人流吗
北京可以抽烟吗	北京公园可以抽烟吗
九龙坡区特产	日本特产
七十除五	七百除五
尼泊尔是那个国家	圭亚那是那个国家
康佳电视石家庄售后服务电话	康佳电视成都售后服务电话
堪培拉是哪里的	巴西利亚是哪里的
读什么什么有感十字	读什么什么有感四百字
北方工业大学研究生报录比	湖南工业大学研究生报录比
三月十三日是什么星座	三月一日是什么星座
二百一十三是什么意思	二百二十三是什么意思
windows八系统多少钱	windows七系统多少钱
关于元宵节的古诗三句	关于元宵节的古诗八句
二十六个月宝宝身高体重标准表	十三月宝宝身高体重标准表
青岛理工大学考研复试分数线	成都理工大学考研复试分数线
打电话给叶明	打电话给吴先生
男生网名霸气超拽高冷一个字	男生网名霸气超拽高冷四个字
安徽理工大学多大	太原理工多大
安徽理工大学多大	南理工多大
科目三考什么	科目二考什么
青海尼姑岛在哪	西宁在哪
二百五十乘三等多少	二百五十乘四十等多少
睡觉老是手麻	睡觉偶尔手麻
凯迪拉克at五报价	凯迪拉克xt五报价
七十一除两列竖式怎么列	九除两列竖式怎么列
苏州到河南邮费多少钱	广东到河南邮费多少钱
嘉兴到嘉善火车	嘉兴到深圳火车
大同公交卡充值地点	青岛公交卡充值地点
甘肃日报是国企吗	百度是国企吗
伊犁师范学院地址在哪里	齐鲁师范学院地址在哪里
起点四大精神病主角	起点三大精神病主角
笔记本三分钟就黑屏	笔记本一分钟就黑屏
八减三	八减四
三区一城是什么	四区一城是什么
十五楼蚊子能飞上来吗	十二楼蚊子能飞上来吗
绍兴的土特产有哪些	徐州的土特产有哪些
西安文科大学排名	西安文科生大学排名
湖北中医院擅长	江苏中医院擅长
濮阳的区号	洛阳的区号
北京至大连飞机	北京至巴黎飞机
打电话给赵总	打电话给阿文
外地人在上海能办身份证吗	外地人在广州能办身份证吗
山西师范大学是双一流吗	江西师范大学是双一流吗
太原理工湖北分数线	武汉理工湖北分数线
二十年山东退休养老金调整方案	二十年湖南退休养老金调整方案
湖北疫情解除了吗	浙江疫情解除了吗
郑州到济南飞机	郑州到厦门飞机
经常只睡五个小时会怎样	偶尔只睡五个小时会怎样
二千零一十九美术生高考分数线浙江	二千零一十九美术生高考分数线湖北
哈工业大学排名	湖北工业大学排名
云南属于南方还是北方	蒙古属于南方还是北方
二钱	八钱
血压九十除六十正常吗	血压一百二十除六十正常吗
汝阳县的历史	象山县的历史
山东历代名人	河北历代名人
尼斯湖到底有多大	中国到底有多大
从武汉到洪湖市多少公里	从武汉到上海多少公里
东北农大多少亩	北京农业大学多少亩
例假过六天能测出怀孕吗	例假过一天能测出怀孕吗
沈阳北站到凌源的火车时刻表	沈阳北站到西安的火车时刻表
四川行政编码	云南行政编码
抗甲状腺过氧化物酶抗体十	抗甲状腺过氧化物酶抗体一
苏州有啥水果	昆明有啥水果
邳州哪里招临时工	鄂州哪里招临时工
河北到威海多少公里	河北到天津多少公里
柳州好的初中	昆明好的初中
四个月宝宝拉肚子怎么办	九月宝宝拉肚子怎么办
二十年八月八号是黄道吉日吗	二十年八月一日是黄道吉日吗
包头防控中心电话	香港防控中心电话
东北一家人小伟当家是哪一集	东北一家人牛小伟当家是哪一集
二千零一十九各高校在河南录取分数线	二千零一十九各高校在浙江录取分数线
北京电视台台长级别	湖北电视台台长级别
二十五和十九的最小公倍数	二十五和八的最小公倍数
例假一天后可以洗澡吗	例假几天后可以洗澡吗
上海到沧州火车	菏泽到沧州火车
二十以内的分合	五以内的分合
内蒙古卫视主持人名单大全	湖南卫视主持人名单大全
五十二和十九的最大公因数	五十二和六的最大公因数
四分之三乘五	四分之三乘九
武汉最低生活标准	福州最低生活标准
西北政法大学和延安大学哪个好	西北政法大学和安大哪个好
王雨纯是谁	王欣雨是谁
这两天很困	这两天有点困
江苏卫视台长是谁	浙江卫视台长是谁
还有七分钟英语	还有五分钟英语
新加坡的第一位总统是谁	美国的第一位总统是谁
苹果x和xs对比	苹果x和xr对比
海门到南京多少公里	海门到贵阳多少公里
传祺gm八发动机怎么样	传祺gs八发动机怎么样
一千五百八十二年发生了什么	九十九年二月二十一日发生了什么
正月十五开什么花	腊月十五开什么花
新生儿总是吐奶怎么回事	新生儿偶尔吐奶怎么回事
一是偏旁吗	八是偏旁吗
三月二十六日什么星座	三月六日什么星座
南理工书记	成都理工大学书记
兰州牛肉拉面怎么做	兰州站牛肉拉面怎么做
鄂尔多斯名小吃	连云港名小吃
成都到安康多远	成都到广州多远
四除七除两等几分之几	六除七除两等几分之几
北京交大国内排名	北体大国内排名
给老邓打电话	给邓打电话
师范大学热门专业	华中师大热门专业
坪山新区房价	日本房价
四川各大高校排名	山西各大高校排名
李字怎样组词	李怎样组词
0九年交的社保什么时候可以领	十年交的社保什么时候可以领
几除五等几余数最大是几	几除四等几余数最大是几
二十和一百一十三的最大公因数	二十和八的最大公因数
南京工业大学是名校吗	南京林业大学是名校吗
荣昌区有多少人口	屯留区有多少人口
南充市是地级市还是县级市	陇南是地级市还是县级市
南航研究生拟录取名单	沈阳航空航天大学研究生拟录取名单
济南初中开学时间二千零二十	银川初中开学时间二千零二十
三亚有水果批发市场吗	齐齐哈尔有水果批发市场吗
哈工大税号	西安工业大学税号
历任民进中央主席	历任国务院主席
浦城到泉州有多少公里	深圳到泉州有多少公里
江西男生特点	澳门男生特点
八月六是什么星座	八月三十一是什么星座
七十二年农历八月十八日什么星座	七十二年农历八月十五什么星座
三十八乘五	三十八乘四
杨宇轩名字怎么样	杨振宇名字怎么样
华东交通大学啥时候开学	上海交大啥时候开学
甘肃离四川有多远	江苏离四川有多远
被减数是十二减数是四差	被减数是十二减数是八差
二百五十克等多少斤	一克等多少斤
锡山区属于什么街道	宝山区属于什么街道
许昌学院属于哪个区	潍坊学院属于哪个区
东京大学交换生项目	鲁东大学交换生项目
买车可以立刻上牌吗	买车可以不上牌吗
七月与八月中国有哪些节日	五月与八月中国有哪些节日
九十五年阳历十二月十二日是什么星座	九十六年阳历十二月十二日是什么星座
九百八十除五等多少	一除五等多少
怎么才能一天赚一千	怎么才能一天赚五百
a五的音效	a九的音效
南京到铜陵开车多久	南京到青岛开车多久
月经推迟了十天怎么回事	月经推迟了一天怎么回事
济南买猫去哪里买	福州买猫去哪里买
石家庄生日布置	广州生日布置
七十一年腊月十八是什么属像	七十二年腊月十八是什么属像
苹果五原装耳机多少钱	苹果十原装耳机多少钱
昌吉学院多大	九江学院多大
三月十日是什么星座	三月九日是什么星座
伊利股份股价	安源煤业股价
二千零一十九石家庄教师编制考试时间	二千零一十九湖南教师编制考试时间
一百五十八数字含义	三数字含义
未来流行什么衣服	现在流行什么衣服
二十年西工大研究生复试名单	二十年河南工业大学研究生复试名单
苹果八plus电量百分比怎么设置	苹果七plus电量百分比怎么设置
三峡在哪里	三峡水库在哪里
k五是否支持防抖	k七是否支持防抖
十一月二十五号是星期几	十一月二十八号是星期几
广州大学各科分数线	扬州大学各科分数线
八月份的猪命运如何	十一月份的猪命运如何
建行没开通网银怎么查余额	中行没开通网银怎么查余额
北理工待遇	厦门理工大学待遇
七十除八等多少	九除八等多少
空腹血糖七点二十五需要吃药吗	空腹血糖七点十九需要吃药吗
一万快手币是多少钱	九万快手币是多少钱
十一年十大流行语	十二年十大流行语
北京去桂林需要隔离吗	北京去榆林需要隔离吗
二十一用英语怎么说	三十一用英语怎么说
一号线什么时候开通	六号线什么时候开通
从泰安到菏泽多少公里	从郑州到菏泽多少公里
十九年三月二十六日星期几	三月九日星期几
三星和skt哪个厉害	三星和华为哪个厉害
西华师大的排名	陕西师大的排名
武汉到深圳飞机票多少钱	武汉到北京飞机票多少钱
成都到江苏车票多少钱	成都到广州车票多少钱
一百五十除三	一百五十除五
一百乘二十怎么列竖式	十二乘二十怎么列竖式
无限极网址是多少	百度网址是多少
为什么陕西没有美女	为什么江苏没有美女
驻马店到常州火车票	驻马店到盐城火车票
一千九百九十四旧历十月初九是什么星座	一千九百九十四旧历八月初九是什么星座
莆田市辖区有哪些	黄冈市辖区有哪些
机智的医生生活第三集乐队唱的歌	机智的医生生活第二集乐队唱的歌
广州美术学院二十年研究生复试分数线	中国美术学院二十年研究生复试分数线
农发行待遇怎么样	农行待遇怎么样
济宁特产	中国特产
浙大硕士研究生录取分数线	浙江工业大学硕士研究生录取分数线
现在武汉到合肥需要隔离吗	现在武汉到厦门需要隔离吗
青岛科技大学复试线	湖南科技大学复试线
孕妇尿检白细胞一百二十	孕妇尿检白细胞九十
四和十的最小公倍数	三和十的最小公倍数
五十五乘五十五	五十五乘二
扬州女人的特点	桂林女人的特点
步步高的手机怎么样	华为的手机怎么样
打电话给幺三	打电话给老君
三千除六百等多少	一百除六百等多少
0八年谁是国家主席	九年谁是国家主席
武汉哪有站街	广州哪有站街
high吗	nice吗
江油市行政区划	延安行政区划
徐康俊在韩国红吗	徐若瑄在韩国红吗
广西大学有分校吗	西北大学有分校吗
江西到吉林快递多少钱	江西到云南快递多少钱
三月八是什么日子	三月十四是什么日子
吉首大学多久开学	沈阳大学多久开学
石家庄旅游线路	成都旅游线路
石狮到青岛物流	天津到青岛物流
十二的英语序数词怎么写	五的英语序数词怎么写
今天西安下雪了吗	今天哈尔滨下雪了吗
演讲一分钟大概多少字	演讲七分钟大概多少字
stinty怎么读	stroy怎么读
罗田县殡仪馆电话	上海殡仪馆电话
北大复试时间	北科大复试时间
香港坐船到广州	香港机场坐船到广州
大连医科大学学费	南方医科大学学费
七十年女明星	七十一年女明星
七十五乘一百零二	七十五乘十
长沙到宣城的火车时刻表	长沙到福州的火车时刻表
重庆到上海距离	台北到上海距离
陕西师大十九年硕士研究生录取名单	西北师范大学十九年硕士研究生录取名单
苏州到上海的动车	苏州到广州的动车
宝宝只喝奶不吃辅食怎么办	宝宝不喝奶不吃辅食怎么办
临沂到聊城的汽车	临沂到上海的汽车
零点零八乘零点两	零点一乘零点两
hpv十八阳性有什么症状	hpv十一阳性有什么症状
十四年网游小说排行榜前一百位	十五年网游小说排行榜前一百位
一月一日是星期几	十一月十一日是星期几
义乌到龙港汽车	义乌到沈阳汽车
四川的功效	山东的功效
刘姓女宝宝起名	谢姓女宝宝起名
brier是什么意思中文	carrier是什么意思中文
八月十九日是什么星座	十一月十九日是什么星座
德国的首都是哪里	法国的首都是哪里
贵州师范学院多大	周口师范学院多大
阿拉尔市属于哪个省	阿尔山市属于哪个省
赵高是怎么死的	高虎是怎么死的
楚雄到景谷	楚雄到北京
昆明到高安火车时刻表	昆明到北京火车时刻表
古代谁画的竹子最好	近代谁画的竹子最好
十二月九日是什么星座	三月九日是什么星座
中国电影学院院长	北京电影学院院长
广西省总共有多少人口	河南总共有多少人口
南通在哪个省	通化在哪个省
邵东到都匀高铁时刻表	邵东到南昌高铁时刻表
孕妇肚子微微疼	孕妇肚子一直疼
桐乡到常州	上海到常州
江西财经大学编号	广东财经大学编号
数字一百五十三是什么意思	数字七是什么意思
萍乡是哪个省	台湾是哪个省
上海飞韩国机票价格	上海飞台湾机票价格
十四乘六	十四乘十四
六除八化成带分数	三除八化成带分数
南阳到拉萨飞机票多少钱	昆明到拉萨飞机票多少钱
七十五年七月二十七日晚上十一点多出生的人是什么命	七十六年七月二十七日晚上十一点多出生的人是什么命
北京到金华顺丰多少钱	北京到南京顺丰多少钱
呼吸比较困难怎么回事	呼吸越来越困难怎么回事
石家庄到乐陵多少公里	郑州到乐陵多少公里
广东工业大学二本分数线	河工大二本分数线
农行信用卡未通过	建行信用卡未通过
湖南理工学院校长什么级别	洛阳理工学院校长什么级别
三除什么	六除什么
色膏零除四十三是什么颜色	色膏八除四十三是什么颜色
登封自助餐哪家好	上海自助餐哪家好
一百七十七身高体重多少正常	一百七十四身高体重多少正常
二百乘四	八百乘四
西安科技大学是省重点吗	湖南科技大学是省重点吗
正月我想搬家可以吗	腊月我想搬家可以吗
北邮二千零一十九浙江录取分数线	北大二千零一十九浙江录取分数线
十四岁打生长激素	十三岁打生长激素
肚脐右边一直痛	肚脐右边有点痛
重庆是中国第一大城市吗	北京是中国第一大城市吗
加拿大和瑞士哪个好	加拿大和比利时哪个好
五百五十乘三十	零乘三十
老是干呕想吐是怎么回事	偶尔干呕想吐是怎么回事
五点二除二	五点五除二
内蒙古工业大学保研名单	北方工业大学保研名单
武宁县有多少人口	兴宁县有多少人口
西安高铁站有吸烟室吗	南京高铁站有吸烟室吗
今天是几号	立冬是几号
云南的	宁夏的
0九年腊月初九是几号	0九年五月初九是几号
吉安到南昌	吉安到杭州
十一月二十号是星期几	现在是星期几
济南到兰州航班	济南到武汉航班
金门大学分数线	开封大学分数线
八个月的宝宝吃什么辅食	七月的宝宝吃什么辅食
阴历七月二十二是什么星座	阴历七月七是什么星座
陈汉三是谁	汉三是谁
山东高考体检费用	江苏高考体检费用
长葛到济源多少公里	长葛到福州多少公里
银川到荣成火车	天津到荣成火车
北京卫视节目表今天播	深圳卫视节目表今天播
十九年仁寿一中录取分数线	十九年莘县一中录取分数线
湖南大学入学分数线	河南大学入学分数线
a五上市时间	a七十二上市时间
操场的面积大约是一万二千	操场的面积大约是五千
纸巾一百一十抽是多少张	纸巾一百二十抽是多少张
江西那个地方离广东最近	江西那个地方离福建最近
怀孕一个月可以打胎么	怀孕九个月可以打胎么
成都到乐山高铁	石家庄到乐山高铁
云南特色小镇	黑龙江特色小镇
常熟市生孩子哪个医院好	福州生孩子哪个医院好
中国抗疫实践带给世界的思考之三	中国抗疫实践带给世界的思考之四
小米八有没有红外线功能	小米六有没有红外线功能
无锡到南昌动车	无锡到济南动车
兰州吉他谱	乌鲁木齐吉他谱
高压一百三十低压九十正常吗	高压五十低压九十正常吗
成都可以带走的土特产	西安可以带走的土特产
河南单招二千零二十时间	湖南单招二千零二十时间
工行社会招聘条件	农行社会招聘条件
农发行待遇怎么样	广发待遇怎么样
澳洲南部有哪些城市	中国南部有哪些城市
农安县比较好的酒店	上海比较好的酒店
长春动物园门票多少钱	抚顺动物园门票多少钱
十三的二进制数	九的二进制数
厦门到深圳动车	厦门到南充动车
一米五十五多少斤算瘦	一米五十八多少斤算瘦
浙江哪里人最多	宁波哪里人最多
泰梨院男主角发型	梨泰院男主角发型
六十一的数字代表什么	三十一的数字代表什么
二百七十除五	二百七十除六
大乐透六加两中零加两多少钱奖金	大乐透六加两中三加两多少钱奖金
高压一百三十低压九十正常吗	高压一百三十低压一百正常吗
0九年拉菲多少钱一瓶	十年拉菲多少钱一瓶
九十八年六月初五是什么星座	九十九年六月初五是什么星座
一百六十除三十	一百六十除二十
山西中医学院录取分数线二千零一十九	山西中北大学录取分数线二千零一十九
太原到吕梁的火车时刻表	银川到吕梁的火车时刻表
白细胞十是什么意思	白细胞零是什么意思
两尺四是多少码的裤子	两尺三是多少码的裤子
乌鲁木齐和东北哪个冷	乌鲁木齐和哈尔滨哪个冷
石家庄著名律师	贵阳著名律师
五十二和十九的最大公因数	五十二和十三的最大公因数
四十除六十等多少	四十除零等多少
沈阳大学是几本	沈阳建筑大学是几本
晋江到临海动车时刻表	晋江到昆明动车时刻表
三百除四十等多少	三百除五等多少
鄂尔多斯到扎兰屯多少公里	鄂尔多斯到福州多少公里
离上海近的旅游景点	离杭州近的旅游景点
钢铁是怎样炼成的第五章好词好句	钢铁是怎样炼成的第四章好词好句
莘松八村房价	莘松路房价
呼和浩特到济南多少公里	呼和浩特到成都多少公里
沈阳工程学院二千零一十七录取分数线	福建工程学院二千零一十七录取分数线
十二年成人高考时间	十三年成人高考时间
三星和小米哪个好	华为和小米哪个好
两个月宝宝喉咙有痰怎么办	六月宝宝喉咙有痰怎么办
上海海关周末上班吗	上海联通周末上班吗
黑龙江临近的城市	海南临近的城市
胎压六十八还能开吗	胎压一百还能开吗
郑州到卫辉大巴	郑州到大连大巴
福州知名酒吧	成都知名酒吧
徐工集团董事长	临工集团董事长
中信周六周日上班吗	中行周六周日上班吗
两月二十六号是农历多少	二月二是农历多少
成都三月二手房成交量	南京三月二手房成交量
山东几个市	江西几个市
十二和三十五最大公因数	十二和三十二最大公因数
七十一年属什么生肖属相	七十二年属什么生肖属相
西安工程大学是本科吗	海军工程大学是本科吗
中国平安成立于哪一年	平安人寿成立于哪一年
西海岸自贸区范围	西海岸新区自贸区范围
七与两的和	五与两的和
南平属于地级市吗	上海属于地级市吗
八十一除九	八十一除二
内蒙古师范大学十九年录取分数线	湖南师大十九年录取分数线
餐后两小时血糖正常值	餐后三小时血糖正常值
当代建筑的特点	唐代建筑的特点
广东墓地多少钱	中山墓地多少钱
丹阳到深圳火车时刻表	丹阳到郑州火车时刻表
济南到溧阳高铁时刻表查询	济南到南昌高铁时刻表查询
云南艺术学院是本科吗	山东艺术学院是本科吗
西北政法大学是不是九百八十五	西工大是不是九百八十五
南京医科大学读研怎么样	宁夏医科大学读研怎么样
仪征市的邮政编码	冀州市的邮政编码
苏州属于哪个省	克州属于哪个省
八乘十吧	十五乘十吧
青岛理工大学什么专业好	山东理工大学什么专业好
北京的总人口	哈尔滨的总人口
安阳有那些县	拉萨有那些县
一百乘三十二怎么列竖式	十二乘三十二怎么列竖式
晋城到长治多少公里	晋城到南昌多少公里
遵义医学院好吗	泸州医学院好吗
西安至衡阳多少公里	西安至长沙多少公里
朝阳的区号	通州的区号
揭阳属于哪个省份	浏阳市属于哪个省份
郑州火车站到北京西站火车票	郑州火车站到西安火车站火车票
防灾科技学院在哪	河南科技学院在哪
合肥学院一本专业	台州学院一本专业
太原理工十九年录取分数线是多少	北理工十九年录取分数线是多少
上海怎么走	上海机场怎么走
十除六	十除十
今天是农历几月几号了	今天是农历五月几号了
佛山到太原火车	温州到太原火车
九十三年七月初八是什么命	九十三年十月初八是什么命
成语五开头	成语六开头
九的大写数字怎么写	八的大写数字怎么写
邵阳到广西	邵阳到长沙
一千零一十一怎么写	一千零一十二怎么写
天津至深圳多少公里	福州至深圳多少公里
上外研究生初试分数线	西安外国语大学研究生初试分数线
青岛到济南快递多少钱	青岛到南京快递多少钱
cos二分之一	cos五分之一
八十二年十一点十九是什么星座	八十三年十一点十九是什么星座
银行卡已过期	银行卡即将过期
六的占格怎么写	九的占格怎么写
一减七除十二等几	一减十除十二等几
霸气的四个字	霸气的六个字
西安到赣州高铁	西安到长沙高铁
下午怎么打招呼	午夜怎么打招呼
西华师大属于哪个区	华南师大属于哪个区
四川有多少人口	浙江有多少人口
广东哪里有新冠病毒	浙江哪里有新冠病毒
西安纸箱厂家	拉萨纸箱厂家
九十三年三月二十六阴历	九十三年三月二十阴历
媒体音量调到百分之三十	媒体音量调到百分之六十
南京工业大学导师怎么选	南京师大导师怎么选
东风本田urv多少钱	东风本田xrv多少钱
花都最好的口腔医院	上海最好的口腔医院
济南至枣庄西火车时刻表	天津至枣庄西火车时刻表
短发欧美女歌手	短发韩国女歌手
八十八除九	八十八除四
南京五塘新村房价	南京南京房价
九江十七路公交车路线	北京十七路公交车路线
南京财经大学在哪里	山东财经大学在哪里
黄明昊今年多少岁	黄晓明今年多少岁
广州在那里	合肥在那里
十一月十八是什么节日	十一月十七是什么节日
南京到青岛的飞机时刻表	上海到青岛的飞机时刻表
北京卫视节目表今天播	辽宁卫视节目表今天播
广西省总共有多少人口	江西总共有多少人口
七十二乘三点十四等多少	一乘三点十四等多少
距离十二月二十六号还有多少天	距离十二月三十一号还有多少天
海南自贸区在哪里	陕西自贸区在哪里
牙齿经常出血是怎么回事	牙齿偶尔出血是怎么回事
从北京到承德的火车	从北京到佳木斯的火车
五年级下册语文第一课近义词反义词多音字	五年级下册语文第三课近义词反义词多音字
高压一百五十低压一百严重吗	高压一百六十低压一百严重吗
六岁生日的意义	七岁生日的意义
芒果树在浙江能种植吗	芒果树在河南能种植吗
月经后一天会怀孕吗	月经后二天会怀孕吗
女生网名四字可爱	女生网名五字可爱
十七年河北gdp总值	十八年河北gdp总值
农行不良率	建行不良率
三百七十乘四十的竖式	四乘四十的竖式
还有多久到二十一年	还有多久到春节
四价hpv疫苗可以管多久	九价hpv疫苗可以管多久
呼市三路公交车路线	呼市四路公交车路线
二十年北方民族大学什么时候开学	二十年中国民航大学什么时候开学
五十二和十九的最大公因数	六和十九的最大公因数
双色球六加一多少钱	双色球五加一多少钱
西华师大二千零二十复试线	华师大二千零二十复试线
南昌的天气如何	香港的天气如何
三字老写怎么写	一字老写怎么写
湖南大学大概什么时候开学	河南大学大概什么时候开学
刘伯承是谁	刘承俊是谁
湖北工业大学二千零一十九研究生录取名单	西安工业大学二千零一十九研究生录取名单
宜昌到内蒙古多少公里	宜昌到南京多少公里
沛县科目一考场在哪里	沛县科目二考场在哪里
大写的四怎么写	大写的七怎么写
湖北有什么特产	宁夏有什么特产
九万一千五百三十的最小公倍数	六万一千五百三十的最小公倍数
天津到秦皇岛的火车时刻表	天津到济南的火车时刻表
哈尔滨到广东距离	哈尔滨到浙江距离
亚洲与北美洲的分界线是	亚洲与美洲的分界线是
昆明距离深圳多少公里	长沙距离深圳多少公里
七月十四是什么节日	七月七是什么节日
生肖三合是什么意思	生肖五合是什么意思
关于李隆基的电视剧有哪些	关于唐玄宗的电视剧有哪些
坐月子第二天可以吃什么水果	坐月子第一天可以吃什么水果
山东二建及格线	湖南二建及格线
周口到贵阳的高铁	昆明到贵阳的高铁
什么样的运动最伤膝盖	什么样的运动不伤膝盖
三乘八百等多少	三乘十一等多少
十九年四川有多少高考生	十九年陕西有多少高考生
七十三年有没有发生过什么重大事件	七十四年有没有发生过什么重大事件
长春有哪些公司	哈尔滨有哪些公司
开封有名的律师事务所	太原有名的律师事务所
青岛到汉中火车时刻表	青岛到济南火车时刻表
零点二四除三	零点二四除四
三点六乘三	三点六乘六
一米十二等多少英寸	一米三等多少英寸
宁夏特岗报名费多少	内蒙古特岗报名费多少
幽门螺旋杆菌阳性数值四百八十五	幽门螺旋杆菌阳性数值四百八十四
高压一百三十低压八十正常吗	高压一百八十低压八十正常吗
孕妇餐后一小时血糖正常值	孕妇餐后四小时血糖正常值
西南交大属于二百一十一还是九百八十五	西安交大属于二百一十一还是九百八十五
西南交大校长级别	西安交大校长级别
西安理工大学研究生分数线二千零一十九	南理工研究生分数线二千零一十九
青岛到乳山大巴时刻表	青岛机场到乳山大巴时刻表
中国人为什么不喜欢四	中国人为什么不喜欢七
九十除七	九十除九
合肥到霍山有多远	合肥到苏州有多远
沈阳到北京高铁多长时间	沈阳到哈尔滨高铁多长时间
百色哪里好逛街	北京哪里好逛街
忻州到朔州多少公里	忻州到亳州多少公里
南通到沈阳多远	南通到常熟多远
十九年春晚主持人	二十年春晚主持人
八下英语unit三重点短语	八下英语unit八重点短语
赣州到揭阳的火车时刻表	南昌到揭阳的火车时刻表
南京哪里的房子值得买	西安哪里的房子值得买
三天不排便怎么办	九天不排便怎么办
十二和二十五最小公倍数是多少	十二和八最小公倍数是多少
九龙仓怎么样	百度怎么样
武汉体育学院有几个校区	首都体育学院有几个校区
秦皇岛碧桂园首府房价	涪陵碧桂园首府房价
农历三月十八日是什么日子	农历三月九日是什么日子
沈阳音乐学院难考吗	西安音乐学院难考吗
百白破为什么要打三针	百白破为什么要打四针
中国离土耳其最近的城市	中国离欧洲最近的城市
林小庄为什么黑化	小庄为什么黑化
重庆至浙江有多少公里	重庆至武汉有多少公里
八和十五的公倍数有哪些	十二和十五的公倍数有哪些
北京交大0七年录取分数线	北大0七年录取分数线
乌市夜景最美的地方	日本夜景最美的地方
撒哈拉气候特点	日本气候特点
二十八乘一百	二十八乘二十二
二除三	二除二
三点一四乘八	三点一四乘六
二十五bar等多少兆帕	三bar等多少兆帕
八十六年阳历十一月二十六日是什么星座	八十七年阳历十一月二十六日是什么星座
六十七年阴历腊月二十三是几号	六十七年阴历十月二十三是几号
怀孕三十周小肚子隐隐作痛	怀孕三十六周小肚子隐隐作痛
长垣县有多少个村	中国有多少个村
泉州师范学院是一本吗	周口师范学院是一本吗
西咸新区邮编多少	中国邮编多少
属牛的二十年全年运势	属牛的二十一年全年运势
0两年十一月召开的党的什么	0两年一月召开的党的什么
大连轮渡到烟台时刻表	大连轮渡到天津时刻表
上海到杭州大巴车	上海到苏州大巴车
十二月二十七生日的明星	十二月十一生日的明星
旧金山有几座大桥	中国有几座大桥
一百乘二百	二百乘二百
西游记第一回的内容提纲	西游记第六回的内容提纲
南京邮电大学和北邮哪个好	南京邮电大学和重庆邮电大学哪个好
重庆银保监投诉电话	成都银保监投诉电话
柯桥到龙游汽车时刻表	上海到龙游汽车时刻表
青龙寺电话	青龙古镇电话
湖南大专学校分数线	江苏大专学校分数线
九十除七	九十除六十
长沙理工博士点	西安理工博士点
郑州到瑞丽飞机票	郑州到厦门飞机票
昆山到泰安的火车票	厦门到泰安的火车票
四十五乘三	四十五乘二
西安书画市场在哪里	乌鲁木齐书画市场在哪里
七乘九	九乘九
十年到现在多大了	十一年到现在多大了
华泰证券是上市公司吗	中信证券是上市公司吗
西宁二手车落户政策	长沙二手车落户政策
三天大便一次正常吗	五天大便一次正常吗
十八万左右口碑最好的suv	十五万左右口碑最好的suv
成都地铁三号线怎么转四号线	西安地铁三号线怎么转四号线
北京到柴沟堡火车时刻表	北京到福州火车时刻表
漯河到衡阳的火车票	漯河到沧州的火车票
为什么在四十九年十月一日开国大典的礼炮有二十八响还是五十四们齐发的	为什么在五十年十月一日开国大典的礼炮有二十八响还是五十四们齐发的
贵州公证处公证费用	江苏公证处公证费用
徐州到成都的飞机票	威海到成都的飞机票
中国有多少人	韩国有多少人
辽宁离贵州多远	江苏离贵州多远
八十二年农历四月四日是什么星座	八十二年农历五月四日是什么星座
中国现处于什么阶段	中国初期处于什么阶段
几的立方是三十六	几的立方是四
上海最好的宾馆	汾阳最好的宾馆
张子枫多大	叶子楣多大
济南耳科哪个医院好	长沙耳科哪个医院好
胎心一百四十六正常吗	胎心一百三十六正常吗
出马出道基本知识十八	出马出道基本知识十九
舟山是哪个省的	秦山是哪个省的
香港高考时间	成都高考时间
长沙最大的水果批发市场在哪里	洛阳最大的水果批发市场在哪里
嘉兴到淮南的火车时刻表	嘉兴到南昌的火车时刻表
一千左右的手机那款好	二千左右的手机那款好
温州大学各专业分数线	兰大各专业分数线
分一声组词	分四声组词
苏州和深圳哪个大	上海和深圳哪个大
石家庄哪个医院去痣好	济南哪个医院去痣好
孕二十六周两天是几个月	孕二十四周两天是几个月
沈阳理工大学男女比例	沈阳工业大学男女比例
莎菲宝的老公是谁	王莎莎的老公是谁
北大招生分数线	华东师大招生分数线
武汉科技大学中外合作学费	青岛科技大学中外合作学费
月经第七天还有褐色血	月经第八天还有褐色血
高压一百五十低压一百严重吗	高压一百三十低压一百严重吗
山西大学排名全国第几位	西北大学排名全国第几位
重庆到上海距离	重庆到北京距离
信阳到襄阳多远	信阳到合肥多远
河北现在可以外出吗	中国现在可以外出吗
湘潭到长沙的拼车	湘潭到长沙机场的拼车
鞍钢集团什么级别	首钢集团什么级别
苹果七怎么操作	苹果八怎么操作
设置一个十五分钟的闹钟	设置十五分钟的闹钟
淮坊到盘锦多少公里	淮坊到成都多少公里
尤溪一中分数线二千零一十九	广饶一中分数线二千零一十九
八分之一的导数	七分之一的导数
河南城建学院在哪里	河南大学民生学院在哪里
潍坊到临朐物流	潍坊到成都物流
oppia十一x是一体屏还是分屏	oppoa十一x是一体屏还是分屏
三百乘六	六百乘六
十年网游小说排行榜	十一年网游小说排行榜
镇江到上海火车时刻表	武汉到上海火车时刻表
北京到威海大巴	北京到焦作大巴
河北城市名称大全	山西城市名称大全
二百四十除三的竖式计算怎么写	二百四十除五的竖式计算怎么写
scary怎么读	scale怎么读
长春二手车交易市场电话	武汉二手车交易市场电话
四分米用小数表示是多少米	七分米用小数表示是多少米
北海离越南多远	北海离杭州多远
宜昌医保报销比例	林州市医保报销比例
八十五年谷雨是几月几号	八十六年谷雨是几月几号
开心消消乐隐藏关二百六十怎么过	开心消消乐隐藏关三怎么过
二十年幼儿园啥时候开学宁夏	二十年幼儿园啥时候开学江苏
四百四十六除两的竖式怎么写	五百四十六除两的竖式怎么写
浙江工业大学和沈阳工业大学哪个好	北方工业大学和沈阳工业大学哪个好
第三位皇帝是谁	第一位皇帝是谁
吃头孢后六小时我喝酒了	吃头孢后七小时我喝酒了
广州属于什么气候区	日本属于什么气候区
北大美食	清华美食
可乐放了两天还能喝吗	可乐放了七天还能喝吗
中央戏剧学院位于	中央美术学院位于
二里面有几个一除六	五里面有几个一除六
深圳办外地身份证需要什么	苏州办外地身份证需要什么
郑州图书批发市场在哪	合肥图书批发市场在哪
兰州的面积	长沙的面积
两月份经济运行情况	四月份经济运行情况
七十四年属虎人二十年运势运程	七十四年属虎人二十一年运势运程
十二月二十七生日的明星	十二月九生日的明星
零除九等多少	零除十等多少
陈赫是哪里人	赫敏是哪里人
六十三除九	六十三除二
河南人口多少人	安徽人口多少人
距离七月二号还有几天	距离七月十五还有几天
第一代计算机所采用的电子器件是	第二代计算机所采用的电子器件是
欢乐喜剧人第二季第四期排名	欢乐喜剧人第二季第七期排名
十月十六日是什么星座	十月一日是什么星座
张家港到泰州多少公里	张家港到苏州多少公里
江西医保咨询电话	江苏医保咨询电话
十六乘一千二百五十	十六乘六
江西农业大学不开学	东北农大不开学
外地人回山东需要什么证明	外地人回湖北需要什么证明
多少的平方等一百	多少的平方等十
商丘师范学院院长级别	曲靖师范学院院长级别
七乘几等二十	五乘几等二十
内蒙青瓦生产厂家	江西青瓦生产厂家
小孩子晚上哭闹是怎么回事	小孩子早上哭闹是怎么回事
二十五乘五	二十五乘四
北大在河南录取分数线	上海交大在河南录取分数线
十九年稳岗补贴政策西安	二十年稳岗补贴政策西安
总是发烧怎么回事	偶尔发烧怎么回事
五月份会议主持词	六月份会议主持词
双色球七加三中零加一多少钱	双色球七加三中五加一多少钱
滁州学院更名大学	惠州学院更名大学
重庆的名胜古迹有哪些	新加坡的名胜古迹有哪些
三月一是什么星座	三月五是什么星座
闹钟调到十二点五十	闹钟调到十二点半
七除一千的最简分数	六百二十除一千的最简分数
北大在校生人数	北京交大在校生人数
福州比较好的小区	西安比较好的小区
八月二十一是什么星座	八月二十四是什么星座
覃的多音字	罗的多音字
五月二十六日出生的足球运动员	五月四日出生的足球运动员
三字母英文	五字母英文
齐齐哈尔大学世界排名	美国耶鲁大学世界排名
柠檬郡地址	澜湖郡地址
一分米等几厘米等几毫米	四分米等几厘米等几毫米
九十三年正月二十六是阳历多少	九十三年腊月二十六是阳历多少
吃头孢后六小时我喝酒了	吃头孢后二十四小时我喝酒了
中国分为几个地区	韩国分为几个地区
常州有什么好玩的地方吗	杭州有什么好玩的地方吗
六百零三除六约	六百零二除六约
九岁儿童的标准身高体重	六岁儿童的标准身高体重
甘肃有什么文化	山东有什么文化
中国古代最早精通物理学的是谁	中国古代最精通物理学的是谁
珠江在哪	珠江新城在哪
江西离天津远吗	湖北离天津远吗
国土资源局内设机构	国家税务局内设机构
北邮附近酒店	北京农业大学附近酒店
太和医院呼吸内科主任	同仁医院呼吸内科主任
太原有多少个县	哈尔滨有多少个县
临沂有火车站吗	汕头有火车站吗
五个月孩子发烧三十八度怎么办	六月孩子发烧三十八度怎么办
自然流产第一天可以喝红糖水吗	自然流产第三天可以喝红糖水吗
四字歌名疯狂猜歌	五字歌名疯狂猜歌
二千零一十九整木定制十大名牌	二千零一十八整木定制十大名牌
济南回民中学升学率	济南育秀中学升学率
四十三的比值	四十二的比值
五十乘五十	四乘五十
莲花山公园开放时间	南海子公园开放时间
一繁体字是什么样的	五繁体字是什么样的
南阳电视台台标	衡阳电视台台标
九百九十九是什么位数	八是什么位数
北师二十年考研分数线	北理工二十年考研分数线
昆明到南昌有多少公里	昆明到广州有多少公里
六岁男孩体重四十五斤正常吗	四岁男孩体重四十五斤正常吗
昆明理工大学算几本	西安理工大学算几本
西安到安顺物流专线	西安到兰州物流专线
深圳马峦山怎么去	深圳马峦山瀑布怎么去
十九岁的英语怎么写	十七岁的英语怎么写
长安福特哪里生产的	福特汽车哪里生产的
三万多块钱	三百多块钱
年的来历八十字	年的来历二十字
北大招生分数线	北师大招生分数线
中国一重股价	中国平安股价
太原有多少个县	日本有多少个县
怀孕三天能不能测出来	怀孕一周能不能测出来
南京装修时间	天津装修时间
浙江高职学校排名	广东高职学校排名
第三节的英语	第五节的英语
体检前一天注意事项	体检一周前注意事项
香港中文大学校址在哪里	沈阳大学校址在哪里
九位数皇冠qq号多少钱	八位数皇冠qq号多少钱
宁陵属于哪个省份	香港属于哪个省份
中日开战谁会赢	中英开战谁会赢
正当防卫四画质怎么调到最好	正当防卫三画质怎么调到最好
南昌到济宁的火车	南昌到兰州的火车
十三岁男孩正常体重	十六岁男孩正常体重
一百零二乘十九简便计算	一百零二乘十六简便计算
祝自己三十八岁生日祝福语	祝自己四十八岁生日祝福语
济南好吃的外卖	哈尔滨好吃的外卖
十年儿童电视剧	十一年儿童电视剧
烟台离南昌有多远	北京离南昌有多远
重庆有什么好吃的	长春有什么好吃的
北京飞伊春机票	北京飞悉尼机票
心理健康七大标准	心理健康八大标准
无锡到盘锦多少公里	无锡到福州多少公里
阳历七十三年一月九日是什么星座	阳历七十四年一月九日是什么星座
广州怎么预约口罩	太原怎么预约口罩
北京有什么好吃	澳门有什么好吃
七十七年出生男演员	七十八年出生男演员
夏津搬家公司的电话	深圳搬家公司的电话
机智的医生生活第三集乐队唱的歌	机智的医生生活第五集乐队唱的歌
微信好友超过五千人怎么办	微信好友超过五百人怎么办
上海卫视相亲节目	东方卫视相亲节目
一百以内最大的偶数是几	二十以内最大的偶数是几
人大录取分数线二千零一十九	辽大录取分数线二千零一十九
五十五乘五十五	五十五乘七
开州到重庆汽车时刻表	北京到重庆汽车时刻表
金龙汽车股价	阿里巴巴股价
国泰的企业文化	吉祥航空的企业文化
华东属于哪个省	江北属于哪个省
重庆哪里可以做义工	济南哪里可以做义工
广州包括哪里	武汉包括哪里
太平保险客服热线	华安保险客服热线
上海体育学院是几本	河北体育学院是几本
西安交大什么时候开学	上海交大什么时候开学
十九年山东科技大学研究生录取分数线	十九年青岛科技大学研究生录取分数线
四减十八什么星座	四减四什么星座
怀孕四十三天能看出双胞胎吗	怀孕四十二天能看出双胞胎吗
第二次工业革命重要发明	第一次工业革命重要发明
徽商银行限额	招行限额
a五十二有超广角吗	a七十二有超广角吗
中国近代名将	中国当代名将
赵薇怎么样	马嘉祺怎么样
天津做核磁共振多少钱	乌鲁木齐做核磁共振多少钱
sim卡怎么取出来	slm卡怎么取出来
云梦一中什么时候开学	邹城一中什么时候开学
长春治疗肝癌最好的医院	长沙治疗肝癌最好的医院
iphone十一有红外	iphone七有红外
九十七年四月二十一日出生的是什么星座	九十八年四月二十一日出生的是什么星座
北京到唐山开车多久	北京到成都开车多久
武汉东方雅园一期房价	武汉东方雅园三期房价
四和十最小的公倍数	四和九最小的公倍数
九十九年农历十月十七是什么星座	八十九年农历十月十七是什么星座
二千零二十天津医大研究生拟录取名单	二千零二十福建医科大学研究生拟录取名单
维生素比十二缺乏症状	维生素比一缺乏症状
今天是农历几号	前天是农历几号
宜春公务员工资	西宁公务员工资
一百二十五加五十x八的简便计算	一百二十五加九x八的简便计算
汕头高三一模考试时间二千零二十	青岛高三一模考试时间二千零二十
汇丰银行待遇怎么样	恒丰银行待遇怎么样
南京林业大学研究生复试时间	南京工程学院研究生复试时间
河南大学到底什么时候开学	河北大学到底什么时候开学
三十八乘五	三十八乘八
一繁体字是什么样的	四繁体字是什么样的
河北大学软件工程怎么样	东北大学软件工程怎么样
七个月宝宝咳嗽有痰怎么办	九月宝宝咳嗽有痰怎么办
解放军总医院放射科主任	武警总医院放射科主任
月经推迟七天了怎么办	月经推迟四天了怎么办
零点六乘零点三	零点六乘零点六
停经三天能测出怀孕吗	停经一天能测出怀孕吗
周润发电影有哪些	周总理电影有哪些
东莞到淮安多少公里	东莞到珠海多少公里
三十六减八等多少	零减八等多少
三星还是闪迪	三星还是华为
公主岭到黑龙江多远	公主岭到沈阳多远
乌鲁木齐离北屯有多远	乌鲁木齐离上海有多远
中国有多少姓乔的人	中国有多少姓葛的人
山东科技大学会计学怎么样	辽宁科技大学会计学怎么样
捷豹xfl质量怎么样	捷豹xel质量怎么样
郴州到长沙高铁时刻表	郴州到武汉高铁时刻表
贵州师范学院多大	安庆师范学院多大
三十乘三十等多少	三十乘六等多少
一千九百三十是什么时间	四百三十是什么时间
deli是什么牌子	desi是什么牌子
五十岁还能买社保吗	六十岁还能买社保吗
重庆到南阳的动车	重庆到杭州的动车
四十六年是哪里世界杯	四十七年是哪里世界杯
兰州在哪里	兰州机场在哪里
中石油国企还是央企	中石化国企还是央企
西安著名小学	西城著名小学
苏州到遵义汽车时刻表	西安到遵义汽车时刻表
桂林哪个驾校口碑最好	沈阳哪个驾校口碑最好
南京师大历史系在哪个校区	云南师范大学历史系在哪个校区
二十三乘五十等多少	二十三乘四等多少
三大营养素之间的关系	七大营养素之间的关系
河北农业大学研究生分数线二千零一十九	河工大研究生分数线二千零一十九
河南师范大学招美术生吗	南京师大招美术生吗
江苏自考一月科目	江苏自考八月科目
西安哪里有租电动车的	南京哪里有租电动车的
六百除八竖式计算	六十除八竖式计算
两千越南盾是多少人民币	两万越南盾是多少人民币
九点八乘十五等多少	九点八乘一千等多少
济南好吃的外卖	兰州好吃的外卖
k三的价格	k七的价格
十八和四十二的最大公因数是什么	十八和一的最大公因数是什么
八十四和七的最小公倍数	一和七的最小公倍数
中国农大浙江录取分数线	中国农大广东录取分数线
江门到张家界多少公里	南京到张家界多少公里
男女在床上做不可描述的事情	男女一起做不可描述的事情
十七个月宝宝突然发烧怎么回事	十一月宝宝突然发烧怎么回事
二十九乘三十五	二十五乘三十五
十七年中国gdp增速	十八年中国gdp增速
第二次听力筛查没通过	第一次听力筛查没通过
江西二本院校	山东二本院校
山东有什么山	广西有什么山
江西四大水库	江西七大水库
二千二百九十三千焦等多少千卡	二千一百九十三千焦等多少千卡
上海到重庆动车时刻表	上海到深圳动车时刻表
现在所在位置	刚才所在位置
飞车宠物最后二格要多少钱	飞车宠物最后一格要多少钱
适合七十后唱的歌	适合九十后唱的歌
峨眉湖在哪个城市	鄱阳湖在哪个城市
孩子老是挤眼睛怎么办	孩子偶尔挤眼睛怎么办
黄岛有哪些大学	新加坡有哪些大学
八级工伤赔偿标准	一级工伤赔偿标准
六岁孩子流清鼻涕怎么办	四岁孩子流清鼻涕怎么办
十三岁古语怎么说	十四岁古语怎么说
三分之一是不是有理数	二分之一是不是有理数
南宁有没有海底捞	乌鲁木齐有没有海底捞
钢铁是怎样练成的第一部第四章概括	钢铁是怎样练成的第一部第一章概括
近视零点八是多少度	近视一点八是多少度
三月二十六日什么星座	三月一日什么星座
九百kg等多少t	九十kg等多少t
咸阳到武汉多少公里	咸阳到兰州多少公里
怀孕初期肚子隐隐疼	怀孕初期肚子一直疼
四十岁可以练瑜伽吗	六十岁可以练瑜伽吗
榆林到杭州的火车	上海到杭州的火车
银川到绵阳多少公里	银川到天津多少公里
五得利是上市公司吗	百度是上市公司吗
闹钟调到十一点	闹钟调到十五点
沈阳到广西多少公里	沈阳到香港多少公里
成都打疫苗的地方	呼和浩特打疫苗的地方
叶绍翁是哪个朝代	叶圣陶是哪个朝代
春阳路实验小学怎么样	南宁新阳路小学怎么样
南京有什么好玩的	南京南站有什么好玩的
十九年全国高校毕业生人数	二十年全国高校毕业生人数
八十七年腊月初十是什么星座	八十七年腊月初五是什么星座
兖矿集团本科生待遇	三一集团本科生待遇
埃及官方语言	马其顿官方语言
六百g有多重	四百g有多重
温州消费券使用规则	成都消费券使用规则
九十八年九月初三是什么星座	九十九年九月初三是什么星座
成都上班时间	成都地铁上班时间
十九年时代背景	二十年时代背景
二千零二十安徽农业大学复试名单	二千零二十河南农业大学复试名单
青海师范大学艺术生录取分数线	哈尔滨师范大学艺术生录取分数线
设置一分钟后的闹钟	设置明天六点的闹钟
湖南到衡阳多少公里	湖南到贵州多少公里
台州到江苏	台州到浙江
十二年五年期存款利息	十三年五年期存款利息
辽宁工业大学地址	西安工业大学地址
左眼一直跳是怎么回事	左眼有点跳是怎么回事
六十四除四十怎么列竖式	六十四除八怎么列竖式
南宁长热线电话	成都长热线电话
吉木乃县邮政编码	吉水县邮政编码
天主七天创造了什么	天主第一天创造了什么
oppo是哪国的手机	华为是哪国的手机
海南的少数民族有哪些	广西的少数民族有哪些
重庆属于东几区	南宁属于东几区
五百的单词	三百的单词
姓赖的取什么名字好听	姓唐的取什么名字好听
北大排名全国第几	北京联合大学排名全国第几
温州到上海动车	温州到香港动车
焦作到日照多少公里	焦作到厦门多少公里
秦的秦怎么组词	秦淮的秦怎么组词
如果除数是七余数最大是几	如果除数是九余数最大是几
虹口公园要预约吗	莲花山公园要预约吗
空调只制冷不制热怎么回事	空调不制冷不制热怎么回事
怀孕九个月引产	怀孕四月引产
二十四和六的最大公因数是多少最小公倍数是多少	三和六的最大公因数是多少最小公倍数是多少
海螺沟至康定多少公里	西安至康定多少公里
设置明天五点半的闹钟	设置明天四点半的闹钟
陕西高中什么时候分文理科	河南高中什么时候分文理科
沈阳到银川的火车票	沈阳到长春的火车票
红色芒果叫什么名字	红色苹果叫什么名字
五十除十	一千除十
河南到深圳经过几个省	河南到四川经过几个省
西安交大博士毕业年薪	上海交大博士毕业年薪
上海交大什么专业好	上海理工大学什么专业好
农历七月十七是什么星座	农历七月十四是什么星座
南昌离哈尔滨多远	济南离哈尔滨多远
太仓市在哪个省	中国在哪个省
下午去哪玩	国庆去哪玩
华威大学和伯明翰大学哪个好	华威大学和爱丁堡大学哪个好
高压九十低压六十正常吗	高压一百一十低压六十正常吗
西城广场属于哪个街道	西城花园属于哪个街道
七十二乘三	七十二乘二
深证湾公园在哪里	枫林湾在哪里
中央大街附近有什么好吃的	中央路附近有什么好吃的
工行对公账户电话	建行对公账户电话
江西巡抚衙门旧址	河南巡抚衙门旧址
贾宝玉和谁一天生日	宝玉和谁一天生日
德州电话区号	菏泽电话区号
长白山怎么样	白头山怎么样
四和十的最小公倍数	九和十的最小公倍数
太原理工十九年录取分数线是多少	长沙理工大学十九年录取分数线是多少
营口属于那里	西宁属于那里
漳州哪里可以领养狗狗	广州哪里可以领养狗狗
南昌信访局地址	石家庄信访局地址
十八万音浪等多少钱	十五万音浪等多少钱
六十八年农历十月二十五阳历	六十八年农历十月十二阳历
西安房屋交易政策	兰州房屋交易政策
意大利离印度多远	意大利离德国多远
广德县景点	中国景点
开心消消乐隐藏五百六十六关怎么过	开心消消乐隐藏三关怎么过
常州有什么好玩的地方	哈尔滨有什么好玩的地方
黑龙江主产什么	贵州主产什么
乙肝五项二四五阳性什么意思	乙肝五项三四五阳性什么意思
二十年北方民族大学什么时候开学	二十年北华大学什么时候开学
陕西二级建造师分数线	河南二级建造师分数线
四字霸气签名	三十字霸气签名
盖州到东港多少公里	盖州到杭州多少公里
柳州到许昌火车时刻表	柳州到哈尔滨火车时刻表
大姨妈第二天可以喝啤酒吗	大姨妈第六天可以喝啤酒吗
第一次怀孕会宫外孕吗	第二次怀孕会宫外孕吗
烟台哪里有卖乌龟的	唐山哪里有卖乌龟的
三百零六除三	三百零六除九
十八周去医院检查什么	二十八周去医院检查什么
辽宁铁矿分布	甘肃铁矿分布
二十年西工大研究生复试名单	二十年哈工大研究生复试名单
成都打疫苗的地方	昆明打疫苗的地方
中国和巴林时差多少	中国和新加坡时差多少
合肥有哪些工厂	中国有哪些工厂
九百除八等几	六除八等几
湖南城市学院是几本	湖南农业大学是几本
从昆明到南京	从苏州到南京
孕三十九周胎动减少正常吗	孕三十一周胎动减少正常吗
武侯区房价	江夏区房价
扬州到贵阳火车票	扬州到南宁火车票
洛阳离扬州有多远	西安离扬州有多远
四川有什么好玩的地方吗	辽宁有什么好玩的地方吗
北京至上海有多远	北京至西安有多远
历史上姓杨的名人	历史上姓邰的名人
馆陶县属于哪里	常山县属于哪里
淮安到宿迁	淮安到四川
三十八周头围标准值	三十五周头围标准值
水利部原部长	财政部原部长
带三字的四字成语	带七字的四字成语
最优美的拟人句十字	最优美的拟人句五字
郑州科一考试时间	郑州科三考试时间
孕二十八周是几个月	孕二十六周是几个月
果香园怎么样	集美园博一号怎么样
姓荣的由来	姓杨的由来
一百三十二除二	一百三十二除六
八十六年属虎和什么属相最配	八十七年属虎和什么属相最配
零点三乘零点三	零点三乘零点五
九千六百韩币等多少人民币	九千五百韩币等多少人民币
陕西距离河北有多远	海南距离河北有多远
cpa考试什么时候报名	cma考试什么时候报名
三十二乘八	一乘八
西安到莱西	西安到成都
什么是疫情防控二类人员	什么是疫情防控四类人员
曲靖到马关	曲靖到广东
印度的高新技术产业中心在哪里	台湾的高新技术产业中心在哪里
长沙卖书的地方在哪里	昆明卖书的地方在哪里
山东离江西有多远	贵州离江西有多远
苹果七什么时候上市	苹果十一什么时候上市
二千三百三十三是什么意思	一千三百三十三是什么意思
通辽至北京航班	厦门至北京航班
二千乘六十	二千乘七百
两的多少次等六	两的多少次等三
阿勒泰有什么特色美食	澳门有什么特色美食
今天西安下雪了吗	昨天西安下雪了吗
立秋的习俗有哪些	立夏的习俗有哪些
四个一和三个十组成的数	四个一和三个千组成的数
好听的四个字名字	好听的二个字名字
武汉隔离多少钱	南京隔离多少钱
基金净值五十六万零二	基金净值五十八万零二
重庆哪家迪卡侬最大	天津哪家迪卡侬最大
郑州贾鲁河在哪里	郑州贾鲁河公园在哪里
九十年润五月初九是几号	九十一年润五月初九是几号
福州到哈尔滨特价机票	福州到广州特价机票
今日山东卫视节目单	今日山西卫视节目单
东北大学有哪几个校区	北大有哪几个校区
西安特色美食加盟店排行榜	重庆特色美食加盟店排行榜
fifa十八球员生涯模式怎么转会	fifa十五球员生涯模式怎么转会
西安车辆限行规定	南京车辆限行规定
二十万美金是多少人民币	四十万美金是多少人民币
沂水一中怎么样	沂源一中怎么样
黑龙江到淮南快递几天	广东到淮南快递几天
科一后多久能考科三	科一后多久能考科二
中山邮编号	广州邮编号
杨桃的功效与作用	杨桃叶的功效与作用
六和九的最小公倍数有什么	四和九的最小公倍数有什么
宜昌拆迁补偿标准	连云港拆迁补偿标准
重庆落户条件	石家庄落户条件
农行信用卡怎么提前还款	建行信用卡怎么提前还款
山东到通辽	山东到辽宁
七十二除五	七十二除十二
宿迁到天津有多少公里	天津到天津有多少公里
北京至上海有多远	北京至大连有多远
河北二千零一十九二本投档线	湖北二千零一十九二本投档线
四十五乘四十五	四十五乘三
张炎夏怎么了	张丽怎么了
高压一百二十低压六十正常吗	高压一百一十低压六十正常吗
北京交大广东录取分数线	西安交大广东录取分数线
兰州穷不穷	济南穷不穷
十五和九十五最大公因数	十五和一百最大公因数
二百一十除七	二百一十除三十
武汉属于哪个省	长沙属于哪个省
十三乘五等多少	十三乘十四等多少
华容县gdp二千零一十九	闽侯县gdp二千零一十九
晋城到长治多少公里	晋城到河北多少公里
平煤集团世界五百强	潞安集团世界五百强
浙江到乌鲁木齐多少公里路	浙江到山东多少公里路
十七年中国煤炭进口量	十八年中国煤炭进口量
二百五十除二十五	四百五十除二十五
上海理工大学就业怎么样	沈阳理工大学就业怎么样
九十年阴历三月二十七	九十年阴历三月三
江阴地毯生产厂家	山东地毯生产厂家
北大开学日期	北京交大开学日期
现在广州可以回安徽吗	现在广州可以回河南吗
山西退住宿费	甘肃退住宿费
凌凌的含义	凌的含义
长春中考体育成绩对照表二千零一十九	贵阳中考体育成绩对照表二千零一十九
顺丰快递从河南到天津要多久	顺丰快递从海南到天津要多久
三十八乘九	六乘九
胎儿二十四周双顶径正常值	胎儿三十三周双顶径正常值
江苏属于什么	福建属于什么
长春动物园门票多少钱	北京动物园门票多少钱
传祺ga六价格	传祺gm六价格
四十乘六等	一乘六等
太原理工最新全国排名	上海理工大学最新全国排名
英国消费低的城市	中国消费低的城市
阳江有什么区	海阳市有什么区
西宁最大整形医院	济南最大整形医院
西安的西南方向有哪些城市	南京的西南方向有哪些城市
杭州距离马鞍山多少公里	杭州距离南昌多少公里
吉赛尔邦辰身高	吉尔加美什身高
苹果十一屏幕间歇性失灵	苹果六屏幕间歇性失灵
枣庄到泰安高铁	枣庄到杭州高铁
东南亚冬季风和夏季风成因	东亚冬季风和夏季风成因
贵阳车辆尾号限行	南昌车辆尾号限行
九十二年九月初四是什么星座	九十三年九月初四是什么星座
第一个字是七成语	第一个字是九成语
节食七天能瘦多少	节食五天能瘦多少
宁德到宜春多少公里	宁德到哈尔滨多少公里
中国太平有车险吗	中国太平保险有车险吗
三亚有水果批发市场吗	北京有水果批发市场吗
十九年出了什么电影	二十年出了什么电影
温州到拉萨多少公里路	温州到杭州多少公里路
长春动物园门票多少钱	武汉动物园门票多少钱
设置七点五十的闹铃	设置五点五十的闹铃
苏州有地铁吗	苏州站有地铁吗
五乘二点五	四十乘二点五
西南财大十九年内蒙古录取分数线	西南财大十九年云南录取分数线
一千一百四十六爱情数字是什么意思	一千一百一十六爱情数字是什么意思
张家口历任市长	淄博历任市长
三明到武昌火车时刻表	三明到兰州火车时刻表
内蒙古车牌号城市代号	四川车牌号城市代号
三星note十可以插内存卡吗	三星note八可以插内存卡吗
六十四乘八	六十四乘六
二十和二十二的最小公倍数是多少	二十和七的最小公倍数是多少
南京有哪些职业高中	石家庄有哪些职业高中
泰康人寿的电话	平安人寿的电话
沈阳至徐州	沈阳至东京
五和八的最小公倍数是什么	十和八的最小公倍数是什么
咸阳到宁夏多少公里	咸阳到武汉多少公里
上海财大上海分数线	南京财经大学上海分数线
五百三十二除七的竖式怎么列	五百三十三除七的竖式怎么列
二又七分之一	二又四分之一
九百零二g是多少斤	九百一十五g是多少斤
南华大学何时开学	华南农业大学何时开学
五十除十	五十除五
乌鲁木齐至青岛火车票	重庆至青岛火车票
十六cm等多少m	三cm等多少m
月经推迟七天了怎么办	月经推迟八天了怎么办
广东电价	海南电价
阳历三月十一日是什么星座	阳历三月九日是什么星座
昆明车辆报废点	武汉车辆报废点
小学四种时态	小学五种时态
郑州到济南汽车时刻表	济南到济南汽车时刻表
科目四多少分过	科目一多少分过
四什么四什么四什么四等三	四什么四什么四什么四等一
郑州离山西多远	郑州离深圳多远
a十一x的价格	a十一n的价格
三个月宝宝汗多	七个月宝宝汗多
玉林师范学院校长办公室电话	盐城师范学院校长办公室电话
十六和二十四最大的公因数是什么	十六和九最大的公因数是什么
九十六年九月初四是什么星座	九十七年九月初四是什么星座
呼和浩特到长沙的飞机票	南昌到长沙的飞机票
深圳哪里吉他教得好	洛阳哪里吉他教得好
冬天有什么花	春天有什么花
沈阳昨天发生了什么事	沈阳今天发生了什么事
闹钟调到五点五十	闹钟调到十二点五十
定西人口	西固区人口
清远至广州距离	南京至广州距离
朔州到廊坊火车时刻表	朔州到青岛火车时刻表
iphone七plus内屏价格	iphone六plus内屏价格
常州人好吗	漳州人好吗
中南民族大学缴费	云南民族大学缴费
三级能耗空调耗电量	一级能耗空调耗电量
云南师范大学是重点大学吗	云南财经大学是重点大学吗
西北民族大学就业去向	西北政法大学就业去向
张家口是哪个省	张家港是哪个省
遵义医学院全国排名	泸州医学院全国排名
息屏时长调到十秒	息屏时长调到三十秒
怀孕二十八周肚子有点疼	怀孕一周肚子有点疼
f十五参数	r十五参数
朝鲜电压和中国一样吗	哈萨克斯坦电压和中国一样吗
昌平地铁路线	香港地铁路线
如何在一星期内提高成绩	如何在一天内提高成绩
株洲到新化火车	株洲到昆明火车
苹果七有几个摄像头	苹果八有几个摄像头
南理工计算机专业怎么样	西安理工计算机专业怎么样
中联重科是央企还是国企	中联是央企还是国企
南昌至景德镇列车时刻表	南京至景德镇列车时刻表
鸟哥在哪直播	飞哥在哪直播
《水浒传》第三章主要内容	《水浒传》第九章主要内容
南京邮电大学在四川录取分数线	南京大学在四川录取分数线
打电话给建明	打电话给王建明
黑龙江第一个省会	河南第一个省会
苹果六plus什么时候降价	苹果八plus什么时候降价
九周岁的孩子身高体重标准	八周岁的孩子身高体重标准
十六乘一千二百五十	十六乘九
二十年重庆选调生报名时间	二十年广东选调生报名时间
三十六℃体温正常吗	三十九℃体温正常吗
九和四的最小公倍数是几	九和十三的最小公倍数是几
南昌哪里有回收酒的	成都哪里有回收酒的
石家庄经济学院录取分数线	西安财经学院录取分数线
南师大难考吗	湖南师大难考吗
k三包装清单	k七包装清单
吉林农大在哪	甘肃农业大学在哪
淮安到扬州高铁	淮安到沈阳高铁
梧州学院占地面积多少亩	贺州学院占地面积多少亩
一十八分之三	一十八分之七
柳州到杭州东火车	上海到杭州东火车
三月十八日是什么星座	三月六日是什么星座
波士顿大学和加州大学哪个好	波士顿大学和清华哪个好
黑龙江科技大学属于二百一十一吗	辽宁科技大学属于二百一十一吗
三个月断奶可以吗	八月断奶可以吗
一个四位数它的千位上是八	一个四位数它的千位上是三
河北距离广西多远	河北距离广东多远
从化区哪里最繁华	中国哪里最繁华
十八和三十五的最大公因数是多少	十八和四的最大公因数是多少
二乘几等六	二乘几等十四
合肥二千零二十重点项目	长春二千零二十重点项目
什么是甲功三项	什么是甲功七项
长春有哪些公司	南京有哪些公司
内蒙古师范大学十九年录取分数线	内蒙古财经大学十九年录取分数线
月经推迟七天了怎么办	月经推迟五天了怎么办
毕节到河南多少公里	毕节到四川多少公里
二十年河北高速收费了吗	二十年广西高速收费了吗
三千六百个小时是多少天	十二小时是多少天
贵阳最低生活保障标准是多少	哈尔滨最低生活保障标准是多少
九和十的最小公倍数怎么求	四和十的最小公倍数怎么求
山西中医学院录取分数线二千零一十九	云南中医学院录取分数线二千零一十九
九月出生的羊好不好	十月出生的羊好不好
安徽养殖业补贴政策	内蒙古养殖业补贴政策
仙华山是在什么地方	华山是在什么地方
工行公积金贷款提前还款	徽商银行公积金贷款提前还款
丰宁晚上好玩的地方	杭州晚上好玩的地方
安康学院宿舍怎么样	合肥学院宿舍怎么样
安阳到徐水火车时刻表	安阳到南昌火车时刻表
安康学院宿舍怎么样	石家庄学院宿舍怎么样
邯郸到瓦房店的火车票	邯郸到西安的火车票
一百七十五除二十五	一百七十五除七
东方卫视播放时间表	浙江卫视播放时间表
双流机场属于哪个区	中国属于哪个区
嘉兴单身公寓楼盘价格	北京单身公寓楼盘价格
苏州到上海的动车	苏州到长沙的动车
周培公怎么死的	周公瑾怎么死的
五减一	五减三
七除五十六	七除四
洛阳到迁安多少公里	洛阳到武安多少公里
定兴到青岛多少公里	石家庄到青岛多少公里
第一个错的成语	第四个错的成语
十五号星期几	十八号星期几
荣耀十没有录屏功能	荣耀九没有录屏功能
迪拜和中国的汇率	英国和中国的汇率
barrio什么意思	barren什么意思
十九角等多少元多少角	六角等多少元多少角
fifa十八球员生涯模式怎么转会	fifa十九球员生涯模式怎么转会
西安到东营	西安到深圳
山西最大的官是谁	广东最大的官是谁
九的乘法口诀	六的乘法口诀
去北京同仁医院坐地铁几号线	去北京协和医院坐地铁几号线
甘肃农业大学什么时候开学	河南农业大学什么时候开学
二十年特岗教师报名时间黑龙江	二十年特岗教师报名时间陕西
天津至上海火车票	天津至昆明火车票
英文三的序数词	英文四的序数词
安顺到玉溪多少公里	安顺到长沙多少公里
重庆最新楼盘开盘	太原最新楼盘开盘
李流芳是哪个朝代的	李是哪个朝代的
四十五加十九	四十五加十六
两月十八是什么座	两月九是什么座
蔡卓怡多少岁	卓卓多少岁
成都有几个客运站	长春有几个客运站
湖南城市学院是几本	湖南文理学院是几本
几除五等几余数最大是几	几除九等几余数最大是几
柯珞克的意思	柯克的意思
上海海洋大学的双一流学科	海大的双一流学科
慈利到西安火车时刻表	北京到西安火车时刻表
安徽师范大学保研条件	辽宁师范大学保研条件
十八年山东公务员考试面试名单	十九年山东公务员考试面试名单
江苏和韩国哪个发达	江苏和江西哪个发达
月经量比较多	月经量不多
宁夏一般几点天黑	青海一般几点天黑
三十六和四十五的最大公倍数	五和四十五的最大公倍数
兰州到南阳的火车	兰州到杭州的火车
茂名到抚州火车时刻表	南昌到抚州火车时刻表
lasik手术费用	lasek手术费用
一百二十五乘十六乘七的简便运算	一百二十五乘十六乘二十五的简便运算
北京到濮阳的汽车	北京到青岛的汽车
你能听懂四川话吗	你能听懂山东话吗
肚子有点胀气	肚子一直胀气
虹桥中学招生办电话	教育部招生办电话
五除十二乘九	五除十二乘四
十五韩元等多少人民币	三韩元等多少人民币
西南交大属于二百一十一还是九百八十五	西交大属于二百一十一还是九百八十五
河内的三字代码	开罗的三字代码
从昆明到南京	从南宁到南京
三月二十六日什么星座	三月七日什么星座
设置五点二十闹钟	设置八点二十闹钟
中信怎么换积分	中行怎么换积分
一点二十五化成分数	六点二十五化成分数
减两的二千零一十七次方加减两的二千零一十八次方	减两的二千零一十九次方加减两的二千零一十八次方
湘潭到贵州	湘潭到厦门
历史上姓周的名人	历史上姓俞的名人
南阳师范学院还开学吗	淮南师范学院还开学吗
南通著名企业家	武汉著名企业家
周文强是谁	王宝强是谁
今天是农历多少号	前天是农历多少号
佛山到唐山	佛山到北京
济南飞南京航班时刻表	台北飞南京航班时刻表
辽宁工业大学地址	淮北工业学校地址
中国美术馆门票多少钱	深圳美术馆门票多少钱
十四乘八加五	五乘八加五
甲状腺功能三项是查什么	甲状腺功能八项是查什么
徐州工业学院怎么样	徐州工程学院怎么样
乌鲁木齐到石家庄高铁票价	郑州到石家庄高铁票价
本田crv好不好	本田xrv好不好
三十四乘五十八列竖式计算	四十四乘五十八列竖式计算
胶州一中录取分数线二千零一十九	郴州一中录取分数线二千零一十九
北京海关公务员好考吗	沈阳海关公务员好考吗
意大利离印度多远	意大利离中国多远
十九年体育单招专项评分标准	二十年体育单招专项评分标准
九十年一角的硬币值多少钱	八十九年一角的硬币值多少钱
十九年混合型基金业绩排名	二十年混合型基金业绩排名
一米五的身高标准体重应该	一米八的身高标准体重应该
五月二十七号是什么座	五月二十五号是什么座
餐后两小时血糖正常值	餐后六小时血糖正常值
西安理工大学专硕读几年	江西理工大学专硕读几年
河北金融学院王牌专业	广东金融学院王牌专业
辽宁铁矿分布	四川铁矿分布
月经来三天就没了正常吗	月经来一天就没了正常吗
云南到苏州快递要几天	福建到苏州快递要几天
九十九年农历八月十七是什么星座	九十九年农历八月十八是什么星座
西华师大的排名	华东师大的排名
西安到天水的大巴	成都到天水的大巴
馆陶县属于哪里	五莲县属于哪里
赤峰到银川火车	唐山到银川火车
五百二十四的最小公倍数	五百二十三的最小公倍数
八除三分之一	八除八分之一
山东清水模板生产厂家	澳门清水模板生产厂家
罗寨村怎么样	寨子村怎么样
九月结婚好日子有哪些	十月结婚好日子有哪些
二千零一十九江西科技师范大学专升本拟录取名单	二千零一十七江西科技师范大学专升本拟录取名单
华为ar怎么用	百度ar怎么用
0八年是第几届奥运会	九年是第几届奥运会
为什么腿一直凉	为什么腿很凉
三乘七	四乘七
一百和四十八的最大公因数是多少	七和四十八的最大公因数是多少
连云港有没有红旗四s店	深圳有没有红旗四s店
南宁到巴马多远	南宁到沈阳多远
科目四补考需要交费吗	科目一补考需要交费吗
为什么第二次还会流血	为什么第三次还会流血
老是反胃干呕怎么回事	偶尔反胃干呕怎么回事
沂水靠谱的装修公司	吴江靠谱的装修公司
农夫山泉的股价	楚天科技的股价
湖南师大具体地址	闽南师范大学具体地址
上海工程技术大学待遇	上海海事大学待遇
哈尔滨海拔高度是多少	哈尔滨站海拔高度是多少
七十三年十二月十三日是什么星座	七十四年十二月十三日是什么星座
十九年六月份汽油价格	二十年六月份汽油价格
上午九时是什么时	上午八时是什么时
山西几天无新增病例	湖北几天无新增病例
今天会下雨吗	明天会下雨吗
济南大学什么时候返校	南理工什么时候返校
五百除二	五百除六十
餐后两小时血糖正常值范围	餐后一小时血糖正常值范围
农历七月十七是什么星座	农历七月十一是什么星座
去康巴什坐几路公交车	去杭州坐几路公交车
七十二除十五	七十二除十六
呼和浩特到济南多少公里	拉萨到济南多少公里
六个月婴儿感冒流鼻涕怎么办	九个月婴儿感冒流鼻涕怎么办
黑瞎子岛面积	星光岛面积
一百二十五乘八等多少	六乘八等多少
驻马店到常州火车票	驻马店到青岛火车票
月经推迟六天了验孕棒显示没怀孕	月经推迟八天了验孕棒显示没怀孕
今日上交所金价	今日纽交所金价
九十年阴历三月二十七	九十年阴历三月二十
临沂黄金回收价格	湛江黄金回收价格
减一除两的五次方	减一除两的四次方
两点八十二化成分数	两点八十四化成分数
塞舌尔在哪个洲	巴拿马在哪个洲
台北湾属于哪个社区	檀香湾属于哪个社区
江西哪些地方有血吸虫	湖北哪些地方有血吸虫
三明到梅州火车	上海到梅州火车
天津哪个省的	南京哪个省的
三点消毒抹布桶中最多可以放置多少条抹布除煎炉抹布	十四点消毒抹布桶中最多可以放置多少条抹布除煎炉抹布
湖南大学偏文还是偏理	湖北大学偏文还是偏理
淮安到宿迁	淮安机场到宿迁
四百五十九除三等多少	零除三等多少
郑州是属于哪个省	合肥是属于哪个省
0五年出生的明星	二百零六年出生的明星
五乘八	八乘八
农行成都网点	农行南京网点
洛阳有什么好玩地方	长沙有什么好玩地方
重庆至浙江有多少公里	重庆至广东有多少公里
宜昌至台州动车时刻表	上海至台州动车时刻表
梧州学院占地面积多少亩	池州学院占地面积多少亩
孕三十一周很累	孕三十四周很累
南昌到南京要经过哪些地方	南昌到深圳要经过哪些地方
毕节到黔南有多少公里	毕节到重庆有多少公里
长春到外地需要隔离吗	哈尔滨到外地需要隔离吗
合肥到齐齐哈尔的火车	合肥到石家庄的火车
今天呼和浩特多少度	今天南宁多少度
武汉理工转专业	哈尔滨理工大学转专业
以前的江东是现在的哪里	以前的江南是现在的哪里
绵阳飞南京	宜宾飞南京
ma是什么意思	st是什么意思
临汾到侯马多远	临汾到济南多远
五和六的最小公倍数	五和八的最小公倍数
明天西安什么天气	明天南昌什么天气
六十除八	六十除四
奔驰gle二百六十价格	奔驰glc二百六十价格
小米手机和苹果哪个好	小米手机和三星哪个好
湖南历年高考分数线	浙江历年高考分数线
一到一百的序数词怎么读	一到六的序数词怎么读
十七岁能在哪里贷款	十六岁能在哪里贷款
北京交大国内排名	北大国内排名
五百五十乘三十	一乘三十
张卫健多高	姜熙健多高
邓州到烟台火车时刻表	邓州到青岛火车时刻表
尺寸二十七是多大码	尺寸二十四是多大码
沈阳养老金计算方法	岳阳养老金计算方法
肚子太饿了	肚子不饿了
潮州有啥好吃的	佛山有啥好吃的
十一pm是几点	十一am是几点
兰州真实房价	南京真实房价
北京协和医院隆鼻怎么样	北京同仁医院隆鼻怎么样
十九年国产恐怖电影	二十年国产恐怖电影
厦门批发市场在哪里	宜兴批发市场在哪里
六岁全麻对身体有什么危害	一岁全麻对身体有什么危害
上海狂犬疫苗接种点	遵义狂犬疫苗接种点
四分之三乘五	四分之三乘一百
驰宏锌锗十大股东	百度十大股东
四十二除十等	六除十等
环保部部长级别	教育部部长级别
上海骨科哪家医院好	酒泉骨科哪家医院好
五月份可以种什么瓜	四月份可以种什么瓜
四十二乘二	四十二乘六
结果一年纪念日说说	结果一个月纪念日说说
哈尔滨师范学院分数线二千零一十九	哈尔滨体育学院分数线二千零一十九
睢宁到吴江	济宁到吴江
南京邮电大学在四川录取分数线	南华大学在四川录取分数线
织金县特色美食	金平县特色美食
西华师大翻译	陕西师大翻译
合肥到恩施飞机	太原到恩施飞机
九小时多少秒	二十四小时多少秒
清华入取分数线	辽大入取分数线
广州到西藏飞机	南京到西藏飞机
宁波的大学排名	香港的大学排名
广州发顺丰到宁波	广州发顺丰到北京
八十七年到现在有多少年了	八十八年到现在有多少年了
陕西的编号	江西的编号
七十八年上映的电影	七十九年上映的电影
江苏科技大学mba学费	陕西科技大学mba学费
苹果十一的装置管理在哪里	苹果七的装置管理在哪里
打电话给唐飞	打电话给张静
柳州到合山	柳州到澳门
湖北多少公里	武汉多少公里
六百四十除四等多少	三除四等多少
十四和十三的最小公倍数	十四和十七的最小公倍数
盐城事业单位工资	珠海事业单位工资
二年级下册万以内数的认识	二年级下册千以内数的认识
洛阳到西安的距离	成都到西安的距离
东方卫视女主持人	广东卫视女主持人
一点四乘零点五	二点四乘零点五
上海到滕州火车时刻表	南京到滕州火车时刻表
兰州武警医院是三甲医院吗	南京武警医院是三甲医院吗
临海到杜桥有多少公里	临海到福州有多少公里
截止五月六日全国疫情情况	截止五月四日全国疫情情况
cpa哪个培训机构好	cfa哪个培训机构好
一百二十四刀是多少人民币	九刀是多少人民币
南京大学和南京工业大学哪个好	海大和南京工业大学哪个好
唐探三好看吗	张雪迎好看吗
谷雨是农历几月几号	清明是农历几月几号
南航是国企吗	西南航空是国企吗
十九年三月份的电影	十九年八月份的电影
十九岁的英语怎么写	十八岁的英语怎么写
广丰区面积多少平方公里	广安区面积多少平方公里
临汾到安阳多少公里	山东到安阳多少公里
诸葛亮的儿子是谁	詹姆斯的儿子是谁
南昌到济南的高铁	南昌到沈阳的高铁
东方卫视女主持人名单	浙江卫视女主持人名单
十kv变压器价格	十kw变压器价格
九江到南京多少公里	九江到宁波多少公里
七十四年正月二十六是几月几号	七十五年正月二十六是几月几号
一到一百的英语序数词	一到五十的英语序数词
网易的股价	腾讯控股的股价
怀孕四十四天孕囊多大正常	怀孕四十二天孕囊多大正常
卢氏家族族谱字辈	萧氏家族族谱字辈
濮阳是哪个省	黑龙江是哪个省
十七岁可以办工行卡吗	十七岁可以办招行卡吗
安徽最好的骨科医院	江西最好的骨科医院
深圳到佛山动车	重庆到佛山动车
十五和二十一的公因数有几个	十二和二十一的公因数有几个
上海体育学院是几本	哈尔滨体育学院是几本
户胡镇有多少人口	筻口镇有多少人口
区号0五百三十九是哪个城市	区号0五百六十九是哪个城市
九百除八等几	九百除十等几
温州大学是本科还是专科	温州医科大学是本科还是专科
无锡到宁波的火车	无锡到济南的火车
中山发光字厂家	宜山发光字厂家
一百的质数	二十七的质数
爸爸去哪儿主题曲第一季	爸爸去哪儿主题曲第六季
十七和十四最大公因数	十一和十四最大公因数
卡罗拉一点两t和一点八哪个好	卡罗拉一点两t和一点五哪个好
厦门是不是一线城市	北京是不是一线城市
五百四十除五	五百四十除六
六月二十七日什么星座	六月十三什么星座
财通证券忘记资金账号	湘财证券忘记资金账号
六的繁體字	九的繁體字
黄山到重庆飞机票	黄山到济南飞机票
iphone七plus黑屏	iphone八plus黑屏
六十六年十二月二十一日生阳历是什么星座	六十七年十二月二十一日生阳历是什么星座
沈阳至海拉尔	沈阳至广州
北京到旅顺	北京到纽约
深圳有什么好玩的地方	衡阳有什么好玩的地方
山西师范大学是一本吗	陕西师大是一本吗
美国犹他州有几所大学	美国俄亥俄州有几所大学
合肥新闻电话	济南新闻电话
华电的双一流学科	清华的双一流学科
六和九公倍数	四和九公倍数
沈阳到东港多少公里	沈阳到厦门多少公里
十九年南京大学在安徽录取分数线	十九年南京大学在湖北录取分数线
沈阳位于中国的哪个方向	重庆位于中国的哪个方向
海淀公园可以搭帐篷吗	星海公园可以搭帐篷吗
三百六十八除七的竖式怎么列	四除七的竖式怎么列
惊蛰是几号	明天是几号
今年的天气为什么这么热	前几天的天气为什么这么热
建行如何缴纳违章罚款	农行如何缴纳违章罚款
四月十八日是什么星座	四月六日是什么星座
中梁镇属于哪个区	中国属于哪个区
河南到兰州多少公里路	湖北到兰州多少公里路
老是打嗝怎么办	偶尔打嗝怎么办
徐州哪个医院内科比较好	上海哪个医院内科比较好
三十二加九等	三十二加四十等
横县到桂林多少公里	横县到郑州多少公里
四十一除一千化成最简分数	四十一除六十化成最简分数
东北大学秦皇岛分校怎么样	秦皇岛宝岛妇产医院怎么样
八十年代十大名酒	六十年代十大名酒
苹果七什么时候上市	苹果八什么时候上市
五除十二乘六十	五除十二乘八
杭州什么整形医院好	德州什么整形医院好
五十一乘五十	五十一乘零
二千五百四十三大写	二千四百四十三大写
张嘉译的女儿叫什么	特朗普的女儿叫什么
五十四克除九等	五十四克除六等
瑞安到凯里汽车	瑞安到石家庄汽车
塘沽到白洋淀火车时刻表	石家庄到白洋淀火车时刻表
重庆师范大学考研复试时间	上海师范大学考研复试时间
定一个九点零五的闹钟	定一个五点零五的闹钟
王俊凯住哪儿	王凯住哪儿
上海到北京用不用隔离	沈阳到北京用不用隔离
东南大学qs排名二千零二十	江南大学qs排名二千零二十
海南岛到乌鲁木齐多少公里	黑龙江到乌鲁木齐多少公里
池州到绍兴	池州到广东
上海到哈尔滨的航班	上海到福州的航班
亳州到聊城多少公里	重庆到聊城多少公里
义乌至玉山高铁时刻表	北京至玉山高铁时刻表
怎样教三年级孩子写日记	怎样教二年级孩子写日记
西北大学考研专业课压分吗	广西大学考研专业课压分吗
十七路公交车站点	十五路公交车站点
天津又叫什么名字	石家庄又叫什么名字
广州哪里有衣服批发市场	昆明哪里有衣服批发市场
郑州到江西火车票	郑州到南昌火车票
潍坊有几个五a景区	沈阳有几个五a景区
宇智波带土厉害吗	宇智波鼬厉害吗
六个月婴儿可以吃乳钙吗	七个月婴儿可以吃乳钙吗
西安外事学院研究生录取名单	西安石油大学研究生录取名单
云南警官学院怎么样	南京审计学院怎么样
达州到通江县	达州到深圳
英文数字一减十二	英文数字一减六
大理到三亚机票多少钱	天津到三亚机票多少钱
山西人晚上吃什么饭	新疆人晚上吃什么饭
广东石子多少钱一吨	陕西石子多少钱一吨
六十五岁是哪年出生的	七十五岁是哪年出生的
遵化市医保中心电话	通化医保中心电话
宁波到贵阳长途汽车	杭州到贵阳长途汽车
哈工大附中地址	哈师大附中地址
如何加盟申通	如何加盟顺丰速运
五月二十九日是什么星座	五月四日是什么星座
宝鸡旅游景点排行榜	秦皇岛旅游景点排行榜
马梦唯是哪里人	马思纯是哪里人
汉中到天津飞机票	上海到天津飞机票
九十一年冬月初六是什么星座	九十二年冬月初六是什么星座
湖南城市学院改名	池州学院改名
七十一年属什么生肖配对	七十二年属什么生肖配对
十四是四的倍数吗	一是四的倍数吗
河南八年级什么时候开学	河南三年级什么时候开学
两和五的最小公倍数	两和十九的最小公倍数
羊水少是怎么回事	羊水多是怎么回事
十五岁今年生肖	十六岁今年生肖
润州区有几个街道	甘州区有几个街道
武汉都有哪些高校	石家庄都有哪些高校
郑州适合逛街的地方	济南适合逛街的地方
烟台离南昌有多远	烟台离广东有多远
南京到沙家浜多少公里	南京到武汉多少公里
r九splus多少钱	oppox九splus多少钱
伟易达怎么样	宏力达怎么样
北外四川录取分数线	上外四川录取分数线
河南理工大学会计学怎么样	河南工业大学会计学怎么样
十一除三分之一等多少	零除三分之一等多少
十八乘十八等多少	四乘十八等多少
巨力集团总部在哪里	谷歌总部在哪里
一个长方形的周长是六十	一个长方形的周长是一百
一百和三十六最大公因数	五和三十六最大公因数
一和九最大公因数	一和八最大公因数
八百d什么意思	三d什么意思
苹果八plus怎样设置id	苹果六plus怎样设置id
澳门五行属什么	河南五行属什么
南昌幼儿园收费标准	南宁幼儿园收费标准
成都到上海的动车	成都到临沂的动车
自贡公交卡充值点	赤峰公交卡充值点
十五点二十五英寸等多少厘米	二十五点二十五英寸等多少厘米
华润和华为哪个厉害	三星和华为哪个厉害
天津到昆明要多久	天津到广州要多久
呼兰河传第五章人物分析	呼兰河传第三章人物分析
新兴县在哪	新乡县在哪
南京晓庄学院美术生分数线	南京工程学院美术生分数线
vivoz三手机怎么样	vivox三手机怎么样
月经干净后第一天会排卵吗	月经干净后第六天会排卵吗
杭州东站到定安路	杭州东站到厦门
十八除五分之三等多少	六除五分之三等多少
北师研究生复试分数线	哈尔滨师范大学研究生复试分数线
十年网游小说排行榜	十一年网游小说排行榜
东方卫视女主持人名单	辽宁卫视女主持人名单
一bar等多少mbar	十bar等多少mbar
成都到缅甸机票	中国到缅甸机票
河南最好的三本排名榜	甘肃最好的三本排名榜
小米九怎么隐藏应用图标	小米六怎么隐藏应用图标
七十五除十二	七十五除四
现在流行什么颜色头发	以往流行什么颜色头发
五五险一金指什么	一五险一金指什么
鸡西到佳木斯火车时刻表查询	鸡西到北京火车时刻表查询
广益街道属于哪个区	中国属于哪个区
沈阳到北京高铁多长时间	西安到北京高铁多长时间
苹果手机用了一年发烫	苹果手机用了半年发烫
河南工业大学的分数线	西安工业大学的分数线
湖北人去广州打工要隔离吗	湖北人去福州打工要隔离吗
上海地区有哪些	广东地区有哪些
浙江到乌鲁木齐多少公里路	济南到乌鲁木齐多少公里路
七plus现在多少钱	八plus现在多少钱
十的两倍	八的两倍
三门峡至太原火车时刻表	杭州至太原火车时刻表
西安电线电缆厂家	天津电线电缆厂家
八十六年和九十年相配吗	八十六年和九十一年相配吗
爱情数字五千九百三十是什么意思	爱情数字五千九百六十是什么意思
中行理财产品	中信理财产品
太原哪家医院妇科比较好	长春哪家医院妇科比较好
四十除六十等多少	四十除三等多少
南方医科大学简称	南京医科大学简称
杭州高铁站附近有什么好玩的地方	南宁高铁站附近有什么好玩的地方
内蒙古的地理位置	湖北的地理位置
西北地区的河湖特征	日本的河湖特征
百字在田字格的写法	一字在田字格的写法
八十八年是什么生肖	八十九年是什么生肖
苏大放假时间二千零二十	贵大放假时间二千零二十
心跳一分钟九十正常吗	心跳一分钟五十正常吗
0二十一是哪的区号	0三百九十一是哪的区号
荣耀八的usb调试在哪	荣耀十的usb调试在哪
湖北美术学院就业前景	河北美术学院就业前景
红安建行网点	温州建行网点
八十二年十一点十九是什么星座	八十三年十一点十九是什么星座
顺丰从上海到新乡要多久	顺丰从郑州到新乡要多久
扬州人口二千零二十	中国人口二千零二十
张含韵是哪年出生的	张韶涵是哪年出生的
淮安到长春多少公里	成都到长春多少公里
岳阳至通城多少公里	岳阳至昆明多少公里
高压九十低压六十正常吗	高压一百低压六十正常吗
苹果se和十一那个好	苹果se和八那个好
利物浦大学离伦敦多远	爱丁堡大学离伦敦多远
星巴克是上市公司吗	阿里巴巴是上市公司吗
浙江到上海快递	云南到上海快递
西藏最重要的农业区	美国最重要的农业区
开封到聊城的火车	开封到北京的火车
西宁工务段段长	福州工务段段长
九十一年两月十五日阳历	九十二年两月十五日阳历
天津种一颗牙需要多少钱	南京种一颗牙需要多少钱
深圳至长沙火车票	深圳至洛阳火车票
深圳未来几天的天气	厦门未来几天的天气
skye什么意思	gode什么意思
三天不排便怎么办	五天不排便怎么办
广州哪个大学最好	长春哪个大学最好
五月二十日是什么星座	五月四日是什么星座
什么除五等四余什么	什么除七等四余什么
郑州到叶县汽车时刻表	郑州机场到叶县汽车时刻表
十四年网游小说排行榜前一百位	十五年网游小说排行榜前一百位
丹东到合肥多少公里	丹东到沈阳多少公里
沈阳和合肥哪个城市好	广州和合肥哪个城市好
广西大学二千零一十九复试名单	广西师范大学二千零一十九复试名单
一千的算术平方根是多少	一百的算术平方根是多少
西南财大好不好	西南民族大学好不好
五十乘六等多少	五十乘十五等多少
三点五乘零点四	三点六乘零点四
九十六除二	九十八除二
两天不睡觉会怎么样	三四天不睡觉会怎么样
历史上姓杨的名人	历史上姓倪的名人
农历二月十九出生的蛇	农历五月出生的蛇
到济南换乘需要隔离吗	到上海换乘需要隔离吗
合肥哪家医院男科好	昆明哪家医院男科好
五分之一的意义是什么	五分之八的意义是什么
八点八除零点二	八点四除零点二
溧阳县历任县长	昔阳县历任县长
陇东学院怎么样	肇庆学院怎么样
南航是国企吗	海航是国企吗
冀州市属于哪个市	镇江属于哪个市
炮兵学院分数线二千零一十九	新乡学院分数线二千零一十九
一分管外径	三分管外径
重庆的造句	济南的造句
山西师范大学研究生拟录取名单	江西师范大学研究生拟录取名单
圣诞节是几月几号	植树节是几月几号
vivoa七十九多少钱	vivoy七十九多少钱
安徽五百强企业名单	山西五百强企业名单
十一月一日是什么节日	十一月九日是什么节日
湖北工业大学研究生读几年	南京工业大学研究生读几年
今天回南京需要隔离吗	今天回成都需要隔离吗
天津那个站离飞机场近	成都那个站离飞机场近
湖北卫视新闻主持人名单	广东卫视新闻主持人名单
八的立方根是无理数吗	九的立方根是无理数吗
广西艺术学院二千零二十研究生复试名单	吉林艺术学院二千零二十研究生复试名单
苹果迷你五是什么处理器	苹果迷你四是什么处理器
从均值为μ一和μ两的两个总体中随机取两个大样本n>三十在α等零点零五的显著性水	从均值为μ一和μ两的两个总体中随机取两个大样本n>三十在α等零点零一的显著性水
十九年烟台大学录取分数线	十九年人大录取分数线
三月十六星座	三月十一星座
二十年陕西小学四年级什么时候开学	二十年安徽小学四年级什么时候开学
八十一和十五的最大公因数是多少	九和十五的最大公因数是多少
中国近代名将	中国现代名将
湖北电视台帮忙热线	浙江电视台帮忙热线
阳历九月三十号什么星座	阳历十月三十号什么星座
二十四小时多少分	八点一小时多少分
十九年清明节哪一天	二十年清明节哪一天
宿州到中山高铁时刻表查询	广州到中山高铁时刻表查询
王者二十赛季什么时候结束	王者七赛季什么时候结束
四十六乘十三	九乘十三
逢七过怎么玩	逢三过怎么玩
刘姓女宝宝起名	吴姓女宝宝起名
辽宁最大民营企业	湖北最大民营企业
扬子江药业核心产品	以岭药业核心产品
一除零	零除零
人流后十天出血量增多	人流后一周出血量增多
南昌到余干开车多久	南昌到北京开车多久
东北农大多少亩	山东农业大学多少亩
iphone八plus换屏幕	iphone七plus换屏幕
陕西那个医院看皮肤病好	山东那个医院看皮肤病好
九十二年劳动部长	九十三年劳动部长
哪个软件可以看湖南卫视的直播	哪个软件可以看浙江卫视的直播
广州火车站到驻马店	广州火车站到上海
苹果八plus是什么屏幕	苹果六plus是什么屏幕
广州到银川要不要隔离	广州到西安要不要隔离
二百五十乘三	二百五十乘六十
宝鸡早教机构有哪些	南通早教机构有哪些
大冶到广州大巴车	西安到广州大巴车
捷豹xfl降价	捷豹xel降价
庆安到南岔多少公里	庆安到北京多少公里
丹东到昆明	丹东到天津
一百乘五	一百乘一
焦作到青岛火车时刻表	焦作到杭州火车时刻表
中国佛教的四大名山	中国佛教的五大名山
宿州到龙川火车时刻表查询	宿州到上海火车时刻表查询
咸阳的地理位置	荥阳的地理位置
七百二十三除六等多少列竖式	七百二十三除八等多少列竖式
九十一年五月十三日生的人是什么命	九十二年五月十三日生的人是什么命
甘肃都包括哪些城市	黑龙江都包括哪些城市
大连医科大学是几本	北京医科大学是几本
四十岁动脉硬化	三十岁动脉硬化
南通到武汉的飞机	太原到武汉的飞机
怎么清理苹果十一内存	怎么清理苹果六内存
华东师大奖学金制度	华中师大奖学金制度
柳州画室排名前十位	厦门画室排名前十位
月经推迟七天能测出怀孕吗	月经推迟一天能测出怀孕吗
武汉比较有名的纹身店	北京比较有名的纹身店
八十一的倍数有哪些	七的倍数有哪些
长春中考各科时间	重庆中考各科时间
如何开启四g模式	如何开启五g模式
通化到干沟多少公里	通化到石家庄多少公里
十万英文怎么写	十亿英文怎么写
一米六十三的女生标准体重	一米七十三的女生标准体重
福州娱乐场所什么时候恢复营业	呼和浩特娱乐场所什么时候恢复营业
大庆唯美主邑二期怎么样	大庆唯美主邑三期怎么样
你和小一谁厉害	你和小布谁厉害
内蒙古到西安	内蒙古到广州
浙江到昆明火车票价格	重庆到昆明火车票价格
七是几分之几	零是几分之几
南阳理工世界排名	南理学院世界排名
甲功三项是什么	甲功五项是什么
南京医科大学读研怎么样	首都医科大学读研怎么样
六和二十三的最大公因数	二十一和二十三的最大公因数
荣耀九有录屏功能吗	荣耀八有录屏功能吗
月经完第六天会排卵吗	月经完第四天会排卵吗
像渐渐地这样的词有哪些	像慢慢地这样的词有哪些
南昌考驾照要多久	香港考驾照要多久
包头至西安飞机票	包头至成都飞机票
ipad二千零一十八怎么分屏	ipad三怎么分屏
七分之四除三	七分之四除六
深圳最近的天气怎么样	深圳以往的天气怎么样
九十九除七	九十九除五
高压一百五十四低压七十七正常吗	高压一百五十四低压一百零六正常吗
郫县有什么大学	南陵县有什么大学
索尼xperia一屏幕素质	索尼xperia五屏幕素质
一百和三十八的公因数	一百和四十八的公因数
北林研究生分数线	北化研究生分数线
五分之一乘四分之三	五分之一乘二分之三
从长春到延吉	从长春到杭州
德州到张家港有多少公里	连云港到张家港有多少公里
宝宝老是干呕怎么回事	宝宝偶尔干呕怎么回事
香港大学博士含金量	香港科技大学博士含金量
银川到绵阳多少公里	银川到济南多少公里
西游记三十六到四十回概括	西游记三十七到四十回概括
吉林到集安多少公里	北京到集安多少公里
oppi客服电话	oppo客服电话
上海工程技术大学是二百一十一吗	上海东华大学是二百一十一吗
德州到张家港有多少公里	南京到张家港有多少公里
二加三	二加二
虎门中心到西安中转	虎门中心到哈尔滨中转
五十二年的立春是几月几号以及什么时间	五十三年的立春是几月几号以及什么时间
k五是否支持五g	k七是否支持五g
阜阳离芜湖有多远	阜阳离长沙有多远
济南最宽的马路	郑州最宽的马路
幼儿数字八的正确写法	幼儿数字五的正确写法
中国有多少姓乔的人	中国有多少姓穆的人
莆田到郑州快递要多久	莆田到厦门快递要多久
八十七年腊月初十是什么星座	八十八年腊月初十是什么星座
湖南师大具体地址	海南师范大学具体地址
昆明至西安	长春至西安
好听的四个字名字	好听的六个字名字
深圳北到梧州	深圳北到钦州
南阳到合肥飞机票价	南阳到广州飞机票价
猎德村属于哪个区	中国属于哪个区
梅州有没有新型冠状病毒	中国有没有新型冠状病毒
上海卫视相亲节目	湖北卫视相亲节目
百分之一等多少克	百分之五等多少克
铜陵到宁国火车时刻表查询	铜陵到南昌火车时刻表查询
哈尔滨到济南快递	哈尔滨到东莞快递
陕西属于华北	山东属于华北
七十二年农历八月十八日什么星座	七十二年农历八月一日什么星座
南昌毕业生平均工资	长沙毕业生平均工资
二十人会议室面积	五十人会议室面积
二十年大连中考分数线	二十年广西中考分数线
镇江伊利牛奶代理商	马鞍山伊利牛奶代理商
七年级下册英语unit六重点短语	七年级下册英语unit九重点短语
华西医学院院长	包头医学院院长
二千零一十八江苏录取分数线	二千零一十七江苏录取分数线
陕西到广西多远	陕西到天津多远
重庆治疗胆结石最好的医院	哈尔滨治疗胆结石最好的医院
南普陀寺几点开门	白云寺几点开门
宁海县妇联地址	宁海县工商联地址
顺义最好的小区	香港最好的小区
南京的白酒	西安的白酒
陕西有哪个市	河南有哪个市
镇江到苏州多少公里	镇江到重庆多少公里
七十五乘一百零二	七十五乘四十
开封到青岛飞机	齐齐哈尔到青岛飞机
十月十八号的星座	十月十九的星座
西安工程大学是本科吗	南京信息工程大学是本科吗
寿光到潍坊大巴	寿光到潍坊机场大巴
江西财经大学改名	山东财经大学改名
八十七年腊月初十是什么星座	八十八年腊月初十是什么星座
九十七年农历三月二十七	九十七年农历三月二十九
无锡二十五路公交车路线	临沂二十五路公交车路线
盐城离无锡多远	盐城离青岛多远
身上莫名出现淤青怎么回事	身上经常出现淤青怎么回事
上海理工大学就业怎么样	南理工就业怎么样
八十八除九	八十八除八
六和十二最大的公因数是	十一和十二最大的公因数是
我现在的具体位置	我刚才的具体位置
砀山县海拔	平山县海拔
重庆治疗胆结石最好的医院	合肥治疗胆结石最好的医院
属牛九月份出生的命运	属牛十二月份出生的命运
七时等几日	五时等几日
三月三十一是什么节	三月八是什么节
苹果四手机主题怎么换	苹果六手机主题怎么换
a五的解锁方式	a八的解锁方式
商丘到无锡汽车	成都到无锡汽车
临汾到侯马多远	临汾到成都多远
厦门有什么大学	上海有什么大学
石家庄正规的整形医院	成都正规的整形医院
六除一点五等九分之几	一除一点五等九分之几
三月十八日是什么星座	三月九日是什么星座
河南科技大学是几本	辽宁科技大学是几本
南昌家具城在哪	许昌家具城在哪
0两年阳历九月十一什么星座	0两年阳历九月一日什么星座
海南特产水果	辽宁特产水果
合肥一中邮编	合肥师范学院邮编
法国总人口	越南总人口
数字九十代表什么含义	数字六代表什么含义
无锡到新沂大巴车	无锡到青岛大巴车
三百六十五乘八	零乘八
鞍山到吉林多少公里	鞍山到济南多少公里
四个月狗狗	四个半月狗狗
清明节是几月几号啊	清明节是五月几号啊
海林到柴河多少公里	海林到北京多少公里
怀孕三十二周胎儿体重	怀孕三十四周胎儿体重
二十年北方民族大学什么时候开学	二十年大连民族大学什么时候开学
孝感是地级市还是县级市	嘉峪关是地级市还是县级市
息屏时间设为三十分钟	息屏时间设为三十秒
餐后两小时血糖正常值	餐后一小时血糖正常值
梦见数字十二是什么意思	梦见数字一是什么意思
考湖北美术学院要多少分	考广州美术学院要多少分
从临沂到沂水多长时间	从临沂到青岛多长时间
a五的充电接口	a九的充电接口
长兴离芜湖有多远	长兴离南京有多远
韩国标准插头	印度标准插头
五百一十五除三的竖式	四除三的竖式
遵义医学院怎么样	新乡医学院怎么样
林书豪国籍	富兰克林国籍
池州到徐州火车时刻表	深圳到徐州火车时刻表
河南有口音吗	浙江有口音吗
拉萨现在发展得怎么样	南京现在发展得怎么样
十八年的贺岁电影有哪些	十九年的贺岁电影有哪些
五万一千立方厘米等多少升	七立方厘米等多少升
韩国和中国时差	韩国和朝鲜时差
天津六月一号骑电动车要戴头盔吗	南京六月一号骑电动车要戴头盔吗
菲律宾在哪个国家	印度在哪个国家
二千零二十温州高考时间	二千零二十浙江高考时间
泉州最好的皮肤医院	北京最好的皮肤医院
六用韩语怎么写	八用韩语怎么写
曲阜师范大学面积多少亩	南京师大面积多少亩
孕三十八周感觉不到胎动怎么回事	孕三十五周感觉不到胎动怎么回事
八十九年蛇属什么	九十年蛇属什么
五月十四生日是什么星座	五月十六生日是什么星座
昭通到喀什多少公里	昭通到昆明多少公里
南宁肺部检查哪个医院好	广州肺部检查哪个医院好
苹果十一有慢动作吗	苹果五有慢动作吗
江苏公务员面试后多久会通知结果	广东公务员面试后多久会通知结果
阳历七十三年一月九日是什么星座	阳历七十四年一月九日是什么星座
南京体育学院难考吗	西安体育学院难考吗
池州有多少人	纽约有多少人
鲁南制药待遇怎么样	联邦制药待遇怎么样
天津今年社保缴费基数	南京今年社保缴费基数
十九年三月十四号到今天多少天了	二十年三月十四号到今天多少天了
孕妇餐后两小时血糖正常值范围	孕妇餐后四小时血糖正常值范围
二千零一十九法拉利中国销量	二千零一十八法拉利中国销量
石家庄经济学院录取分数线	山东经济学院录取分数线
广汽传祺gm六油耗	广汽传祺gs六油耗
一百三十三开头的号码是哪里的	七开头的号码是哪里的
一到一百的单双数	一到二十的单双数
求几部小时候看过的动画片哈尔滨的九十五年以后电视上演过	求几部小时候看过的动画片哈尔滨的九十六年以后电视上演过
餐后两小时血糖正常值	餐后十小时血糖正常值
十四和九的倍数	九和九的倍数
石家庄多久开学	香港多久开学
沈阳几线城市	伦敦几线城市
邢台到大城多少公里	沧州到大城多少公里
营口旅游景点开放了吗	青岛旅游景点开放了吗
大连职业技术学院好不好	石家庄铁路职业技术学院好不好
五十三年七月十三日的星座	五十四年七月十三日的星座
江苏各市一季度gdp	广西各市一季度gdp
王荆公是个什么样的人	王昭君是个什么样的人
平安银行深圳网点	平安银行珠海网点
绵阳哪里好玩	瑞金哪里好玩
怀孕十九周尾椎骨疼	怀孕三十九周尾椎骨疼
杭州到安昌古镇多少公里	杭州到天津多少公里
怀孕六个月可以吃黄皮吗	怀孕八个月可以吃黄皮吗
最凶的五大星座	最凶的四大星座
河南节日习俗	青海节日习俗
滦县有平安银行吗	曹县有平安银行吗
九十八年六月初十是什么星座农历	九十八年七月初十是什么星座农历
如何从银行贷款六十万	如何从银行贷款四十万
慢慢同义词	忽然同义词
十八年的上半年有多少天	十九年的上半年有多少天
亳州到北京高铁	亳州到长沙高铁
濮阳到信阳多远	濮阳到北京多远
久治县的邮政编码是多少	天津的邮政编码是多少
苏州在山东的哪个方向	苏州在江西的哪个方向
陕西师大博士好考吗	华中师大博士好考吗
怀孕三个月可以做人流嘛	怀孕五个月可以做人流嘛
北京历史文化名城保护	中国历史文化名城保护
遵义到重庆大巴车时刻表	长沙到重庆大巴车时刻表
二十九楼为什么是黄金楼层	六楼为什么是黄金楼层
百度的股价	顺丰控股的股价
湖北有名人物	山东有名人物
老是拉肚子是怎么回事	偶尔拉肚子是怎么回事
温州商会会长是谁	浙江安徽商会会长是谁
成都至昆明动车时刻表	重庆至昆明动车时刻表
九十八年去年多大	九十八年明年多大
删除两点半的闹钟	删除两点的闹钟
长沙到安徽多少公里	长沙到湖北多少公里
河南到广西邮费多少	河南到武汉邮费多少
中午吃什么饭	早上吃什么饭
三大文明起源	四大文明起源
闽是哪个城市	滇是哪个城市
辽宁回上海要隔离十四天吗	河南回上海要隔离十四天吗
上海到温州的快递要多久	上海到江苏的快递要多久
一百二十乘二十	一百二十乘六
葫芦岛离大连多少公里	葫芦岛离西安多少公里
邢台到柳州的火车票	邢台到南昌的火车票
天津游乐场开了吗	南京游乐场开了吗
西藏好还是美国好	德国好还是美国好
三岁中性粒细胞百分比偏低	六岁中性粒细胞百分比偏低
邵阳到佛山	重庆到佛山
承德是哪个省的	青岛是哪个省的
上海到福州机票	上海到深圳机票
天津到白洋淀火车时刻表	天津到北京火车时刻表
吃甲硝唑三小时能喝酒吗	吃甲硝唑二十四小时能喝酒吗
石家庄至成都	昆明至成都
夏普二千六百四十八载体型号	夏普二千六百五十八载体型号
南京中医药大学二千零一十九研究生拟录取名单	清华二千零一十九研究生拟录取名单
北京至涟水机票	北京至青岛机票
三除两是整数吗	四除两是整数吗
吴江区行政级别	呈贡区行政级别
科比四偏码吗	科比九偏码吗
上海初中老师待遇	安阳初中老师待遇
巴东到广州	巴东到长沙
合肥最大的小区	武汉最大的小区
张家港个人征信报告去哪里打	湛江个人征信报告去哪里打
安庆到临安	安庆到云南
十的负四次方	十的负七次方
深圳怎么去澳门	深圳怎么去澳门机场
第六届矛盾文学获奖作品	第八届矛盾文学获奖作品
十减一	十减十
西安好的驾校有哪些	郑州好的驾校有哪些
离广东最近的草原	离广西最近的草原
平顶山学院有多少人	上海音乐学院有多少人
鼻子经常出血怎么办	鼻子偶尔出血怎么办
马云和李嘉诚谁更有钱	马云和特朗普谁更有钱
二十年贵阳普通话考试报名时间	二十年重庆普通话考试报名时间
十一月二十五是什么节日	十一月二十四是什么节日
英伟达显卡排名	nvidia显卡排名
西华师大属于哪个区	华师大属于哪个区
长江商学院知名校友	天津商学院知名校友
天津小区排行榜	天津区排行榜
血小板七十正常吗	血小板三十正常吗
怎么把圆分成二十等分	怎么把圆分成四等分
湛江有什么地方好玩	澳门有什么地方好玩
怀化学院在哪个区	池州学院在哪个区
宝宝老是干恶心怎么回事	宝宝偶尔干恶心怎么回事
西安到长沙开车多久	西安到兰州开车多久
扬州到贵阳火车票	长沙到贵阳火车票
四川是南方还是北方	山东是南方还是北方
黑龙江科技大学暑假时间	湖南科技大学暑假时间
十六加几等二十五	十三加几等二十五
海宁到东阳汽车站时刻表	海宁到济南汽车站时刻表
新疆有多少少数民族	内蒙古有多少少数民族
上海体育学院是几本	沈阳体育学院是几本
河北工程大学名人	河工大名人
福州经济适用房申请条件	温州经济适用房申请条件
南京今天天气怎么样	南京前几天天气怎么样
五月一日是什么星座	八月一日是什么星座
十月五日是什么星座	十月一日是什么星座
考湖北美术学院要多少分	考上海美术学院要多少分
苹果六可以越狱吗	苹果十可以越狱吗
银川到天水的火车时刻表	银川到北京的火车时刻表
十分之三	十分之一
沧州职业技术学院好吗	宁波卫生职业技术学院好吗
商丘师范学院院长级别	黄冈师范学院院长级别
aids是什么意思中文	bids是什么意思中文
王一博是谁	王彬彬是谁
长白山的景色	芦山的景色
鞍山师范学院怎么样	鞍山银行怎么样
经常打喷嚏是怎么回事	偶尔打喷嚏是怎么回事
吉林到石家庄多少公里	吉林到天津多少公里
兰州买第二套房有什么规定	南昌买第二套房有什么规定
皖南医学院分数线	海南医学院分数线
淮南师范学院返校时间	皖南医学院返校时间
湖北工业大学研究生读几年	湖南工业大学研究生读几年
柳州劳保工作服厂家	珠海劳保工作服厂家
哈尔滨师范大学排名全国第几	湖南师大排名全国第几
九十五年阴历是九月二十四的生日是什么星座	九十五年阴历是十月二十四的生日是什么星座
杨凌到西安的火车时刻表	杨凌到天津的火车时刻表
滁州至苏州高铁	西安至苏州高铁
最近头老晕是怎么回事	最近头有点晕是怎么回事
枣庄学院专科分数线	晋中学院专科分数线
甘肃空置房物业费收取标准	河北空置房物业费收取标准
西华师大属于哪个区	江西师范大学属于哪个区
十二和二十五最小公倍数是多少	十二和四最小公倍数是多少
攀枝花学院单招分数线	榆林学院单招分数线
七百六十除八的竖式怎么写	七百六十除七的竖式怎么写
云南有几个机场	宁夏有几个机场
江西有多少个飞机场	西藏有多少个飞机场
有的人只适合做朋友	有的人不适合做朋友
广东去重庆	陕西去重庆
云南有飞机场的城市	新疆有飞机场的城市
四十和七的最小公倍数是多少	四十和四十的最小公倍数是多少
金华二手市场在哪里	香港二手市场在哪里
西安隆胸需要多少钱	拉萨隆胸需要多少钱
空调一小时大概几度电	空调一天大概几度电
襄城县特产	虞城县特产
三十六乘二	三十六乘五
济南到拉萨飞机	济南到重庆飞机
潮州花鸟市场在哪里	鄂尔多斯花鸟市场在哪里
内蒙身份证前六位	湖北身份证前六位
西安怎么上车牌	重庆怎么上车牌
情人湾在哪里	月儿湾在哪里
连州房价最新消息	中山房价最新消息
石家庄到聊城几个小时	石家庄到上海几个小时
外地打哈尔滨长热线	外地打天津长热线
诸暨到温州火车	上海到温州火车
长沙火车站到临澧县火车站	长沙火车站到东莞火车站
八和二十五是互质数吗	八和三是互质数吗
漳州有个什么岛	重庆有个什么岛
五个月宝宝流鼻涕咳嗽怎么办	十月宝宝流鼻涕咳嗽怎么办
十五和九的最大公因数和最小公倍数	十五和七的最大公因数和最小公倍数
新开路属于哪个区	新源路属于哪个区
贵阳到宁波高速过路费多少	成都到宁波高速过路费多少
高血压三级症状	高血压二级症状
属鼠四月份出生的命运	属鼠三月份出生的命运
八的最小公倍数	五的最小公倍数
去年西安交大录取分数线	去年西南交大录取分数线
山西几天无新增病例	河北几天无新增病例
陕西师大收费标准	湖南师大收费标准
兰州吉他谱	贵阳吉他谱
九月九日忆山东兄弟诗意	三月九日忆山东兄弟诗意
石家庄客车时刻表	长春客车时刻表
宝马故障码二千七百九十六	宝马故障码二千七百八十六
苹果八plus换屏	苹果七plus换屏
十六岁女孩有狐臭怎么办	十二岁女孩有狐臭怎么办
二千零一十五的银行利率	二千零一十七的银行利率
沧县中学电话	夷陵中学电话
曼谷到南京机票	曼谷到郑州机票
a七十三耳机接口	a七十二耳机接口
龙江到大庆多远	上海到大庆多远
成都到武汉列车时刻表	成都到南宁列车时刻表
浙江信用社信用卡客服电话	海南信用社信用卡客服电话
oppo账号登陆不了	谷歌账号登陆不了
四除十五加一除十五	九除十五加一除十五
前几天的水果	今天的水果
猫一年没打疫苗	猫五年没打疫苗
十一月四日是什么星座	五月四日是什么星座
今天中午吃什么饭呢	今天下午吃什么饭呢
二千零二十湖南卫视电视新剧上映表	二千零二十浙江卫视电视新剧上映表
西北大学和宁大哪个好	西北师范大学和宁大哪个好
煤科院是干嘛的	军事科学院是干嘛的
女生为什么越来越敏感	女生为什么很敏感
二千零一十九肇庆中学中考录取分数线	二千零一十九春晖中学中考录取分数线
九十除八竖式	九十除五竖式
哥伦比亚大学世界排名qs	芝加哥大学世界排名qs
苏州科技大学研究生复试科目	天津科技大学研究生复试科目
工行上市价格	招行上市价格
十二除一点五	十二除二点五
广州到安庆物流专线	太原到安庆物流专线
为什么一千九百二十七年后推翻国民党成为中国革命的目标	为什么二十八年后推翻国民党成为中国革命的目标
云阳属于哪个市哪个省	濮阳属于哪个市哪个省
苹果七手机耗电突然变快	苹果六手机耗电突然变快
血压一百四十六除七十二正常吗	血压一百四十五除七十二正常吗
居然的近义词语	果然的近义词语
三分之一加二分之一	三分之一加三分之一
巴西淡水资源短缺的原因	中国淡水资源短缺的原因
某市工业企业十七年生产经营成果	某市工业企业十八年生产经营成果
全国有多少姓曹的	全国有多少姓胡的
五百四十除八等多少	八除八等多少
西湖大学研究生好考吗	山西大学研究生好考吗
人流后第五天有点出血正常吗	人流后第四天有点出血正常吗
襄阳哪里有卖床的	武汉哪里有卖床的
十九年中国人民公安大学研究生分数线	二十年中国人民公安大学研究生分数线
沈阳建筑大学几本	安徽建筑大学几本
九月的是什么座	十月的是什么座
华南农业大学参考书目	湖南农业大学参考书目
贵州旅游景点预约	山西旅游景点预约
山西财经大学二千零二十博士招生专业目录	西南财大二千零二十博士招生专业目录
荣耀十怎么显示步数	荣耀九怎么显示步数
安庆一中附近的学区房	同安一中附近的学区房
青岛和大连哪个好	青岛和长沙哪个好
云南会晒黑吗	海南会晒黑吗
考研英语一的新题型是什么	考研英语二的新题型是什么
海尔的广告词	百度的广告词
南京看癌症哪家医院好	重庆看癌症哪家医院好
云南师范大学是重点大学吗	湖南师大是重点大学吗
郑州哪里钓鱼好去处	南昌哪里钓鱼好去处
兴宁到河源火车时刻表	兴宁到厦门火车时刻表
餐后三小时血糖正常值	餐后一小时血糖正常值
沧州到许昌的火车票	武昌到许昌的火车票
连云港的市中心在哪里	香港的市中心在哪里
绵阳大还是成都大	深圳大还是成都大
洛阳到偃师怎么走	洛阳到重庆怎么走
七十四年正月二十六是几月几号	七十四年腊月二十六是几月几号
二分之一手机怎么打出来	四分之一手机怎么打出来
五字的硬笔书法	六字的硬笔书法
明天买什么股票	后天买什么股票
一加一等五什么意思	一加一等四什么意思
十八乘二十七	十一乘二十七
九千九百五十约等多少	一约等多少
广东面积有多少	美国面积有多少
云南艺术学院是本科吗	昆明艺术学院是本科吗
十三岁古语怎么说	十六岁古语怎么说
打了一针疫苗的猫会得猫瘟吗	打了三针疫苗的猫会得猫瘟吗
中国人民银行今日汇率	工行今日汇率
东南风四级怎么表示	东南风七级怎么表示
岳阳有几个五a景区	郴州有几个五a景区
月经推迟两天能不能测出怀孕	月经推迟三天能不能测出怀孕
0三年阴历三月十五是什么星座	0三年阴历八月十五是什么星座
剖腹产第七天可以吃虾吗	剖腹产第八天可以吃虾吗
绥中县有多少人口	日本有多少人口
温州寄快递到广东多少钱	温州寄快递到四川多少钱
七点二除零点零八	五点六除零点零八
哪个软件可以看湖南卫视的直播	哪个软件可以看江苏卫视的直播
son的中文意思	comeon的中文意思
七加三	七加八
杭州有多少市	香港有多少市
北京至长沙机票	广州至长沙机票
日本与中国的时差	以色列与中国的时差
咸阳有什么好玩的地方	瑞金有什么好玩的地方
滁州景点排名大全	合肥景点排名大全
孕妇三十三周有褐色分泌物	孕妇三十六周有褐色分泌物
无锡哪里办健康证	西宁哪里办健康证
山西预算定额	云南预算定额
无锡和哈尔滨哪个城市好	无锡和宁波哪个城市好
晋江市民政局局长	安宁市民政局局长
五除三分之四	四除三分之四
沈阳建筑大学几本	北京建筑大学几本
怀化学院在哪个区	嘉应学院在哪个区
k五支持的sim卡类型	k七支持的sim卡类型
贵州到天津飞机几个小时	贵州到郑州飞机几个小时
达州到广西	达州到上海
成都离青岛多少公里	合肥离青岛多少公里
阜阳到南通有多少公里	阜阳到长沙有多少公里
郑州到广元的高铁	郑州到重庆的高铁
成都到南充汽车票价	成都到重庆汽车票价
中原六大门派	中原八大门派
汇源破产了	微软破产了
五月三十日是什么星座	五月四日是什么星座
周杰伦在南京开过几次演唱会	周杰伦在太原开过几次演唱会
十一年二月多少天	十二年二月多少天
石家庄租房投诉电话	昆明租房投诉电话
徐州有什么好吃的	徐州东站有什么好吃的
西江大学好吗	西澳大学好吗
清朝入关后的第一个皇帝是谁	清朝入关后的第三个皇帝是谁
五除三百等多少	二百除三百等多少
春节由来五字	春节由来十字
r七的电话	徐的电话
石家庄社保卡电话	南昌社保卡电话
湖南大学二千零一十九江苏录取分数线	河南大学二千零一十九江苏录取分数线
曹云金身高	金钟云身高
西北师范大学冷门专业	江西师范大学冷门专业
顺丰到四川多少钱	顺丰到湖北多少钱
西安财经大学研究生考试科目	西安交大研究生考试科目
曹操专车郑州公司地址	曹操专车福州公司地址
昆明理工大学会计专硕学费	长春理工大学会计专硕学费
池州到大山村汽车时刻表	池州到上海汽车时刻表
沧州全国排名	荆州全国排名
十的八次方是多少亿	十的六次方是多少亿
一除十一	八除十一
三天不排便怎么办	八天不排便怎么办
如何一句话得罪三个人	如何一句话得罪四个人
血红蛋白低到八十怎么办	血红蛋白低到四十怎么办
九月九日是什么星座农历	三月九日是什么星座农历
小米mix两参数	小米max两参数
乌鲁木齐离婚律师哪个好	长春离婚律师哪个好
三的多少次方等四	三的多少次方等七
阳新到赣州火车时刻表	厦门到赣州火车时刻表
鲁滨逊漂流记电影九十六年版	鲁滨逊漂流记电影九十七年版
宝安机场到松岗有多远	宝安机场到深圳有多远
十二乘十三	十二乘十四
宁乡有哪些景点好玩	中国有哪些景点好玩
河北跨市需要隔离吗	安徽跨市需要隔离吗
石家庄生态门生产厂家	西宁生态门生产厂家
二十年正月初七是阳历的几月几号	二十一年正月初七是阳历的几月几号
上海卫视图标含义	浙江卫视图标含义
设置八点半闹钟	设置八点闹钟
好玩的arpg游戏	好玩的srpg游戏
心率五十正常吗	心率一百正常吗
东方卫视主持人	湖北卫视主持人
中通江苏到河北收费标准	中通江苏到陕西收费标准
成都夜市有哪些地方	济南夜市有哪些地方
乙肝表面抗体二十以上	乙肝表面抗体一千以上
小米九屏幕对比度	小米六屏幕对比度
一百和三十八的公因数	三十六和三十八的公因数
三百除四十	一百除四十
上外有交换生吗	上海交大有交换生吗
二十年四月份申报期限	二十年六月份申报期限
福建蔬菜种植基地	安徽蔬菜种植基地
福建有哪些历史人物	山西有哪些历史人物
怀孕三十一周可以吃榴莲吗	怀孕三十七周可以吃榴莲吗
换一颗牙齿要多少钱	换三颗牙齿要多少钱
宜宾内哪里好玩	乐清市内哪里好玩
二十年六月初二是几号	二十年五月初二是几号
承德距离邯郸多少公里	西安距离邯郸多少公里
呼和浩特离大同多少公里	贵阳离大同多少公里
济南大学有几个博士点	南昌大学有几个博士点
孕期餐后两小时血糖正常值	孕期餐后四小时血糖正常值
北京科大录取分数线二千零一十九	苏州科技大学录取分数线二千零一十九
花博园门票	厦门园博园门票
南昌到咸阳飞机票	南昌到西安飞机票
孕妇梦见自己已经生了	孕妇梦见自己马上生了
二十年内蒙古三支一扶报名时间	二十年辽宁三支一扶报名时间
济南到拉萨飞机	西宁到拉萨飞机
抚州到赣州多少公里	抚州到西安多少公里
厦门地理位置	厦门北站地理位置
山西中医学院录取分数线二千零一十九	晋中学院录取分数线二千零一十九
昆山到邳州的火车	昆山到兰州的火车
怀孕三天能不能测出来	怀孕七天能不能测出来
洛阳到新蔡县多少公里	洛阳到合肥多少公里
昆山到涡阳的火车	无锡到涡阳的火车
杭州到黑龙江快递	杭州到香港快递
日本国旗叫什么	加拿大国旗叫什么
苹果六空间不足怎么清理	苹果七空间不足怎么清理
南京二手电脑回收价格	武汉二手电脑回收价格
华南师大十九年美术类录取分数线	华中师大十九年美术类录取分数线
美国好的高中	加拿大好的高中
九十年流行歌曲	九十一年流行歌曲
央音名人	天津音乐学院名人
大围山的历史	鲁山的历史
二百六十五大写怎么写	二百六十四大写怎么写
九的倍数	六的倍数
沧县中学电话	赣县中学电话
现在从哈尔滨回西安需要隔离吗	现在从广州回西安需要隔离吗
云南还需要戴口罩吗	安徽还需要戴口罩吗
英语阳光评价答案四下	英语阳光评价答案六下
西安房价多少钱一平方	合肥房价多少钱一平方
南昌教育学院怎么样	南理学院怎么样
大英县到成都	香港到成都
福州房价降了吗	济南房价降了吗
零零年农历八月十四日是什么星座	零零年农历八月一日是什么星座
淄博有罗森便利店吗	宜宾有罗森便利店吗
北京城市学院大专分数线	北京服装学院大专分数线
从昆明到南京	从济南到南京
去金殿怎么坐车	去台湾怎么坐车
五十除二点二	五十除二点五
八月六是什么星座	八月二十二是什么星座
华东师大属于几本	山东师范大学属于几本
北京到辽源物流	北京到杭州物流
剖腹产可以生三胎吗	剖腹产可以生四胎吗
从郑州到深圳的火车票	从郑州到昆明的火车票
鸡西到呼和浩特	鸡西到合肥
湖南工业大学属于哪个区	西安工业大学属于哪个区
华为mate十如何设置指纹锁屏	华为mate八如何设置指纹锁屏
西安文科大学排名	西安文科类大学排名
汕头到南宁物流	汕头到济南物流
惠州二千零一十九gdp	莱州二千零一十九gdp
七十四年正月十九是几号	七十四年正月十三是几号
西安职工医保报销比例	天津职工医保报销比例
北大在中国排名第几位	清华在中国排名第几位
十四岁小孩月经不规律	十三岁小孩月经不规律
九十七年农历一月十八日阳历是多少星座呢	九十七年农历正月初一阳历是多少星座呢
八开头的网名两个字	九开头的网名两个字
总是打喷嚏是怎么回事	偶尔打喷嚏是怎么回事
韩国有君主立宪制吗	美国有君主立宪制吗
八十三乘五十五	八十三乘八
五千二百四十大写	五千二百二十大写
心率八十六正常吗	心率一百正常吗
惠州到衡阳火车票	南昌到衡阳火车票
尤溪一中分数线二千零一十九	莒南一中分数线二千零一十九
南京到太和高铁时刻表	南京到济南高铁时刻表
北师大研究生有宿舍吗	北大研究生有宿舍吗
十九年广州暑假放假时间表	二十年广州暑假放假时间表
顺丰空运上海到天津	顺丰空运广东到天津
济南哪里有温泉	成都哪里有温泉
赤峰教师资格证考试时间	杭州教师资格证考试时间
南京信息职业技术学院占地多大	湖南信息职业技术学院占地多大
十一和十二的最小公倍数	十一和七的最小公倍数
孕两个月可以做阴超吗	孕六周可以做阴超吗
一点五乘三	一点五乘五
贵阳八中在哪	株洲八中在哪
樟树到北京有多少公里	成都到北京有多少公里
哪里可以看湖南卫视直播	哪里可以看江苏卫视直播
麒麟九百九十与骁龙八百四十五哪个厉害	麒麟九百八十与骁龙八百四十五哪个厉害
九位数的电话号码	十四位数的电话号码
姚明多高	詹姆斯多高
六和十二的最大公因数最小公倍数	六和十五的最大公因数最小公倍数
广东到福建运费多少	云南到福建运费多少
包头医学院面积	齐齐哈尔医学院面积
长沙飞丽江机票	南宁飞丽江机票
七十九年gdp增长率	八十年gdp增长率
四川农大二十年什么时候开学	山西农业大学二十年什么时候开学
一百以内的加法和减法	十以内的加法和减法
二百八十除十二等多少	二百八十除七等多少
郑州妇幼和省妇幼哪个好	兰州妇幼和省妇幼哪个好
怎么查询建行信用卡额度	怎么查询农行信用卡额度
十九年十月搬家入宅吉日	二十年十月搬家入宅吉日
两个质数的和是十六	两个质数的和是四
印尼的钱叫什么	黎巴嫩的钱叫什么
一百二十八乘三	一百二十八乘二
成都体育学院院校代码	吉林体育学院院校代码
四十和十五的公因数	六和十五的公因数
河南师范大学招美术生吗	华南师大招美术生吗
烟台到徐州距离	西安到徐州距离
三月八英文	三月二十二英文
西江大学好吗	江西财经大学好吗
西华大学多少人	南华大学多少人
山东面积大还是四川面积大	湖北面积大还是四川面积大
什么软件可以看湖南卫视直播	什么软件可以看深圳卫视直播
手机为什么有时充不进去电	手机为什么一直充不进去电
一点四十五化成分数怎么化	零点四十五化成分数怎么化
一百二十除十五	一百二十除十八
广州有南山区吗	广州有南海区吗
许昌到巩义的汽车	许昌到郑州的汽车
辽宁师范大学历任校长	海南师范大学历任校长
南京今天天气怎样	南京明天天气怎样
把息屏时间调到一分钟	把息屏时间调到两分钟
九十三年nba总决赛比分	九十四年nba总决赛比分
五到六年级古诗	三到六年级古诗
数字六在田字格怎么写	数字七在田字格怎么写
上海到徐州的距离	上海到昆明的距离
山东猪肉价格走势	四川猪肉价格走势
芜湖到秦皇岛火车时刻表	芜湖到杭州火车时刻表
手机上怎么看湖南卫视的直播	手机上怎么看浙江卫视的直播
生肖三合是什么意思	生肖八合是什么意思
南京医科大学护理研究生好考吗	首都医科大学护理研究生好考吗
马鞍山哪里可以烧烤	包头哪里可以烧烤
商业贷款十万一年利息	商业贷款十万三年利息
防灾科技学院咋样	江西科技学院咋样
江苏大学生就业政策	黑龙江大学生就业政策
陕西师大收费标准	辽宁师范大学收费标准
三十的三倍是多少	一千的三倍是多少
六十五岁是几几年出生的	六十二岁是几几年出生的
姓臧的女孩名字	姓季的女孩名字
重庆到贵州的距离	成都到贵州的距离
宜春到临沂	宜春到南昌
上海财大上海分数线	西南财大上海分数线
六分之一加三分之一等几分之几	六分之一加七分之一等几分之几
青岛科技大学就业前景	江苏科技大学就业前景
松山湖歌尔电子厂地址	松山湖交警大队地址
常州离大同有多远	常州离重庆有多远
china是什么意思	chinese是什么意思
瑜伽三天断食排毒法	瑜伽七天断食排毒法
新疆艺术学院毕业要求	云南艺术学院毕业要求
平顶山学院有多少人	龙岩学院有多少人
盐山到烟台多少公里	重庆到烟台多少公里
昆明属于哪个省的	南昌属于哪个省的
苹果七大小	苹果九大小
雷克萨斯is二百价格	雷克萨斯es二百价格
陕西各区县gdp	河南各区县gdp
开封到芜湖的火车票	开封到北京的火车票
上海信访局地址	上海粮食局地址
摩尔定律即将失效	摩尔定律已经失效
辽宁工业大学书记	西安工业大学书记
惠州到衡阳火车票	惠州到石家庄火车票
怀孕三天能不能测出来	怀孕五天能不能测出来
浙江迁户口需要什么材料	湖北迁户口需要什么材料
天津的大学有哪些	济南的大学有哪些
设置一个半小时以后的闹钟	设置半小时以后的闹钟
松下洗衣机南宁售后服务电话	松下洗衣机西宁售后服务电话
山东政府工作时间	海南政府工作时间
低烧两天不退有危险吗	低烧一天不退有危险吗
湖南工程检测单位	辽宁工程检测单位
云南西部计划志愿者待遇	河南西部计划志愿者待遇
后天有风吗	明天有风吗
杭州林内售后电话四百减一百一十八减一千零八十一	重庆林内售后电话四百减一百一十八减一千零八十一
宝鸡的邮政编码	美国的邮政编码
数字三千三百七十五是什么意思	数字一是什么意思
上海到波士顿	上海到哥本哈根
0六年十月十九日是什么星座	七年十月十九日是什么星座
十五和十六的最大公因数是	十三和十六的最大公因数是
广西生猪肉价格今日价格	山西生猪肉价格今日价格
十九和七的最大公因数	十九和十八的最大公因数
这次疫情对上海房价的影响	这次疫情对中国房价的影响
国共第二次合作的标志是什么	国共第一次合作的标志是什么
一百八十乘三	一百八十乘十
溧阳到合肥多少公里	西安到合肥多少公里
宋庆龄哪里人	赵国庆哪里人
毕节到河南多少公里	毕节到安徽多少公里
红十字会的口号	红花会的口号
泸州有几家男科	三亚有几家男科
二十年两月四日农历	五月四日农历
七十寸电视多少瓦	二十寸电视多少瓦
北京到辽宁物流价格	成都到辽宁物流价格
四川户口迁移手续	安徽户口迁移手续
苹果八手机怎么激活	苹果六手机怎么激活
金华到温岭火车时刻表	金华到西安火车时刻表
二十年八月份出生的鼠宝宝起名	二十年七月份出生的鼠宝宝起名
三百一十五怎么读英语	二百一十五怎么读英语
洛阳师范学院专升本学费	商丘师范学院专升本学费
烟台一路公交车路线	邢台一路公交车路线
审协是干什么的	计生协是干什么的
开封到临汾火车时刻表查询	郑州到临汾火车时刻表查询
十三岁身高体重标准表	十二岁身高体重标准表
山西师范大学是双一流吗	山西财经大学是双一流吗
九价hpv疫苗多少钱	六价hpv疫苗多少钱
一个月有多少天	这个月有多少天
负三的立方根的绝对值	负七的立方根的绝对值
烟台至上海高铁时刻表	天津至上海高铁时刻表
art是什么意思	rtrt是什么意思
人体七大系统	人体八大系统
江苏卫视台长是谁	东方卫视台长是谁
八十三年几两命	八十四年几两命
山东选调生待遇	青海选调生待遇
大庆师范学院校长是谁	唐山师范学院校长是谁
大连医科大学学费	重庆医科大学学费
独龙江有什么鱼	黑龙江有什么鱼
盐城工学院怎样	河南工学院怎样
北医三院人流怎么样	北京地坛医院人流怎么样
绥化到嫩江	绥化到北京
广西机电好不好	广西大学好不好
白带特别黄是怎么回事	白带有点黄是怎么回事
新乡今天天气怎么样	新乡明天天气怎么样
舒张压低于六十的危害	舒张压低于二十的危害
大连到韩国机票多少钱	北京到韩国机票多少钱
郑州到济南飞机	郑州到东京飞机
三百二十乘五	三百二十乘四
呼和浩特到长沙的飞机票	昆明到长沙的飞机票
仙游的名胜古迹	香港的名胜古迹
深圳与厦门距离	深圳与东莞距离
二百六十万泰铢是多少人民币	一泰铢是多少人民币
十一年第四十周是几月几日	十二年第四十周是几月几日
四千八百六十六是什么意思	四千八百五十六是什么意思
餐后两小时血糖正常值	餐后五小时血糖正常值
河南博士人才引进政策	黑龙江博士人才引进政策
甘肃农业大学什么时候开学	新疆农业大学什么时候开学
科一可以考试了吗	科四可以考试了吗
南昌至无锡高铁时刻表	南昌至昆明高铁时刻表
内蒙古工业大学一本专业	内蒙古民族大学一本专业
海南特产水果	贵州特产水果
狮岭镇邮政编码	中国邮政编码
二十年东营有多少人口	二十年北京有多少人口
河北工程大学是二百一十一吗	西安空军工程大学是二百一十一吗
白鹿原小说描写田小娥	白鹿原小说描写小娥
四月十七星座	四月十六星座
十九年湖南高考本科录取率	十九年上海高考本科录取率
二十年湖南高考日期	二十年重庆高考日期
咸阳是哪个省哪个市	喀什是哪个省哪个市
华南属于什么地方	华东属于什么地方
沂水一中怎么样	临淄一中怎么样
吉林有哪些	内蒙古有哪些
金华到滁州多少公里	成都到滁州多少公里
求几部小时候看过的动画片哈尔滨的九十五年以后电视上演过	求几部小时候看过的动画片哈尔滨的九十六年以后电视上演过
哈工大有几个校区	哈工大附中有几个校区
十五乘十五	十五乘四百
十一月八日是星期几	十一月十八日是星期几
汕头到惠安有多少公里	汕头到襄阳有多少公里
一mm等几公分	一cm等几公分
苹果x和苹果六的充电器一样吗	苹果x和苹果七的充电器一样吗
河南福利彩票开奖结果	吉林福利彩票开奖结果
宜宾到重庆开车要多久	成都到重庆开车要多久
天津的大学有哪些	西青的大学有哪些
身体老是发麻	身体偶尔发麻
大连到重庆航班时刻表	大连到台北航班时刻表
五月一日出生是什么星座	五月四日出生是什么星座
无功补偿装置svg	无功补偿装置svc
北京卫视播出时间	安徽卫视播出时间
吴忠是哪个省	香港是哪个省
四百五十g是多少克	二百五十g是多少克
云南师范大学研究生补助	华中师大研究生补助
ln几等十	ln几等六
数字一千七百零八什么意思	数字十三什么意思
安徽特产茶叶	贵州特产茶叶
新干县有哪些乡镇	潢川县有哪些乡镇
福建能种芒果吗	甘肃能种芒果吗
二十四天来一次月经正常吗	四十五天来一次月经正常吗
澳门多大平方	台湾多大平方
十四岁脉搏正常范围	十五岁脉搏正常范围
十二岁的孩子发烧三十八度怎么办	十四岁的孩子发烧三十八度怎么办
长江商学院知名校友	上海商学院知名校友
北京联合大学二千零二十研究生复试名单	北京建筑大学二千零二十研究生复试名单
小布三加三	小布三加五
天津毕业生平均工资	成都毕业生平均工资
九字开头的吉祥成语	四字开头的吉祥成语
昆明九价宫颈癌疫苗多少钱	石家庄九价宫颈癌疫苗多少钱
济南回民中学升学率	济南舜耕中学升学率
哈尔滨到汉口火车	哈尔滨到厦门火车
九千九百九十九乘九十九等多少	八乘九十九等多少
一百零四除二十六等多少	八除二十六等多少
甘肃空置房物业费收取标准	浙江空置房物业费收取标准
为什么会经常头晕	为什么会有点头晕
北京到武清区高铁	北京到武汉高铁
西安到渭源	西安到成都
陕西放假安排	贵州放假安排
珠海是哪个省的	龙海市是哪个省的
三字的田字格写法	二字的田字格写法
衡水中学在哪	丽水中学在哪
夏津县是哪个市	滨海县是哪个市
三亚0九年房价	三亚十年房价
山东师范大学历史系分数线	山西师范大学历史系分数线
浙江快速接头生产厂家	吉林快速接头生产厂家
都以组什么词	只以组什么词
河西学院占地面积多少亩	皖西学院占地面积多少亩
汇率工行	汇率招行
如皋到南通多远	如皋到上海多远
上海理工大学就业怎么样	天津理工大学就业怎么样
新生儿一小时吃一次母乳正常吗	新生儿两小时吃一次母乳正常吗
二十八的因数有什么	六的因数有什么
永年二中怎么样	蚌埠二中怎么样
七除三分之一	七除九分之一
五什么什么的四字词语	三什么什么的四字词语
九十一除几等	四除几等
曲靖活动板房厂家	泸州活动板房厂家
移植第四天右边隐痛	移植第六天右边隐痛
umi手机价格	lmi手机价格
六和十二的最大公因数最小公倍数	六和十四的最大公因数最小公倍数
两尺五是多少cm	两尺六是多少cm
徐州工业学院怎么样	成都工业学院怎么样
西安建材市场在哪里	乌鲁木齐建材市场在哪里
庐山的来历	庐山瀑布的来历
九小时多少秒	三小时多少秒
哈工大多大	北大多大
七加两中六加一多少钱	九加两中六加一多少钱
山东的著名建筑	济南的著名建筑
石家庄哪里可以借钱	长沙哪里可以借钱
关闭二十点的闹钟	关闭十点的闹钟
零点六和零点六十五哪个大	零点六和零点一哪个大
三十三乘三	三十三乘二
今年什么生意好做	未来什么生意好做
云南特色小镇	河南特色小镇
心率一百一十正常吗	心率一百二十正常吗
元朝是公元前多少年	商代是公元前多少年
广州到涡阳火车时刻表	沈阳到涡阳火车时刻表
六十八除八	六十八除十七
三月三十日是星期几	三月一日是星期几
天津到成都的物流	北京到成都的物流
苹果三手机怎么解锁	苹果七手机怎么解锁
云南师范大学研究生在哪个校区	海南师范大学研究生在哪个校区
苏州各银行房贷利率	佛山各银行房贷利率
嘉应学院读几年	宜春学院读几年
一点七乘三	一点七乘四
肚子老是隐隐作痛	肚子有点隐隐作痛
糖尿病餐后两小时血糖正常值	糖尿病餐后四小时血糖正常值
莆田到盐城多少公里	广东到盐城多少公里
胎儿二十七周发育标准数值	胎儿三十六周发育标准数值
设置一个一点三十五的闹钟	设置一个五点三十五的闹钟
五月两日艺人	五月四日艺人
a十一如何设置volte	a九十一如何设置volte
二十年汕头幼升小报名时间	二十年上海幼升小报名时间
五加一	五加九
阳历六月份出生的是什么星座	阳历四月份出生的是什么星座
青岛有几个机场	延安有几个机场
第一天月经是黑色的	第五天月经是黑色的
苹果五原装耳机多少钱	苹果七原装耳机多少钱
现在去青海还要隔离吗	现在去四川还要隔离吗
玉林师范学院美术录取分数线	盐城师范学院美术录取分数线
浙江分数线高吗	云南分数线高吗
希腊的首都是哪	英格兰的首都是哪
蚌埠景点排行榜	澳门景点排行榜
八十乘七十	五十乘七十
保定人才落户政策	贵阳人才落户政策
一千九百一十五年是什么年代	一千九百一十六年是什么年代
经常干呕想吐是怎么回事	偶尔干呕想吐是怎么回事
南通到无锡要隔离吗	南通到苏州要隔离吗
a五十九什么时候上市	a七十九什么时候上市
一百八十乘三	一百八十乘四
九十一的因数是哪些	五的因数是哪些
科一考试能考几回	科三考试能考几回
八十九是多少元	一是多少元
华南农业大学退住宿费	中国农大退住宿费
临县计生办电话	郓城县计生办电话
三天大便一次正常吗	一天大便一次正常吗
血压一百零五减七十五	血压一百三十减七十五
二千零一十九奔驰e三百l报价多少钱	二千零一十七奔驰e三百l报价多少钱
周防雪子身高	周防身高
四百八十除九十六	四百八十除四
清华入取分数线	上海交大入取分数线
车晓彤年龄	车晓年龄
六百二十五开头的条形码是哪个国家	三开头的条形码是哪个国家
十一月二十五是什么节日	十一月二十三是什么节日
小孩无故发烧是怎么回事	小孩经常发烧是怎么回事
六和十二的最大公因数最小公倍数	九和十二的最大公因数最小公倍数
聊城到沈阳	聊城到滁州
二十五bar等多少兆帕	一千bar等多少兆帕
镇江到贵阳高铁时刻表查询	郑州到贵阳高铁时刻表查询
李鸿章是谁	查鸿章是谁
三月十八日是什么星座	三月一日是什么星座
快递广州到江西要多久	快递广州到郑州要多久
二十一年五一放假几天	二十二年五一放假几天
苹果七来电话闪光灯不闪	苹果十一来电话闪光灯不闪
日本大还是北京大	武汉大还是北京大
孕二十三周会出现胎儿缺氧吗	孕二十二周会出现胎儿缺氧吗
上海夏天气温	扬州夏天气温
本田urv价格	本田xrv价格
成都那做包皮手术好	重庆那做包皮手术好
成都到康县多少公里	成都到上海多少公里
凯里至铜仁高铁时刻表	凯里至济南高铁时刻表
五除十二乘六十	五除十二乘四
山西属于北方地区吗	浙江属于北方地区吗
双色球十八年历史开奖结果	双色球十九年历史开奖结果
山西名人多吗	江西名人多吗
孕三十九周想拉屎拉不出来	孕三十一周想拉屎拉不出来
十三用英语怎么读	十四用英语怎么读
十八韩元等多少人民币	四韩元等多少人民币
辽宁工业大学书记	北方工业大学书记
荣耀十支持多少瓦快充	荣耀九支持多少瓦快充
机智的医生生活第三集乐队唱的歌	机智的医生生活第四集乐队唱的歌
北京卫视节目表今天播	东方卫视节目表今天播
台湾至香港航班时刻表	台湾至广州航班时刻表
六月初两是什么星座	十二月初两是什么星座
今早的天气怎么样	明早的天气怎么样
科比和詹姆斯谁更强	乔治和詹姆斯谁更强
华东师大怎样	吉林师范大学怎样
西路军参谋长	八路军参谋长
西安外国语大学陕西分数线	西安外国语大学河北分数线
醴陵电视台台长	北京电视台台长
二千零一十九宁波社会平均工资	二千零一十九武汉社会平均工资
杭州今天有地震吗	苏州今天有地震吗
九字情侣网名	五字情侣网名
中国和俄罗斯的贸易	中国和朝鲜的贸易
上海到马德里的机票	上海到洛杉矶的机票
九十一年冬月初三是什么星座	九十二年冬月初三是什么星座
怀孕十天最明显的征兆	怀孕八天最明显的征兆
七月二十五日是什么星座	七月一日是什么星座
0八年是第几届奥运会	二百零九年是第几届奥运会
二十四号是好日子吗	二十二号是好日子吗
南京法官助理一般工资多少	南昌法官助理一般工资多少
沧县中学电话	慈溪中学电话
哈尔滨师范学院分数线二千零一十九	湖州师范学院分数线二千零一十九
西湖大学校长	西澳大学校长
华为mate十时间设置在哪里	华为mate二十时间设置在哪里
八月六是什么星座	八月十一是什么星座
如何用手机看湖南卫视直播	如何用手机看浙江卫视直播
云南民族大学属于几本	内蒙古民族大学属于几本
五开头的车架号是哪个国家	一开头的车架号是哪个国家
美国航天飞机有哪些	中国航天飞机有哪些
变兀森郁的意思	兀森郁的意思
河北中医院科室列表	河南中医院科室列表
广东有多少双一流大学	湖南有多少双一流大学
阜新到四平多少公里	阜新到成都多少公里
血压九万零一百三十正常吗	血压四十正常吗
再加三	再加二
上海到大连机票多少钱一张	上海到泰国机票多少钱一张
潍坊到安徽有多少公里	德州到安徽有多少公里
海南风景区有哪些景点	海口有哪些景点
北外比较文学考研	西安外国语大学比较文学考研
西峡到唐河火车时刻表	西峡到沈阳火车时刻表
重庆旅游景点	兰州旅游景点
呼市到集宁过路费多少钱	呼市到集宁高速过路费多少钱
浙江有什么好玩的地方	甘肃有什么好玩的地方
石家庄周边适合野餐的地方	重庆周边适合野餐的地方
合肥建材市场在哪里	西安建材市场在哪里
福建师范大学工资	山西师范大学工资
温州大学是本科还是专科	贵大是本科还是专科
直角的三分之一是多少度	直角的二分之一是多少度
成都到三沙	成都到台湾
十七和三十二的最大公因数	十七和八的最大公因数
长沙哪里最好玩	昆明哪里最好玩
上海骨科哪家医院好	成都骨科哪家医院好
常州健康证明怎么开	西安健康证明怎么开
昨晚睡不着怎么办	今天晚上睡不着怎么办
郴州在哪个省	鄂州在哪个省
民政局有哪些部门	环保局有哪些部门
在香港转机可以出机场吗	在成都转机可以出机场吗
昆明pos机代理商	福州pos机代理商
低压五十高压一百正常吗	低压五十高压六十正常吗
华为mate十pro屏幕尺寸	华为mate九pro屏幕尺寸
顺丰广西到四川	顺丰广西到云南
从常州到广德多远	从常州站到广德多远
贵阳到广州的高铁票	天津到广州的高铁票
江西电子商务专科学校排名	山东电子商务专科学校排名
北京到天安门的实际距离	北京到济南的实际距离
金立新款手机什么型号	华为新款手机什么型号
一米八床被套尺寸	一米五床被套尺寸
佛山出租车多少钱一公里	郑州出租车多少钱一公里
辽宁工业大学地址	天津工业大学地址
西安到尼泊尔机票多少钱	西安到香港机票多少钱
上海理工大学属于哪个街道	上海海洋大学属于哪个街道
安阳师范学院地址地图	洛阳师范学院地址地图
尤溪一中分数线二千零一十九	涉县一中分数线二千零一十九
苹果四手机开机密码忘了怎么解锁	苹果五手机开机密码忘了怎么解锁
唐河到驻马店多少公里	唐河到北京多少公里
孟津县怎么样	新津县怎么样
英语人教版选修六单词表	英语人教版选修九单词表
呼和浩特到长沙的飞机票	呼和浩特到重庆的飞机票
一百八十六是联通的吗	一百六十六是联通的吗
五十三的开方是多少	零的开方是多少
东北大学详细地址	北大详细地址
十三楼有蚊子吗	六楼有蚊子吗
鄂尔多斯到成都火车时刻表	宜昌到成都火车时刻表
苹果八plus通话没声音	苹果七plus通话没声音
属虎的住五楼好不好	属虎的住一楼好不好
为什么十四年除夕不放假	为什么十五年除夕不放假
宝鸡的邮政编码	重庆的邮政编码
来例假第一天能刮痧吗	来例假第四天能刮痧吗
西澳大学面积	温州大学面积
咸阳到宁夏多少公里	咸阳到广东多少公里
顺丰上海到昆明要多久	顺丰上海到贵阳要多久
今日纽约黄金价	今日纽约国际黄金价
月经推迟了两天能测出怀孕吗	月经推迟了三天能测出怀孕吗
x除七等三十五解方程	x除七等八解方程
邯郸到烟台有多少公里	南昌到烟台有多少公里
临沂到宜兴	贵阳到宜兴
长海医院体检套餐	上海医院体检套餐
成都的歌词	西安的歌词
罗马数字一到一千	罗马数字一到十
三百三十g等多少两	二百三十g等多少两
十一月二十号是星期几	十一月十号是星期几
申通和阿里的关系	腾讯和阿里的关系
为什么一千九百二十七年后推翻国民党成为中国革命的目标	为什么一千九百二十八年后推翻国民党成为中国革命的目标
梧州学院占地面积多少亩	许昌学院占地面积多少亩
悉尼大学研究生开学时间	耶鲁大学研究生开学时间
淮南到丽江	淮南到杭州
头孢二代抗生素有哪些	头孢一代抗生素有哪些
黑龙江名将	四川名将
石家庄奥迪四s店电话多少	长沙奥迪四s店电话多少
德清属于哪个区	德清站属于哪个区
重庆二手房首付几成	南昌二手房首付几成
十七岁月经不规律正常吗	十六岁月经不规律正常吗
沈阳到潍坊的机票	沈阳到澳门的机票
佛山到唐山	佛山到福州
西北大学行政管理考研分数线	山西大学行政管理考研分数线
二十五乘六	二十五乘八
湘潭到常州火车时刻表	湘潭到昆明火车时刻表
虎滩新区房价	虎石台房价
长春提取公积金条件	洛阳提取公积金条件
天水师范学院录取分数线二千零一十八	盐城师范学院录取分数线二千零一十八
湖南到衡阳多少公里	沈阳到衡阳多少公里
太行山出产什么石头	台湾出产什么石头
孕两个月可以做阴超吗	孕五十天可以做阴超吗
五点两乘十六	五点两乘十二
江西坐公交车要健康码吗	黑龙江坐公交车要健康码吗
广西艺术学院考研报录比	解放军艺术学院考研报录比
一百五十乘八	一百五十乘十二
三月宝宝感冒咳嗽鼻塞怎么治	三月三宝宝感冒咳嗽鼻塞怎么治
鼻子里偶尔有血丝是怎么回事	鼻子里老是有血丝是怎么回事
什么什么八脚	什么什么一脚
东京大学交换生项目	京都大学交换生项目
怀孕三十八天见红了怎么办	怀孕四十五天见红了怎么办
齐河到胶州多少公里	青岛到胶州多少公里
广州离肇庆有多远	广州离武汉有多远
四十七除七	四十七除四
二十一万五千零三是哪里的邮编	二十二万五千零三是哪里的邮编
四川选调生政策	广东选调生政策
北京到贵阳多少公里路	北京到沈阳多少公里路
西宁到陇南有多少公里	西宁到上海有多少公里
数字一百五十三是什么意思	数字八是什么意思
出生四十五天的小狗可以洗澡吗	出生十五天的小狗可以洗澡吗
惠州到商丘多少公里	南京到商丘多少公里
十六年巴西队阵容	十六年湖人阵容
六平的餐厅放多大的餐桌	十三平的餐厅放多大的餐桌
十万的计数单位是	一的计数单位是
梧州学院王牌专业	滁州学院王牌专业
沈丘到滁州高铁	上海到滁州高铁
北京到定州	北京到澳门
苹果手机耐用吗	华为手机耐用吗
十三岁孩子能不能用洗面奶	十四岁孩子能不能用洗面奶
十二乘三十六等多少	十二乘零等多少
济南有什么市花	广州有什么市花
四十五和六十的最大公因数	四十五和一百的最大公因数
三亚到崖城	三亚到台湾
北大招生分数线	复旦招生分数线
沈阳到东港多少公里	沈阳到香港多少公里
九十二年阴历六月十六日是什么星座	九十二年阴历六月四日是什么星座
合肥有哪些工厂	太原有哪些工厂
三除什么	八除什么
济南晚上值得去的地方	南宁晚上值得去的地方
太湖在哪个省	太湖湾在哪个省
上海交大和北大哪个好	上海交大和中大哪个好
中大专业排名	哈工大专业排名
日照到济宁客车时刻表	郑州到济宁客车时刻表
重庆北到十堰高铁	重庆北到兰州高铁
定个九点五十八的闹钟	定个十一点五十八的闹钟
衡阳值得去的地方	濮阳值得去的地方
历史上姓杨的名人	历史上姓丁的名人
孕十九周肚子不大正常吗	孕二十一周肚子不大正常吗
江西医学院排名多少	百度排名多少
怎样快速通过科目二	怎样快速通过科目三
七减五分之三	一减五分之三
涟水到常州多少公里	成都到常州多少公里
襄城县特产	赣榆县特产
常熟哪里有好玩的	延安哪里有好玩的
太原历史	太原南站历史
长沙玻璃桥旅游景点在哪里	重庆玻璃桥旅游景点在哪里
最近总是头晕	最近有点头晕
芬兰有红灯区吗	塞尔维亚有红灯区吗
株洲到祁阳的火车	株洲到福州的火车
一楼到五楼多少米	一楼到三楼多少米
为什么在四十九年十月一日开国大典的礼炮有二十八响还是五十四们齐发的	为什么在五十年十月一日开国大典的礼炮有二十八响还是五十四们齐发的
石家庄距离运城多少公里	重庆距离运城多少公里
科目二标准	科目三标准
长春到辽阳开车多长时间	长春到天津开车多长时间
亳州到漯河火车时刻表查询	亳州到上海火车时刻表查询
三十五和一千的最小公倍数	三十五和六十的最小公倍数
五和四十五最大公因数	五和二十五最大公因数
建行辞职流程	农行辞职流程
新西兰面积多少	澳门面积多少
哈尔滨到广东距离	哈尔滨到海南距离
临沂黄金回收价格	武汉黄金回收价格
苹果为什么不如华为	苹果为什么不如三星
贵州到天津飞机几个小时	贵州到成都飞机几个小时
一点二除零点五	零点二除零点五
定一个三点的铃	定一个四点的铃
德国首都是哪里	瑞士首都是哪里
涟源市属于哪个省哪个市	沽源县属于哪个省哪个市
河口县的邮政编码	湖口县的邮政编码
山东理工大学是几本	南理工是几本
洛阳到商丘的火车站时刻表	成都到商丘的火车站时刻表
四十六年一月政治协商会议通过了和平建国纲领和什么等协议	四十七年一月政治协商会议通过了和平建国纲领和什么等协议
四川的功效	蒙古的功效
苏州东环新村属于哪个区	苏州东环属于哪个区
连云港到遵义	连云港到成都
合欢四代技能	合欢三代技能
山西师范大学在全国的排名	西北师范大学在全国的排名
江苏都有哪些区	广东都有哪些区
鄂尔多斯到扎兰屯多少公里	鄂尔多斯到厦门多少公里
连云港至广州火车时刻表	连云港至银川火车时刻表
齐齐哈尔是在哪	嘉陵是在哪
八十一的倍数有哪些	六的倍数有哪些
延吉到唐山多少公里	南京到唐山多少公里
西峡到唐河火车时刻表	西峡到武汉火车时刻表
内蒙古到西安	新疆到西安
江西金氏来源	湖南金氏来源
大连新车在哪里上牌	成都新车在哪里上牌
十三岁男孩标准身高	十四岁男孩标准身高
广州到饶平高铁时刻表	广州到福州高铁时刻表
沙县是属于哪个省	中国是属于哪个省
荷兰说什么语言	埃及说什么语言
血压一百七十和一百	血压八十和一百
温州到赣州火车	温州到福州火车
二十年江苏考公务员考试报名时间	二十年辽宁考公务员考试报名时间
碧蓝航线五减四有什么船	碧蓝航线四减四有什么船
洛阳到重庆快递几天	洛阳到合肥快递几天
二十年的房价	二十年以后的房价
现在坐高铁去天津安全吗	现在坐高铁去济南安全吗
一百零一乘十一等多少	七乘十一等多少
乌鲁木齐欧马可四s店电话	石家庄欧马可四s店电话
十七年河北总人口	十八年河北总人口
唐山到平顶山多少公里	唐山到合肥多少公里
苹果七与电脑连接	苹果六与电脑连接
青岛农业大学是二百一十一大学吗	中国农大是二百一十一大学吗
今天到五月一日还有多少天	今天到八月一日还有多少天
南通在哪个省	焦作在哪个省
天津体育学院二千零二十考研分数线	上海体育学院二千零二十考研分数线
开封到镇江火车时刻表查询	开封到沈阳火车时刻表查询
0六百零六是什么星座	0六百一十六是什么星座
欧阳震华的电视剧	欧阳奋强的电视剧
三国志战略版张飞技能	三国志战略版乌飞技能
天津在哪里	天津机场在哪里
宁波到贵阳长途汽车	重庆到贵阳长途汽车
小肚子老是酸酸的怎么回事	小肚子有点酸酸的怎么回事
六月二十八日是什么星座	六月四日是什么星座
日照财政收入	邓州市财政收入
十二画属木的吉祥字	十四画属木的吉祥字
湖南最有钱的地方	浙江最有钱的地方
马皮镇有多少人口	南头镇有多少人口
济南回民中学升学率	郑州回民中学升学率
有关唐明皇的电视剧	有关李世明的电视剧
华夏航空安全吗	英国航空安全吗
十八年上映科幻电影	十九年上映科幻电影
浙江工业大学有哪些专业	河南工业大学有哪些专业
鹤壁到义乌高铁	鹤壁到济南高铁
日喀则到叶城多少公里	武汉到叶城多少公里
包头医学院面积	昆明医学院面积
三百除四十等多少	八十除四十等多少
辽宁能种榴莲吗	浙江能种榴莲吗
云南名人有哪些	黑龙江名人有哪些
俄罗斯的出海口有哪些	中国的出海口有哪些
三天没有大便了怎么办	五天没有大便了怎么办
经常咳嗽怎么办	偶尔咳嗽怎么办
三位数是什么位	九位数是什么位
欧洲的美景	日本的美景
福建属于哪个省管	青海属于哪个省管
四百九十五除六等多少	六除六等多少
四十二乘十九约等多少	四十二乘三约等多少
无锡周边景点	南宁周边景点
七十四年正月十三是什么星座	七十五年正月十三是什么星座
英文数字一减十二	英文数字一减五
河南师范大学招美术生吗	河北师范大学招美术生吗
三月二十二日是什么星座	三月九日是什么星座
利辛万达广场在哪里	香港万达广场在哪里
湘潭大学十二年分数线	湘潭大学十三年分数线
虹桥中学招生办电话	合川中学招生办电话
安徽哪里产盐	广西哪里产盐
十六和二十四的最大公因数是	十六和二十五的最大公因数是
德州电话区号	香港电话区号
双十一是几月几日	星期一是几月几日
离兰州一百公里的地方	离昆明一百公里的地方
五月十三翻译	五月十二翻译
江苏在安徽的哪边	广东在安徽的哪边
顺丰到四川多少钱	顺丰到河南多少钱
桂林男性医院排名	沈阳男性医院排名
一百三十二除六	一百三十二除十二
荣耀三十指纹怎么设置	荣耀九指纹怎么设置
疫情五月份办婚礼需要延期吗	疫情六月份办婚礼需要延期吗
罗马数字一到一千	罗马数字一到四十
吃头孢后六小时我喝酒了	吃头孢后二十小时我喝酒了
恩施市落户政策	中国落户政策
距离保护一段	距离保护三段
哈工大附中地址	哈工大地址
欧阳震华的电视剧	欧阳飞燕的电视剧
深圳去中山要多久时间	佛山去中山要多久时间
十一年君越怎么样	十二年君越怎么样
日照在哪个省	福州在哪个省
四十二个十是什么	四十二个百是什么
南宁皮卡限行规定	洛阳皮卡限行规定
取消六点三十分的闹钟	取消十六点的闹钟
农历六月十四是几月几日	农历六月六是几月几日
十bit是什么意思	十px是什么意思
三十五和一千的最小公倍数	三十五和五的最小公倍数
十二画属木的吉祥字	十八画属木的吉祥字
cctv十七广告多少钱	cctv一广告多少钱
二千零一十九生鲜超市补贴标准	二千零一十八生鲜超市补贴标准
七十三年五行属啥	七十四年五行属啥
济南到合肥高铁时刻表查询	上海到合肥高铁时刻表查询
山东卫视播放过的电视剧	湖南卫视播放过的电视剧
怀孕一个月可以打胎么	怀孕一周可以打胎么
北大二千零一十九专业分数线	西北大学二千零一十九专业分数线
上海自驾到千岛湖	上海自驾到天津
八减六	六减六
二十八乘一百	二十八乘十五
首都医科大学预防医学考研分数线	哈尔滨医科大学预防医学考研分数线
上海到西藏的机票	上海到杭州的机票
oppo十七屏幕价格	r十七屏幕价格
二千六百五十立方厘米等多少毫升	二千六百七十立方厘米等多少毫升
十四和二十八的最大公因数是多少用短除法	十四和二十一的最大公因数是多少用短除法
甲状腺过氧化物酶抗体大于一千三百	甲状腺过氧化物酶抗体大于零
时针从十二走到六走了几小时	时针从十二走到三走了几小时
十八年证券公司排名	十九年证券公司排名
欧洲的美景	中国的美景
北京协和医院多少人	北京联合大学多少人
现在广州可以回安徽吗	现在广州可以回深圳吗
西安到稻城多少公里	长春到稻城多少公里
北京到威尼斯机票	北京到大阪机票
四十一年什么年	四十二年什么年
一百三十乘十等	五乘十等
一分钟英文	四分钟英文
济南住房贷款政策	合肥住房贷款政策
蚌埠到潍坊高铁	北京到潍坊高铁
滨州到德州的火车时刻表	成都到德州的火车时刻表
两尺四是多少码的裤子	两尺五是多少码的裤子
北大二千零二十考研分数线	哈工大二千零二十考研分数线
天津下雨了吗	西青下雨了吗
pench什么意思	panch什么意思
南京在北京的什么方向	哈尔滨在北京的什么方向
九价一共多少钱	二价一共多少钱
八的平方	一的平方
销售六大原则	销售七大原则
三十二加二十等多少	九加二十等多少
a九十二s支持息屏显示吗	s九十二s支持息屏显示吗
鄱阳县开学时间	濮阳县开学时间
拉萨小姐联系方式	武汉小姐联系方式
昆明到新余多少公里	昆明到重庆多少公里
云南是西方吗	台湾是西方吗
时刻造句一年级一句话	立刻造句一年级一句话
海门到金华汽车时刻表	南京到金华汽车时刻表
山西师范大学编号	赣南师范大学编号
内蒙古民族大学多少分	广西民族大学多少分
灵魂摆渡一第四集演员表	灵魂摆渡一第九集演员表
科目二脚下动作	科目三脚下动作
安岳哪里有鸡	泰安哪里有鸡
西安三大怪	西安七大怪
北京到天津专线物流	沈阳到天津专线物流
广发证券用户数量	广发用户数量
南京现在天气怎么样	南京将来天气怎么样
西安至武威物流	西安至重庆物流
十五乘九等多少	十五乘十五等多少
广安到正定的火车票	石家庄到正定的火车票
0九百九十一是哪里的区号	0九百九十九是哪里的区号
月经干净后第五天又出血是怎么回事	月经干净后一周又出血是怎么回事
成都四月份天气温度	成都八月份天气温度
北京卫视节目表今天播	山西卫视节目表今天播
三月二十日是什么星座	三月九日是什么星座
新车第二年需要做什么	新车第一年需要做什么
江西生小孩报销比例	云南生小孩报销比例
三和一的最大公因数	八和一的最大公因数
莘松八村房价	日本房价
遵义到重庆动车时刻表	长沙到重庆动车时刻表
海南有什么好吃的美食	江西有什么好吃的美食
渠县到贵阳有多少公里	道县到贵阳有多少公里
南理工分数线	南理分数线
rvv电缆厂家	kvv电缆厂家
一百万大写怎么写	一亿大写怎么写
五十二岁的女明星有哪些	五十四岁的女明星有哪些
八十九年是不是闰年	九十年是不是闰年
几乘几等一百零五	几乘几等九
南京离仪征市多少公里	南京离合肥多少公里
鹦鹉花园属于哪个社区	海滨花园属于哪个社区
贵州女人怎么样	广西女人怎么样
十九年茂名gdp	二十年茂名gdp
一年的公鸡能吃吗	七年的公鸡能吃吗
浙江卫视第几频道	东方卫视第几频道
大连到朝阳快递几天	大连到福州快递几天
韩国gmarket会卖假货么	韩国街gmarket会卖假货么
月经推迟七天了怎么办	月经推迟九天了怎么办
八十四年的是什么命	八十五年的是什么命
云南师范大学研究生学费多少钱	南京师大研究生学费多少钱
喝了咖啡反而困	喝了咖啡有点困
十月初十出生的是什么星座	九月初十出生的是什么星座
hpv四价	hpv八价
中国邮政入职体检标准	中行入职体检标准
平顶山到正阳	平顶山到深圳
南充到济南汽车站时刻表	北京到济南汽车站时刻表
天津到长春飞机时刻表查询	太原到长春飞机时刻表查询
三乘九	九乘九
怀孕十三周胎盘低	怀孕三十三周胎盘低
八十一年有哪些国产电影	八十二年有哪些国产电影
幽门螺旋杆菌三联副作用	幽门螺旋杆菌四联副作用
嘉兴到淮南的火车时刻表	南昌到淮南的火车时刻表
北京舞蹈学院要多少分才能考上	北京服装学院要多少分才能考上
经常咳嗽有痰	偶尔咳嗽有痰
西安十九年降温费发放标准	西安二十年降温费发放标准
西安属于哪个省的	银川属于哪个省的
深圳到九江的火车票	无锡到九江的火车票
微信号怎么才能修改第二次	微信号怎么才能修改第一次
顺德区那里好玩的地方	奉贤区那里好玩的地方
贵州旅游景点预约	四川旅游景点预约
小米八手机换电池教程视频	小米五手机换电池教程视频
小李云凯的扮演者	李云凯的扮演者
率土之滨三赛季九级地难度表	率土之滨一赛季九级地难度表
福建距离山东	四川距离山东
广州到西安的机票	昆明到西安的机票
湖北去江西需要核酸检测吗	湖北去杭州需要核酸检测吗
增值税税率为十六的有哪些	增值税税率为十三的有哪些
中国农大浙江录取分数线	中国农大广西录取分数线
华中科大本科分数线	湖南科技大学本科分数线
徐州到咸阳	徐州到上海
华理哪个区	成都理工大学哪个区
第三轮生肖小本票价格	第二轮生肖小本票价格
成都健身房开门了吗	西安健身房开门了吗
二十七周胎儿腿短怎么办	二十四周胎儿腿短怎么办
绥德到横山火车时刻表	绥德到青岛火车时刻表
股票前加dr是什么意思	股票前加xr是什么意思
一百六十乘五十	一百六十乘八十
咸阳有什么好玩的地方	喀什有什么好玩的地方
安徽高考录取分数线二千零一十八	安徽高考录取分数线二千零一十四
六的拼音和组词	三的拼音和组词
沛县到珠海多少公里	成都到珠海多少公里
聂慎儿怎么死的	聂小倩怎么死的
东刘村在哪里	江东村在哪里
流产二十天了可以出门了吗	流产十五天了可以出门了吗
安徽代表团名单	陕西代表团名单
芦潮港在哪里	湛江港在哪里
隆回一中中考录取分数线	怀柔一中中考录取分数线
《西游记》第一回主要内容	《西游记》第八回主要内容
湖南教师资格证考试时间二十年	吉林教师资格证考试时间二十年
心率五十正常吗	心率一百四十正常吗
减肥期间太饿	减肥期间不饿
十分之四等什么	十分之六等什么
湖北人现在去广东要隔离吗	湖北人现在去福建要隔离吗
海大什么专业最好	渤海大学什么专业最好
几除几等零	几除几等二十
郑州五中位置	衡水五中位置
呼和浩特路灯厂家	郑州路灯厂家
郑州至攀枝花火车时刻表	南京至攀枝花火车时刻表
一到一百的序数词怎么读	一到十二的序数词怎么读
三月二十七日是什么星座	三月九日是什么星座
六和十五的公倍数是	六和九的公倍数是
咸丰庚午年是哪一年	咸丰庚辰年是哪一年
五十加六十	六十加六十
黄土高原水土流失严重吗	云贵高原水土流失严重吗
消消乐一千二百一十九关怎么过	消消乐一千四百一十九关怎么过
兰州天气怎么样	柳州天气怎么样
八分之五减八分之一	八分之五减三分之一
贵州有没有三甲医院	山西有没有三甲医院
二千零二十广东放假	二千零二十浙江放假
国信证券是国企吗	中信证券是国企吗
福彩三d六百九十二出现的前后关系	福彩三d六百九十一出现的前后关系
山水集团现状	古井集团现状
淄博到合肥多少公里	淄博到洛阳多少公里
八和十二的倍数是多少	八和九的倍数是多少
左眼零点八右眼零点三是多少度	左眼零点四右眼零点三是多少度
青岛到哈尔滨多少公里	青岛到郑州多少公里
江苏信息职业技术学院怎么样	山东信息职业技术学院怎么样
三百四十五是勾股数吗	二百四十五是勾股数吗
石家庄高铁站是南站还是北站	贵阳高铁站是南站还是北站
上海海关周末上班吗	深圳海关周末上班吗
一千的算术平方根是多少	五的算术平方根是多少
八十二年的狗二十二年运势	八十二年的狗二十三年运势
岳丽娜身高体重	古丽米娜身高体重
浙江卫视第几频道	湖南卫视第几频道
二十六乘十四	二十六乘十九
南宁酒吧排名第一	南京酒吧排名第一
海淀公园好玩吗	西海子公园好玩吗
从中国到美国有多远	从英国到美国有多远
昌乐名胜古迹有哪些	日本名胜古迹有哪些
皮肤经常过敏怎么办	皮肤偶尔过敏怎么办
哈尔滨到威海客车	哈尔滨到重庆客车
安阳东到兰州西高铁	成都到兰州西高铁
七月与八月中国有哪些节日	七月与五月中国有哪些节日
唐山到宁波飞机票多少钱	西安到宁波飞机票多少钱
农历四月十五的月相	农历四月的月相
朱颜的古诗	朱的古诗
成都月平均工资	济南月平均工资
早上吃什么饭	晚上吃什么饭
遵义医学院全国排名	复旦医学院全国排名
曲阳县城房价	阳曲县城房价
设置六点半的闹钟	设置十六点半的闹钟
两百除五	两百除四
六千二百欧元等多少人民币	零欧元等多少人民币
武夷山位于哪个省份	北京位于哪个省份
吉林农业大学是几本	东北农大是几本
苏州到镇江高铁	苏州到沈阳高铁
三千六百除二十五乘四	一除二十五乘四
根号十五	根号十八
山西地标	江西地标
酒泉到高台多少公里	酒泉到西安多少公里
七十二乘一千	七十二乘六十
一又二十分之九化成小数	四又二十分之九化成小数
赣南医学院多大	南昌工程学院多大
小凤你在哪里	小小小你在哪里
喀什有中医院吗	扬州有中医院吗
包头到献县多少公里	包头到昆明多少公里
武功山在哪儿	兰山在哪儿
七十除三十五等	五除三十五等
几除几等零	几除几等九
佑安医院专家	潞河医院专家
五个月宝宝发烧怎么办	七月宝宝发烧怎么办
南宁素描培训班价格	成都素描培训班价格
盘锦到吉林	盘锦到香港
芜湖县劳动监察大队电话	芜湖县人民法院电话
人大考博难度	中央民大考博难度
新疆到丽江	新疆到香港
十月一还有几天	十月初四还有几天
凤凰城的夜景描写	凤凰古城的夜景描写
苹果八plus黑屏	苹果六plus黑屏
西安离泰山有多远	西安离昆明有多远
咸宁到北海高铁时刻表	南京到北海高铁时刻表
华东政法大学山西录取分数线	华东政法大学福建录取分数线
三月八英文	三月十三英文
达溪镇邮编	灵溪镇邮编
三月一是什么星座	三月六是什么星座
二十二周可以做四维彩超吗	二十一周可以做四维彩超吗
怀孕三个月可以做人流吗	怀孕二个月可以做人流吗
演员的诞生第三期	演员的诞生第五期
一千九百九十一农历九月初七	一千九百九十一农历十月初七
上海大众在哪里	上海海洋大学在哪里
六百一十九除五	六百一十九除三
八千零七十七什么意思	八千零八十七什么意思
深圳到冠豸山动车时刻表	深圳到佛山动车时刻表
四十五乘九	四十五乘二
湖北有什么特产	天门有什么特产
安徽五一出行政策	山西五一出行政策
西湖区属于什么街道	西城区属于什么街道
数字十一的含义	数字十二的含义
石家庄有啥山	太原有啥山
湛江有什么好吃的	酒泉有什么好吃的
一百个里面有多少个五	一百个里面有多少个八
苹果手机和华为手机哪个好	苹果手机和谷歌手机哪个好
北京到柴沟堡火车时刻表	北京到郑州火车时刻表
沈阳建筑大学几本	沈阳药科大学几本
有时胸闷气短是怎么回事	经常胸闷气短是怎么回事
周伯通怎么死的	周敦颐怎么死的
富阳到开封高铁	上海到开封高铁
环保局和审计局哪个好	城建局和审计局哪个好
形容声音不清晰	形容声音很清晰
南京林业大学开设专业	南理工开设专业
简爱十四章内容概括	简爱十一章内容概括
南京林业大学研究生复试时间	南京工业大学研究生复试时间
南京哪里可以领养狗狗	郑州哪里可以领养狗狗
k一是否支持防抖	k七是否支持防抖
大写的八怎么写	大写的四怎么写
墨西哥换人民币	香港换人民币
天津至威海飞机时刻表	天津至长沙飞机时刻表
鹤壁到义乌高铁	鹤壁到长沙高铁
两尺四是多少码的裤子	两尺九是多少码的裤子
鸡西到呼和浩特	鸡西到西安
香港和上海哪个大	台北和上海哪个大
深圳属于广东吗	深圳属于湖北吗
四川是属于哪方	广东是属于哪方
二十一乘三	二十一乘四
零点二五乘八	零点二五乘四
张家口历任市长	江阴历任市长
广东的大学排名	海南的大学排名
缅甸沿海吗	葡萄牙沿海吗
二十五周宝宝双顶径标准值	二十八周宝宝双顶径标准值
昆明理工大学院系设置	南理工院系设置
总是胸闷喘不上气	偶尔胸闷喘不上气
三十乘二十四	五十乘二十四
八月十日什么星座	三月八日什么星座
山东有什么山	广东有什么山
合肥学院好不好	毕节学院好不好
农行四川分行地址	工行四川分行地址
一百四十乘七	一百四十乘二十
沈阳什么地方好玩	重庆什么地方好玩
温岭到西安汽车	温岭到广州汽车
五纳米等多少米	一纳米等多少米
零点七乘零点五	零点五乘零点五
钢铁是怎样炼成的第五章好词好句	钢铁是怎样炼成的第七章好词好句
在第一天用英语	在第三天用英语
九十二年九月初四是什么星座	九十二年九月初一是什么星座
人大从政的多吗	法大从政的多吗
镇江市长是谁	香港市长是谁
同仁医院排名	同济医学院排名
武警工程大学十八年录取分数线	武警工程大学十九年录取分数线
广州在天津的哪个方向	广州在长沙的哪个方向
姓名学十四画的字	姓名学十九画的字
乙肝五项二四五阳性什么意思	乙肝五项二三五阳性什么意思
宁波属于哪个省	杭州属于哪个省
上海到甘肃火车	上海到大连火车
乌鲁木齐到哈尔滨机票多少钱	乌鲁木齐到银川机票多少钱
怀化到吉安的火车	怀化到南京的火车
海南第一大城市	吉林第一大城市
现代建筑五原则	近代建筑五原则
阜新到山海关火车时刻表	阜新到兰州火车时刻表
八万日元等多少人民币	八百日元等多少人民币
大连职业技术学院好不好	大连艺术学院好不好
台州到江苏	台州到香港
matebook十四的分辨率	matebook十三的分辨率
郑州五一天气适合穿什么衣服	西安五一天气适合穿什么衣服
his是什么意思	my是什么意思
适合八到十二岁看的电影	适合九到十二岁看的电影
吉林税务局长	四川税务局长
焉耆县属于哪个市	香港属于哪个市
bsci认证费用	bsmi认证费用
南昌明天天气如何	哈尔滨明天天气如何
北理工的邮编	武汉理工的邮编
济南到茌平有多少公里	济南到哈尔滨有多少公里
上海宫颈癌疫苗接种点	哈尔滨宫颈癌疫苗接种点
甲胎蛋白逐渐升高	甲胎蛋白忽然升高
盐城中考总分多少	合肥中考总分多少
在零点五和零点八之间的小数有几个	在零点六和零点八之间的小数有几个
西南财大名人校友	西南民族大学名人校友
广西医科大学详细地址	南京医科大学详细地址
岫岩县副县长名单	攸县副县长名单
开封到银川多少公里	开封到洛阳多少公里
京基集团是国企吗	红塔集团是国企吗
邓丽君怎么死的	邓九公怎么死的
江西卫校排名	江苏卫校排名
适合七十后唱的歌	适合六十后唱的歌
八十三年发生了什么事	九十九年发生了什么事
偶尔便血是怎么回事	老是便血是怎么回事
两尺四穿多大码的裤子	两尺六穿多大码的裤子
青岛农业大学研究生拟录取名单	中国农大研究生拟录取名单
浙江工业大学有哪些专业	山东工业大学有哪些专业
双色球今天开奖号码是	双色球昨天开奖号码是
十二和二十一的最大公因数是多少	十二和六的最大公因数是多少
新加坡到泰国多少公里	香港到泰国多少公里
嗓子往下疼	嗓子非常疼
石家庄到芜湖	长沙到芜湖
十四是什么意思	万四是什么意思
杭州有哪些景物	日本有哪些景物
成都到包头的火车票	成都到杭州的火车票
宿州到宁陵多少公里	宿州到杭州多少公里
南京四大名校高中	武汉四大名校高中
十堰到滁州多少公里	十堰到北京多少公里
去年西安交大录取分数线	去年西交大录取分数线
四班三运转排班表	五班三运转排班表
江西有多少人口二千零一十九	甘肃有多少人口二千零一十九
申通电话	圆通速递电话
三十七是吉利数字吗	八是吉利数字吗
呼和浩特五险一金最低标准	贵阳五险一金最低标准
十一月十八日是星期几	十一月十六日是星期几
南华大学可以进去参观吗	华大可以进去参观吗
黑龙江电子邮箱是多少	甘肃电子邮箱是多少
苹果八屏幕镜像怎么用	苹果六屏幕镜像怎么用
九台到长春需要隔离吗	广东到长春需要隔离吗
十乘八	十乘十
丙氨酸氨基转移酶只有九	丙氨酸氨基转移酶只有十
调整息屏时间为一分钟	调整息屏时间为十五秒
七月份怀孕预产期是什么时候	三月份怀孕预产期是什么时候
河北寄云南快递多少钱	江西寄云南快递多少钱
七年级下册英语unit九知识点	七年级下册英语unit十一知识点
台湾人口为什么那么少	浙江人口为什么那么少
八个小时后是几点	两小时后是几点
衢州到湖州高铁	衢州到石家庄高铁
十九年三月份的电影	二十年三月份的电影
天门冬氨酸氨基转移酶四十七	天门冬氨酸氨基转移酶四十四
武夷学院多少亩	九江学院多少亩
江北机场到武隆	江北机场到成都
一百八十二天英文	四十二天英文
怀孕五十天流褐色分泌物	怀孕四十五天流褐色分泌物
吉林方言骂人的话	甘肃方言骂人的话
江苏电视台举报电话	黑龙江电视台举报电话
九十六年农历三月五日是什么星座啊	九十六年农历三月九日是什么星座啊
荣耀二十评测	荣耀九评测
孕妇能不能经常吃芒果	孕妇能不能不吃芒果
海底两万里十七到二十四章内容概括	海底两万里一到二十四章内容概括
河南科技大学是几本	黄河科技大学是几本
郑州火车站到北京西站火车票	哈尔滨到北京西站火车票
巫山属于哪个省哪个市	鲁山属于哪个省哪个市
八十七年农历九月十六是什么星座	八十七年农历十月十六是什么星座
刹车不灵敏的原因	刹车太灵敏的原因
无锡到福建	无锡到湖南
两分之五减两分之一	两分之一减两分之一
反复发烧是怎么回事	偶尔发烧是怎么回事
日本和美国关系	日本和伊朗关系
安庆到涡阳的火车时刻表	长沙到涡阳的火车时刻表
十五乘六等	十五乘十五等
四川历史名人	青海历史名人
亳州到萍乡多少公里	亳州到合肥多少公里
二十七岁适合什么牌子护肤品	二十八岁适合什么牌子护肤品
为什么很多人去广东打工	为什么很多人去香港打工
重庆到武隆一日游	重庆到武隆二日游
石家庄婚庆一般多少钱	长春婚庆一般多少钱
沈阳到瑞金火车	沈阳到广州火车
五年级十一班用英语怎么说	五年级四班用英语怎么说
上海到宜昌飞机多久	上海到天津飞机多久
北航研究生学制	北邮研究生学制
合肥周末可以办身份证吗	福州周末可以办身份证吗
河南科技大学开学了吗	河南大学开学了吗
快递广州到福州要多久	快递郑州到福州要多久
沧州至北京火车时刻表	无锡至北京火车时刻表
饭后胃疼是怎么回事	饭前胃疼是怎么回事
梧州有什么技校	杭州有什么技校
天水师范学院录取分数线二千零一十八	通化师范学院录取分数线二千零一十八
阳光保险都保什么	平安保险都保什么
无锡到周庄多少公里	无锡到武汉多少公里
延庆一中二千零一十八高考成绩	嘉祥一中二千零一十八高考成绩
山西占地面积最大的大学	湖北占地面积最大的大学
零点六五吨等多少千克	零点四吨等多少千克
南充到北川快递要多久	南充到郑州快递要多久
湖北代表团团长	四川代表团团长
西班牙的传统	中国的传统
洛阳到焦作多少公里	洛阳到抚顺多少公里
江苏和浙江哪个离上海近	江苏和浙江哪个离青岛近
商丘到泰州火车时刻表	商丘到哈尔滨火车时刻表
今天刮什么风	明天刮什么风
南京天气如何	兰州天气如何
肇庆一般公共预算收入	洛阳一般公共预算收入
国家开发银行首席经济学家	中行首席经济学家
蓝山湾三期物业电话	蓝山湾一期物业电话
双流机场到南京机场	南京到南京机场
苹果八怎么关闭抬起亮屏	苹果十一怎么关闭抬起亮屏
东方卫视主持人	安徽卫视主持人
我是歌手第一季有哪些人	我是歌手第二季有哪些人
日本四大歌姬	日本五大歌姬
八下英语六单元重点句子	八下英语五单元重点句子
山西算偏远地区吗	四川算偏远地区吗
包头西门子洗衣机售后服务电话	杭州西门子洗衣机售后服务电话
距离五月二十一日还有多少天	距离五月四日还有多少天
农历九月十三日是什么星座	农历五月十三日是什么星座
二十三除二十四	二十三除二十五
怎样落户南京	怎样落户新西兰
福建师范大学和河北大学哪个好	安徽师范大学和河北大学哪个好
数字三书写格式田字格	数字零书写格式田字格
曹操是哪个朝代的	贺知章是哪个朝代的
月经结束第一天会怀孕吗	月经结束第两天会怀孕吗
华理二千零二十研究生招生专业目录	华东政法大学二千零二十研究生招生专业目录
黄州到广州	深圳到广州
十一年第四十周是几月几日	十二年第四十周是几月几日
三亚学院占地面积	丽水学院占地面积
九十年腊月初十是什么命	九十年腊月初三是什么命
八千九百一十五的最小公倍数	八千九百一十八的最小公倍数
四加二十八等几	四加一百等几
安徽狗市场在哪里	江苏狗市场在哪里
洛阳属哪个省	贵阳属哪个省
重庆最火的火锅店	银川最火的火锅店
八十二年一月十二日属什么生肖	八十三年一月十二日属什么生肖
辽宁卷是全国几卷	湖北卷是全国几卷
周口到台州高铁票	周口到上海高铁票
济南飞泉州机票价格	济南飞昆明机票价格
湖南大学学术硕士毕业要求	南华大学学术硕士毕业要求
遵义职高有哪些专业	衡阳职高有哪些专业
慢性肾病一期	慢性肾病六期
四个人排成一排照相有几种不同的排法	五个人排成一排照相有几种不同的排法
开封到临汾火车时刻表查询	苏州到临汾火车时刻表查询
阿里巴巴的股价	阿里的股价
江苏的二本大学排名	山东的二本大学排名
河南美食名字	四川美食名字
南京大学成人高考录取分数线	湖南大学成人高考录取分数线
九种商业模式	三种商业模式
遵义中考分数线二千零一十九	遵义中考分数线二千零一十八
教师的四种类型	教师的三种类型
忻州到呼和浩特	忻州到太原
平遥属于高风险地区吗	新疆属于高风险地区吗
阜阳到河北	阜阳到北京
二十一乘三	二十一乘四
增城到东莞长安怎么坐车	佛山到东莞长安怎么坐车
怀孕三个月可以做人流吗	怀孕五个月可以做人流吗
新会有什么镇	中国有什么镇
月经结束第一天会怀孕吗	月经结束第八天会怀孕吗
枣庄学院专科分数线	钦州学院专科分数线
成都到包头的火车票	贵阳到包头的火车票
东兴证券怎么充值	东莞证券怎么充值
贵阳到习水有多少公里	重庆到习水有多少公里
最接近九十二的数是多少	最接近一百的数是多少
十七减九	十七减八
《水浒传》第三章主要内容	《水浒传》第一章主要内容
珠海居住证变更地址需要什么材料	上海居住证变更地址需要什么材料
千叶市人口	扶余市人口
洛阳到南通	洛阳到丹阳
银川到绵阳多少公里	石家庄到绵阳多少公里
swatch型号	iphonewatch型号
腰围两尺七是多少cm	腰围两尺八是多少cm
内蒙古师范大学所有专业	青海师范大学所有专业
阜阳离哈尔滨有多远	阜阳离深圳有多远
湖北各大学录取分数线二千零一十九	山东各大学录取分数线二千零一十九
山西占地面积最大的大学	江苏占地面积最大的大学
二千零二十黑龙江网吧开业时间	二千零二十四川网吧开业时间
广州离郑州多少公里	昆明离郑州多少公里
抚远市行政区划	仁怀市行政区划
广东哪个市人最少	河南哪个市人最少
武昌到大同火车时刻表	武昌到成都火车时刻表
开地产公司要多少钱	开房地产公司要多少钱
一百除二等多少	一百除十五等多少
二千零九的年历表	二千零一十八的年历表
无限极总部在哪里	微软总部在哪里
五个月宝宝有点咳嗽怎么办	五个月宝宝经常咳嗽怎么办
去年为什么找工作那么难	现在为什么找工作那么难
头总是晕晕的怎么回事	头有点晕晕的怎么回事
现在浙江去云南需要隔离吗	现在浙江去四川需要隔离吗
拔一颗智齿要多少钱	拔三颗智齿要多少钱
云南比河南大多少	云南比湖南大多少
人体四大循环	人体三大循环
福州最大电器城在哪里	合肥最大电器城在哪里
陇东学院怎么样	陇桥学院怎么样
一百万大写怎么写	二十万大写怎么写
三除七等多少	一百除七等多少
十大运动app推荐二千零一十九	十大运动app推荐二千零一十八
常宁到深圳汽车票	重庆到深圳汽车票
四点二十五日是什么星座	一点二十五日是什么星座
宝鸡到兰州有多少公里	清河到兰州有多少公里
food是什么意思	with是什么意思
南京最新隔离政策	长沙最新隔离政策
十八和三十五的最大公因数	十五和三十五的最大公因数
感觉嗓子有异物老是咳嗽	感觉嗓子有异物偶尔咳嗽
中国最穷的县	日本最穷的县
四川有什么派	安徽有什么派
十五分之二十等多少分	十五分之七等多少分
黑河最新隔离政策	香港最新隔离政策
兰草好养吗	墨兰好养吗
心跳一百二十正常吗	心跳六十正常吗
一百加二百	二百加二百
包头到赤峰火车	包头到青岛火车
重庆有到上海的高铁吗	重庆有到哈尔滨的高铁吗
玉溪师范学院怎么样	上饶师范学院怎么样
昆山到邳州的火车	昆山到上海的火车
二十一乘二十四的竖式计算	二十一乘二十五的竖式计算
今天下午有雨吗	明天下午有雨吗
西安卖旗袍的地方	呼和浩特卖旗袍的地方
一百斤穿多大码衣服	九十斤穿多大码衣服
今是秋天吗	现在是秋天吗
鞍山师范学院怎么样	鞍山科技大学怎么样
鞍山到吉林多少公里	鞍山到重庆多少公里
潍坊至新乡火车时刻表	南昌至新乡火车时刻表
阳历六月份出生的是什么星座	阳历五月份出生的是什么星座
一楼的英语单词是什么	五楼的英语单词是什么
伯利特股票发行价	伯特利股票发行价
徐州怎么样	徐州东站怎么样
广西的古称	宁夏的古称
淮阴到临沂多少公里	广州到临沂多少公里
一除零等多少	一除十一等多少
广州包括哪里	西安包括哪里
二千三百零一的近似数	九的近似数
八十乘八十	八十乘四十
兴义到株洲有多少公里	兴义到西安有多少公里
河南农业大学二千零一十九录取分数线	山西农业大学二千零一十九录取分数线
二十年山东五一节放假安排	二十年新疆五一节放假安排
银川人口净流入	昆明人口净流入
三十八乘六	三十八乘四
河北城市名称大全	广东城市名称大全
四月二十三号农历	五月四日农历
哈尔滨民用水价格	西安民用水价格
四除七等多少小数	一除七等多少小数
十六除十	十八除十
安阳到兰考	安阳到厦门
一百一十五除四等多少	一百一十五除十二等多少
杭州到义乌高铁	石家庄到义乌高铁
月经第七天还有褐色血	月经第九天还有褐色血
餐后两小时血糖正常值	餐后一小时血糖正常值
四十五和八十最大的公因数	四十五和三十最大的公因数
四班中考口号	七班中考口号
十一岁孩子地包天怎么办	十四岁孩子地包天怎么办
太原公积金可以自己交吗	昆明公积金可以自己交吗
一万韩元等多少人民币	五万韩元等多少人民币
南方医科大学简称	南航简称
杭州哪里好玩	杭州机场哪里好玩
东北电力大学专业设置	上海电力大学专业设置
取消六点三十分的闹钟	取消六点的闹钟
昆明监狱地址	成都监狱地址
二十二乘四十等	二十二乘三等
ft是什么意思	pt是什么意思
小米九关于手机	小米八关于手机
山东好玩的地方	内蒙古好玩的地方
北方民族大学校歌	贵州民族大学校歌
乌鲁木齐残保金如何计算	南昌残保金如何计算
苏良锋是哪里人	苏比是哪里人
腊月十六什么星座	十月十六什么星座
济宁各县经济排名	阜阳各县经济排名
好句十三字	好句十五字
小米十自动重启	小米八自动重启
六的九次方	四的九次方
盘锦到江苏多少公里	盘锦到郑州多少公里
昆明至宣威火车票	昆明至南京火车票
温岭市属于那个省	温哥华属于那个省
现在浙江去云南需要隔离吗	现在浙江去北京需要隔离吗
北京至涟水机票	北京至曼谷机票
安徽特产茶叶	湖南特产茶叶
爱奇艺vip怎么关闭自动续费	腾讯vip怎么关闭自动续费
我总是咳嗽	我有点咳嗽
欧洲的人文景观	日本的人文景观
脉搏一百一十正常吗	脉搏八十正常吗
太原哪个省的	江阴哪个省的
九点二十八是什么日子	十一点二十八是什么日子
六岁男孩身高体重标准	三岁男孩身高体重标准
武汉音乐学院钢琴专业分数线	上海音乐学院钢琴专业分数线
十七里地是多远	六里地是多远
长沙到宣城的火车时刻表	长沙到上海的火车时刻表
三百乘五	四百乘五
云南新冠检测费用	河北新冠检测费用
山东用什么教材	浙江用什么教材
怎么联系京东客服	怎么联系百度客服
无限极总部在哪里	谷歌总部在哪里
山西师范大学在全国的排名	山西农业大学在全国的排名
昆明楼市政策	郑州楼市政策
吃了避孕药四个小时后吐了	吃了避孕药六小时后吐了
重庆到达州火车时刻表	重庆到南京火车时刻表
大同到长治多少公里	大同到天津多少公里
根号十五等多少怎么算	根号零等多少怎么算
八十七年腊月初十是什么星座	八十七年腊月初一是什么星座
十九和七的最大公因数	十九和十九的最大公因数
陕西世界五百强企业	宁夏世界五百强企业
老黄历二十年四月份结婚黄道吉日一览表	老黄历二十年三月份结婚黄道吉日一览表
深圳到成都开车多久	重庆到成都开车多久
成都旅游景点大全	洛阳旅游景点大全
银行卡暂时锁定怎么办	银行卡已锁定怎么办
空腹血糖七点二十五需要吃药吗	空腹血糖七点零需要吃药吗
零点十五加零点六等多少	零点九加零点六等多少
湖州师范学院二千零一十九分数线	太原师范学院二千零一十九分数线
怎样快点射	怎样不射
二十一和二十三的最大公因数和最小公倍数	七和二十三的最大公因数和最小公倍数
五月二十七号是什么座	五月八号是什么座
汽车故障码东风标致00九十	汽车故障码东风标致00七十
飞利浦售后怎么样	华为售后怎么样
嘉兴到安顺高铁	嘉兴到宁波高铁
五月十六日是什么星座	五月四日是什么星座
开心消消乐隐藏四百九十五怎么过	开心消消乐隐藏四百九十四怎么过
湖南大学江苏分数线二千零一十九	湖南师大江苏分数线二千零一十九
九千四百三十二什么意思	九千七百三十二什么意思
山大硕士毕业要求	山东理工大学硕士毕业要求
贵大黑龙江录取分数线	贵大海南录取分数线
八月六是什么星座	八月十二是什么星座
中行旅顺口区支行电话	中行香港支行电话
p三十和mate二十充电器一样吗	p三十和mate九充电器一样吗
运城有那些县	中国有那些县
还有多少天到二十一年	还有多少天到除夕
出生十天的宝宝听力怎么样	出生一周的宝宝听力怎么样
哪里和中国时差一小时	哪里和中国时差三小时
河南医科大学在哪	黄河科技大学在哪
上海理工大学就业怎么样	成都理工大学就业怎么样
六和七的最大公因数是几最小公倍数是几	三十五和七的最大公因数是几最小公倍数是几
苹果六可以越狱吗	苹果七可以越狱吗
高压八十低压五十有危险吗	高压一百低压五十有危险吗
十一和三的最大公因数是几	十一和十五的最大公因数是几
商丘到郑州的大巴	商丘到西安的大巴
四川侵占罪立案标准	河北侵占罪立案标准
兴义至昆明火车票	兴义至东莞火车票
辽宁工业大学地址	西工大地址
你喜欢小布吗	你喜欢小易吗
涟源市属于哪个省哪个市	凌源市属于哪个省哪个市
二十二层十八楼好不好	二十二层九楼好不好
广西特级教师评选条件	河北特级教师评选条件
贵阳哪里属于市中心	天津哪里属于市中心
荆门到天水火车票	荆门到北京火车票
视力一点零是多少度	视力四点零是多少度
郑州妇科检查项目有哪些	南京妇科检查项目有哪些
两个月宝宝便秘	七月宝宝便秘
定一个九点三十的闹钟	定一个四点三十的闹钟
桂林有什么旅游景点	泰国有什么旅游景点
无锡去武汉	福州去武汉
vage什么意思	wge什么意思
上海社保流水在哪里打印	青岛社保流水在哪里打印
iphone七是什么时候发布的	iphone四是什么时候发布的
菲律宾在哪个国家	阿尔及尔在哪个国家
营州少年厌原野	并州少年厌原野
东莞到淮安多少公里	南昌到淮安多少公里
盐城哪些公园好玩	香港哪些公园好玩
欧洲人口密度	日本人口密度
现在七十八年一元港币硬币的价值多少元	现在七十九年一元港币硬币的价值多少元
二十年安徽自考考试时间	二十年山东自考考试时间
合肥打疫苗怎么预约	福州打疫苗怎么预约
广西属于哪个省	中国属于哪个省
血小板七十正常吗	血小板三百正常吗
新生儿三天大便一次正常吗	新生儿一周大便一次正常吗
兰州五日游最佳路线图	成都五日游最佳路线图
苏大十九年河南录取分数线	杭州大学十九年河南录取分数线
招行技术岗待遇	工行技术岗待遇
十五乘二等多少	十五乘十五等多少
新华保险险种	华安保险险种
行尸走肉第五季影评	行尸走肉第三季影评
六岁小孩打嗝	零岁小孩打嗝
成语大全三字成语大全	成语大全四字成语大全
中秋节的由来简介五十字左右	中秋节的由来简介二十字左右
现在都有什么职业	早年都有什么职业
沈阳到辽源高铁什么时候开通	沈阳到哈尔滨高铁什么时候开通
小米十怎么打印	小米九怎么打印
节食七天能瘦多少	节食四天能瘦多少
什么姿势可以尽快怀孕	什么姿势可以不怀孕
郑州到拉萨的飞机	西安到拉萨的飞机
河南助理工程师评定	浙江助理工程师评定
黑龙江科技大学几个校区	河南科技大学几个校区
经常吃健胃消食片好吗	偶尔吃健胃消食片好吗
申通基本情况	顺丰速运基本情况
一星期吃几个鸡蛋比较好	一天吃几个鸡蛋比较好
济南个人所得税标准	合肥个人所得税标准
沈阳到临沂机票特价票	沈阳到深圳机票特价票
从成都到西安多少公里	从成都到重庆多少公里
九十九年发生了什么事	今天发生了什么事
河南历年gdp	海南历年gdp
十二月份哪天是黄道吉日	三月份哪天是黄道吉日
十五乘三点一四	十八乘三点一四
肥城摩托车驾驶证怎么考	盐城摩托车驾驶证怎么考
洛阳师范学院专升本学费	南阳师范学院专升本学费
北京到青县的火车票	北京到郑州的火车票
北大排名全国第几	北华大学排名全国第几
宿州到苏州高铁	南京到苏州高铁
甘肃离四川有多远	西藏离四川有多远
武汉体育学院有几个校区	西安体育学院有几个校区
广州属于那里	西安属于那里
济宁离泗水多远	济宁离北京多远
彭州二级医院有哪些	彭州二甲医院有哪些
姓赖的取什么名字好听	姓徐的取什么名字好听
新历三月十二日是什么星座	新历三月九日是什么星座
四g信号差	五g信号差
深圳到冠豸山动车时刻表	深圳到南京动车时刻表
新疆艺术学院毕业要求	广西艺术学院毕业要求
一百二十六除三	一百二十六除六
成都近期篮球比赛	贵阳近期篮球比赛
当下如何才能遇到自己喜欢的人	未来如何才能遇到自己喜欢的人
桂林二千零一十九中考录取分数线	宿州二千零一十九中考录取分数线
华谊兄弟的股价	长江电力的股价
如果a除b等五那么a和b的最大公因数是多少最小公倍数是多少	如果a除b等十二那么a和b的最大公因数是多少最小公倍数是多少
一年有多少天	半年有多少天
石家庄美容院哪家好	北京美容院哪家好
皖南医学院分数线	武警医学院分数线
lne的五次方	lne的三次方
苹果六怎么设置来电铃声	苹果七怎么设置来电铃声
黑龙江科技大学几个校区	武汉科技大学几个校区
十三万二千四百二十一开头的身份证是哪里的	十三万一千四百二十一开头的身份证是哪里的
计算机二级证书有效期	计算机三级证书有效期
十四乘九	十四乘十四
七月七日是星期几	七月十三是星期几
身高八尺等多少厘米	身高一尺等多少厘米
十八年人口统计	十九年人口统计
达州哪个区比较好	重庆哪个区比较好
三十六乘三十八	三十三乘三十八
二十五乘二十等多少	二十五乘五等多少
大便一直不正常	大便不不正常
宫颈癌九价疫苗	宫颈癌五价疫苗
浏阳市人均可支配收入	宜昌人均可支配收入
内蒙古民族大学有专科吗	中国民航大学有专科吗
内蒙古油菜籽价格	江苏油菜籽价格
深圳哪里好玩	深圳东站哪里好玩
七十二乘一千	八百乘一千
江西财经大学编号	山西财经大学编号
九除四等几分之几	九除十八等几分之几
喉咙里好像有异物感	喉咙里一直有异物感
东北师大综合排名	西北师范大学综合排名
怎么样申请小米账号	怎么样申请谷歌账号
现任中国重汽董事长	现任华为董事长
一亿什么意思	三亿什么意思
防灾科技学院怎么样	河南科技学院怎么样
福州到秦皇岛多少公里	广州到秦皇岛多少公里
刚怀孕肚子隐隐疼怎么回事	刚怀孕肚子一直疼怎么回事
海安到重庆多少公里	海安到厦门多少公里
上海财大位置好吗	东北财经大学位置好吗
怎么打四川的报警电话	怎么打福建的报警电话
清华二千零二十分数线	北大二千零二十分数线
十四年三月十号是什么星座	十五年三月十号是什么星座
海安到黄山火车时刻表查询	海安到兰州火车时刻表查询
苹果十一的价格现在是多少	苹果四的价格现在是多少
a七x的电池容量	k七x的电池容量
昨天农历几月几日了	现在农历几月几日了
a三十二包装清单	a五十二包装清单
十三岁可以去健身房吗	十六岁可以去健身房吗
《水浒传》第三章主要内容	《水浒传》第二章主要内容
八的平方等多少	十六的平方等多少
柳市到无锡物流电话	成都到无锡物流电话
河南有什么好玩的地方	蒙古有什么好玩的地方
云大宿舍条件	云南师范大学宿舍条件
四声的分组词	一声的分组词
距离台湾最近的岛屿	距离美国最近的岛屿
苏大十九年河南录取分数线	贵大十九年河南录取分数线
锦州港最好的小区	香港最好的小区
庄周距今多少年	周公距今多少年
六和十二的最小公倍	四和十二的最小公倍
cpa考试用书	cfa考试用书
五十乘三	五十乘五十
南宁高校排名	呼和浩特高校排名
用短除法求十八和六的最小公倍数	用短除法求三和六的最小公倍数
芜湖到泰兴火车时刻表	杭州到泰兴火车时刻表
江西到丽江	青海到丽江
科一课时刷完为什么不能预约	科三课时刷完为什么不能预约
五分之二平方米等多少平方分米	五分之四平方米等多少平方分米
二百小时是几天	一小时是几天
九点二十八是什么日子	九点二十二是什么日子
三十分钟之后关闭音乐	十分钟之后关闭音乐
鲍姓男孩取名	鞠姓男孩取名
苹果七plus换屏幕	苹果八plus换屏幕
微软的ceo	ibm的ceo
武汉历史最高气温	太原历史最高气温
临沂到武邑县物流	临沂到宁波物流
iphone六plus触屏失灵	iphone七plus触屏失灵
一百七十三是移动还是联通的号	一百七十七是移动还是联通的号
云南师范大学专升本录取分数线二千零一十九	河南师范大学专升本录取分数线二千零一十九
常州是哪个省	新安是哪个省
怀孕三十二周胎儿体重	怀孕十二周胎儿体重
驻马店到太原火车票	驻马店到郑州火车票
十加十六等几	十加一千等几
与中国时差十四小时的国家	与中国时差两小时的国家
广东多少人口二千零二十	日本多少人口二千零二十
十八和六的最小公倍数是多少	十八和二十四的最小公倍数是多少
八个月宝宝发烧三十八度怎么办	十一月宝宝发烧三十八度怎么办
六百和二百的最小公倍数	五百和二百的最小公倍数
山东电视台台长	贵州电视台台长
吉水县属于哪个省哪个市	柞水县属于哪个省哪个市
八和十五的公倍数有哪些	七和十五的公倍数有哪些
昆明牙齿矫正医院排名	西安牙齿矫正医院排名
理塘到色达	理塘到云南
二千零二十海淀初三二模时间	二千零二十海淀初三一模时间
眉山的面积	日本的面积
冠县开锁电话	横峰县开锁电话
零零年悉尼奥运会中国国家队的男篮队员名单	一年悉尼奥运会中国国家队的男篮队员名单
阜阳至海口机票	广州至海口机票
郏县到郑州拼车群	西安到郑州拼车群
案件五要素	案件六要素
肺癌晚期死前一月症状	肺癌晚期死前三天症状
德州到大庆有多少公里	天津到大庆有多少公里
十二年的高尔夫值多少钱	十三年的高尔夫值多少钱
领克0两和0一选择哪个	领克0两和0三选择哪个
名山区领导	泉山区领导
三十六周宫缩对胎儿的危害	二十七周宫缩对胎儿的危害
浙江和重庆距离多远	浙江和江西距离多远
凯立德车载导航怎么升级	百度车载导航怎么升级
吉利帝豪gl价格多少	吉利帝豪gs价格多少
居民委员会选举法	村民委员会选举法
济南舜耕中学校长	济南育秀中学校长
枣阳市公证处电话	安阳公证处电话
泰安到许昌	泰安到深圳
金华到庐山	金华到哈尔滨
郑州高中排名及分数线	洛阳高中排名及分数线
南昌到重庆的飞机票多少钱	南昌到北京的飞机票多少钱
成都有几个省	济南有几个省
宝宝经常咳嗽什么原因	宝宝偶尔咳嗽什么原因
与新疆相邻的国家	与法国相邻的国家
八月六是什么星座	八月一是什么星座
西北农大二十年什么时候开学	西工大二十年什么时候开学
二十年四月十五日陕西鸡蛋价格	二十年四月十五日江苏鸡蛋价格
二十一乘二十一	二十八乘二十一
重庆最新楼盘开盘	南昌最新楼盘开盘
十二promax参数详细参数	十一promax参数详细参数
郑州的饰品批发市场在哪里	深圳的饰品批发市场在哪里
半年工作总结结束语	下半年工作总结结束语
十三岁身高体重标准表	十五岁身高体重标准表
十六的最大公约数	十八的最大公约数
济南大学的专业排名	南昌大学的专业排名
山东男生特点	澳门男生特点
七时等几日	二十四时等几日
刑期一年可以减刑吗	刑期四年可以减刑吗
第一个字是摧的成语	第四个字是摧的成语
九十九年十二月二十九日发生了什么	九十九年两月二十九日发生了什么
周庄在哪	周庄嘉园在哪
二加九分之五	九加九分之五
悲戚写一句话	哀写一句话
西藏是偏远地区吗	新疆是偏远地区吗
北京尼泊尔时差	北京深圳时差
兰州到苏州高铁几个小时	郑州到苏州高铁几个小时
河南医科大学在哪	河南科技大学在哪
长春动物园门票多少钱	深圳动物园门票多少钱
五百二十六除七等多少	四除七等多少
滨州隔离政策	延安隔离政策
西安到三门峡多少公里	西安到重庆多少公里
常熟到常州汽车要多久	常熟到扬州汽车要多久
十九年成人大专什么时候报名	二十年成人大专什么时候报名
青岛离无锡有多远	青岛离天津有多远
石家庄哪里可以借钱	兰州哪里可以借钱
罗湖区有哪些初中学校	安徽有哪些初中学校
适合甘肃种植的葡萄	适合黑龙江种植的葡萄
两尺四穿多大码的裤子	两尺三穿多大码的裤子
唐县有服务中心吗	常平有服务中心吗
苹果六通话录音功能	苹果八通话录音功能
十月十日是什么星座	九月十日是什么星座
小宝演过的电视剧	孙小宝演过的电视剧
0八年奥运会的官方语言有几种	二百零九年奥运会的官方语言有几种
偃师到阜阳多少公里	天津到阜阳多少公里
合肥到温州多少公里	合肥到常熟多少公里
六和十六的最大公因数和最小公倍数	六和八的最大公因数和最小公倍数
今天有没有台风	明天有没有台风
糖皮质激素八大副作用	糖皮质激素九大副作用
五十七除三	五十七除十九
郑州科一考试时间	济南科一考试时间
石家庄男科治疗哪家医院好	重庆男科治疗哪家医院好
六十四除二	六十四除四
五菱六座车多少钱	五菱九座车多少钱
长海医院体检套餐	东方医院体检套餐
历史上姓周的名人	历史上姓简的名人
十五乘多少等十	十五乘多少等五
融创是不是央企	百度是不是央企
恩施到沈阳	上海到沈阳
南京哪个汽配城最大	南宁哪个汽配城最大
在福州买房的条件	在新西兰买房的条件
总是反胃干呕怎么回事	偶尔反胃干呕怎么回事
头孢二代抗生素有哪些	头孢五代抗生素有哪些
二的五次方怎么写	二的二次方怎么写
武汉到西宁的火车票	武汉到拉萨的火车票
河南理工大学会计学怎么样	太原理工会计学怎么样
我在六年级八班的英文	我在六年级一班的英文
小仲马是哪国人	小钮马是哪国人
宜昌到汉川火车时刻表	杭州到汉川火车时刻表
姓闫的名人都有哪些	姓徐的名人都有哪些
餐后一小时血糖正常值	餐后六小时血糖正常值
六月一日民政局上班吗	七月一日民政局上班吗
五月二十日历史的今天	五月四日历史的今天
建行十万定期一年多少钱	建行十万定期三年多少钱
宣城到徽州多少公里	宣城到苏州多少公里
怀孕两个月可以用试纸测出来吗	怀孕十八天可以用试纸测出来吗
徐州到平顶山汽车	徐州到长沙汽车
河北中医院科室列表	河北儿童医院科室列表
0八年吉安的市长是谁	九年吉安的市长是谁
a五十二有没有语音唤醒功能	a八有没有语音唤醒功能
重庆疫情解禁了吗	武汉疫情解禁了吗
宁国到巢湖的火车时刻表	上海到巢湖的火车时刻表
敲诈一百七十万判多久	敲诈二十万判多久
八点五乘一千等多少	八点五乘六等多少
八十三年属什么生肖	八十四年属什么生肖
友谊医院附近有什么好吃的	太和医院附近有什么好吃的
孕二十七周肚子发紧发硬	孕三十七周肚子发紧发硬
加二百五十二是哪个国家的区号	加零是哪个国家的区号
月经第八天还有褐色分泌物是怎么回事	月经第七天还有褐色分泌物是怎么回事
攀枝花到昆明有多少公里	南京到昆明有多少公里
快龙怎么画	腾龙怎么画
建行郴州网点	工行郴州网点
女性反复尿频是怎么回事	女性偶尔尿频是怎么回事
月经老是推迟的原因	月经偶尔推迟的原因
北京银行疫情期间营业时间	北京农商银行疫情期间营业时间
华南农业大学退住宿费	南华大学退住宿费
七十年代发型	六十年代发型
北理工教师待遇	重庆理工大学教师待遇
十三年安徽理科状元	十四年安徽理科状元
两尺四是多少码的裤子	两尺六是多少码的裤子
成都办理社保卡在哪里	贵阳办理社保卡在哪里
吉林师范大学二千零一十九专业分数线	陕西师大二千零一十九专业分数线
枣庄到泰安高铁	哈尔滨到泰安高铁
适合二的最大公因数	适合八的最大公因数
一百一十九的平方等多少	三的平方等多少
越西县好玩的地方	陇西县好玩的地方
十五年中美gdp对比	十六年中美gdp对比
明溪县属哪个市	泸溪县属哪个市
平顶山学院有多少人	衡水学院有多少人
云南地区代码	台湾地区代码
西安科技大学有三本吗	西安理工大学有三本吗
小米账号密码如何找回	谷歌账号密码如何找回
dde指标使用技巧	ddx指标使用技巧
眼睛眼角很红	眼睛眼角有点红
西华师大属于哪个区	西北师范大学属于哪个区
今晚湖南卫视的节目单	明天晚上湖南卫视的节目单
十五和二十五最大公因数	七和二十五最大公因数
宿迁到北京有多少公里	宿迁到昆明有多少公里
兰州五百强企业	洛阳五百强企业
北外比较文学考研	四川外国语大学比较文学考研
京都哪个区最好	澳门哪个区最好
九月二十九日是什么星座	八月二十九日是什么星座
怀化有哪些职业高中	中国有哪些职业高中
国航算国企吗	南航算国企吗
吴川市到广州多少公里	吴川市到南宁多少公里
太原有几条地铁线路图	广州有几条地铁线路图
中国一线城市有哪些	中国五线城市有哪些
对郭沫若的评价	对郭敬明的评价
广西离郑州有多少公里	安徽离郑州有多少公里
十九年注会考试科目时间表	二十年注会考试科目时间表
四十五和六十的最大公因数	四十五和三十的最大公因数
呼市到邯郸火车时刻表	济南到邯郸火车时刻表
乐山大佛几月份去最好	新加坡几月份去最好
江门一中二千零一十九录取分数线	龙口一中二千零一十九录取分数线
山东gdp排名城市	中国gdp排名城市
一的二十三次方	一的二十四次方
宁晋有啥好玩的地方	澳门有啥好玩的地方
安徽理工大学理科分数线	长沙理工大学理科分数线
法兰克福地图位置	日本地图位置
景德镇到深圳火车时刻表	景德镇到襄阳火车时刻表
诸暨到温州火车	诸暨到杭州火车
今年二十八岁的人是属什么的	今年二十六岁的人是属什么的
0二十五万九千六百七十六是什么号码	一是什么号码
宜昌属于地级市还是县级市	内江属于地级市还是县级市
低压一百高压一百三十正常吗	低压五十高压一百三十正常吗
十九年中国人平均身高	二十年中国人平均身高
十八和六的最小公倍数是多少	五和六的最小公倍数是多少
国家药监局投诉电话	国家版权局投诉电话
苹果八怎么隐藏软件	苹果四怎么隐藏软件
咸阳有什么好玩的地方	蚌埠有什么好玩的地方
杭州哪里最好玩	郴州哪里最好玩
零点六乘零点三	零点六乘零点六
鱼竿五定位是什么意思	鱼竿三定位是什么意思
衡阳一中怎么样	百度怎么样
苹果七plus的价格	苹果八plus的价格
东南汽车后视镜价格	东风日产后视镜价格
邯郸至长春飞机票多少钱	邯郸至广州飞机票多少钱
南理工书记	南京师大书记
河北工程大学名人	西安工程大学名人
四川侵占罪立案标准	山东侵占罪立案标准
宁波到西双版纳火车时刻表	宁波到东莞火车时刻表
新疆的经度和纬度	澳门的经度和纬度
七百一十二多久一趟	七百零四多久一趟
山西春节习俗	四川春节习俗
长沙防疫情况	长春防疫情况
christina英文名寓意	kristina英文名寓意
衡阳一中怎么样	邹平一中怎么样
南京林业大学环境工程怎么样	南京工业大学环境工程怎么样
大理市市长热线电话	枣阳市市长热线电话
北师大一年学费多少	北大一年学费多少
mate二十系统降级	mate九系统降级
十和八和六的最小公倍数是多少	五和八和六的最小公倍数是多少
北航研究生学制	北大研究生学制
重庆到拉萨飞机票多少钱	呼和浩特到拉萨飞机票多少钱
许昌到哈尔滨	许昌到拉萨
沈阳造币厂怎么样	沈阳理工大学怎么样
西宁哪里能治癫痫	贵阳哪里能治癫痫
怀化到吉安的火车	怀化到上海的火车
沙特阿拉伯被殖民过吗	德国被殖民过吗
r十一乘七	r十一乘九
中国几个港口	香港几个港口
福州能打hpv疫苗吗	银川能打hpv疫苗吗
北京电信咨询电话	上海电信咨询电话
青海特产有哪些	山东特产有哪些
贵州十八年高考分数线	海南十八年高考分数线
覃塘区属于哪个市	湾仔区属于哪个市
湖北办理居住证要多久	河北办理居住证要多久
云南师范大学研究生补助	云南财经大学研究生补助
济南到文登物流直达	济南到成都物流直达
金华到滁州多少公里	金华到南京多少公里
苏字开头的二字网名	苏字开头的三字网名
山东文科一本分数线	西藏文科一本分数线
中建一局在哪里	中建七局在哪里
芒果为什么那么酸	苹果为什么那么酸
盐城到滨州多少公里	丹阳到滨州多少公里
盐城工学院怎样	常州工学院怎样
小米十不能插耳机	小米六不能插耳机
六十四乘九	六十四乘六
沧县中学电话	渠县中学电话
三十九除二	三十九除四
十七年安徽高考录取分数线	十七年辽宁高考录取分数线
三十七除二十	三十七除一百
济宁到溧阳多少公里	济宁到哈尔滨多少公里
十七加十九	十七加十二
小孩偶尔咳嗽	小孩经常咳嗽
六十岁在古代被称为	五十岁在古代被称为
情人湾在哪里	湾湾在哪里
中原地产广州总部电话	中原地产昆明总部电话
浙商银行董事长	莱商银行董事长
打开网易云音乐播放今日推荐	打开网易云音乐播放每日推荐
云南警官学院怎么样	江苏警官学院怎么样
黑龙江解封了吗	山东解封了吗
一千六百乘三	一千六百乘一千六百
济南四路公交车路线	成都四路公交车路线
徐州到湖南有多远	徐州到兰州有多远
香格里拉起源	香格里拉酒店起源
十五年诺贝尔生理学或医学奖得主	十六年诺贝尔生理学或医学奖得主
太原旅游景点一日游	乌鲁木齐旅游景点一日游
写三句珍惜时间的名言警句	写五句珍惜时间的名言警句
一百八十六是哪个地区的号码	一百六十六是哪个地区的号码
长安马自达钥匙换电池	一汽马自达钥匙换电池
阴历四月十四是什么日子	阴历四月十三是什么日子
西安今日豆粕价格	重庆今日豆粕价格
三百五十除一千等多少	三百五十除二十五等多少
九除四等几分之几	九除十二等几分之几
杭州好玩的地方在哪里	北京好玩的地方在哪里
乙肝表面抗体一千是什么意思	乙肝表面抗体一百六十是什么意思
蔡家坡到天水高铁时刻表	重庆到天水高铁时刻表
景德镇到铜陵火车时刻表	景德镇到杭州火车时刻表
昆明当地最低工资标准	长春当地最低工资标准
南京交通大学在哪里	北京交大在哪里
陕西二千零二十公务员考试时间	江苏二千零二十公务员考试时间
三十八天婴儿吃多少奶粉	四十五天婴儿吃多少奶粉
四十除八等	三除八等
河北有哪些军校	福建有哪些军校
王者孙悟空的台词	王者铠的台词
济南个人所得税标准	北京个人所得税标准
一千九百九十四旧历十月初九是什么星座	一千九百九十四旧历七月初九是什么星座
吉林农大在哪	山东农业大学在哪
网贷逾期半年会怎么样	网贷逾期一年会怎么样
江西大还是日本大	福建大还是日本大
郑州到遂平多少公里	郑州机场到遂平多少公里
蚂蚁森林六十八g能量代表什么	蚂蚁森林八十八g能量代表什么
贵州二千零一十九中考录取分数线	青海二千零一十九中考录取分数线
一千一百三十五爱情寓意	一千一百三十一爱情寓意
二十年河北中考分数线	二十一年河北中考分数线
二千零二十安徽重点研发计划	二千零二十广东重点研发计划
高压一百四十低压一百	高压一百四十低压五十
喉咙里好像有异物感	喉咙里总是有异物感
贵州到安顺	贵州到陕西
沧州到焦作的高铁时刻表	广州到焦作的高铁时刻表
描写夏天的句子	描写秋天的句子
南京哪家医院治疗白癜风效果最好	天津哪家医院治疗白癜风效果最好
海大什么专业最好	湖南大学什么专业最好
餐后三小时血糖正常值	餐后半小时血糖正常值
中国一线城市有哪些	中国三线城市有哪些
贵阳到习水有多少公里	贵阳到南昌有多少公里
两和五的最小公倍数	两和九的最小公倍数
仙剑奇侠传三招数	仙剑奇侠传一招数
六百除三竖式	六百除七竖式
农夫山泉的股价	双林股份的股价
十九年三月份的电影	二十年三月份的电影
南昌二手房均价	重庆二手房均价
大庆比较好的牙科医院	上海比较好的牙科医院
西安人才引进落户政策	贵阳人才引进落户政策
属火四画的字	属火七画的字
静息心率低于五十怎么办	静息心率低于六十怎么办
海澜之家全称	居然之家全称
体彩三加两多少钱	体彩八加两多少钱
六的最大因数	二的最大因数
孕二十七周肚子发紧发硬	孕二十六周肚子发紧发硬
西安低保标准	武汉低保标准
五十七和十九的最大公因数和最小公倍数	六和十九的最大公因数和最小公倍数
福建的网吧开门了吗	湖北的网吧开门了吗
你在家里干什么	你正在干什么
iphone八plus换屏幕	iphone六plus换屏幕
三月五日是什么星座	三月九日是什么星座
历史上姓周的名人	历史上姓倪的名人
十五年什么时候买车最便宜现在是淡季吗	十六年什么时候买车最便宜现在是淡季吗
东莞到湛江火车时刻表	东莞到济南火车时刻表
产后第一天吃什么	产后第六天吃什么
商丘未来规划	南宁未来规划
0五年两月六日什么星座	六年两月六日什么星座
龙虎山到长沙多少公里	香港到长沙多少公里
九十六减七等几	五减七等几
零点二十五小时等多少分钟	十二小时等多少分钟
中国人寿的股东是谁	百度的股东是谁
传祺gs八车怎么样	传祺gm八车怎么样
香港哪些地区	中国哪些地区
汉川市领导	沁阳市领导
十五最大的因数是	十一最大的因数是
陈赫是哪里人	赫本是哪里人
南航研究生拟录取名单	南京工程学院研究生拟录取名单
生肖三合是什么意思	生肖四合是什么意思
五乘十三	十三乘十三
otc是什么	vfc是什么
三月十六日是什么星座	三月九日是什么星座
丽水到青田高铁时刻表	丽水到合肥高铁时刻表
体彩大乐透九加四多少钱一注	体彩大乐透九加五多少钱一注
丹东公务员好考吗	肇东市公务员好考吗
零零年九月份现在多少岁	零零年十二月份现在多少岁
河南交通设施厂家	内蒙古交通设施厂家
山东有什么关	广西有什么关
重庆公交车道时间	南昌公交车道时间
ios十三最好用的版本	ios十二最好用的版本
福州到石家庄火车时刻表查询	福州到郑州火车时刻表查询
万载县历任县长	万安县历任县长
腋下三十七℃算发烧吗	腋下三十八℃算发烧吗
太原理工湖北分数线	长沙理工大学湖北分数线
三江学院是三本吗	嘉兴学院是三本吗
眉山华夏地址	保山华夏地址
山东属于哪个地区	广西属于哪个地区
海南种植基地	浙江种植基地
心跳一百零二正常吗	心跳四十正常吗
苹果八还能入手吗	苹果七还能入手吗
香港城市大学什么时候开学	香港大学什么时候开学
贵阳新任市长是谁	广州新任市长是谁
哈尔滨师范学院分数线二千零一十九	廊坊师范学院分数线二千零一十九
沈阳师范大学学号	衡阳师范学院学号
二十四和八的最小公倍数是什么	二十四和五的最小公倍数是什么
南京大学与南开哪个好	湖南大学与南开哪个好
新兴县房价	新昌县房价
合肥清华园小区地址	成都清华园小区地址
八十九年蛇属什么	九十年蛇属什么
经常梦到一个人代表什么	偶尔梦到一个人代表什么
三百二十五除十三等多少	三百二十五除五等多少
带八的三字词语	带四的三字词语
九十六年是第几世纪	九十七年是第几世纪
江西财经大学改名	江西理工大学改名
三月二十日是什么星座	三月八日是什么星座
八月份的猪命运如何	四月份的猪命运如何
沈阳农业大学是一本么	河北农业大学是一本么
圆的内接三边形怎么画	圆的内接四边形怎么画
三分之九化成带分数	三分之五化成带分数
汕头到昆明快递要多久	重庆到昆明快递要多久
齐齐哈尔身份证办理	保定身份证办理
德州到张家港有多少公里	重庆到张家港有多少公里
西藏玩什么	江西玩什么
连云港今日潮汐时间表	香港今日潮汐时间表
成都酒店品牌	长春酒店品牌
十一月二十五是什么节日	十一月二十一是什么节日
五g手机小米和vivo哪个好	五g手机华为和vivo哪个好
十一除一点五	十二除一点五
血压一百三十除一百正常吗	血压一百二十除一百正常吗
四百除五	四百除八
美国和北京时间差几个小时	法国和北京时间差几个小时
九和十二的公因数有几个	八和十二的公因数有几个
左手有时发麻	左手经常发麻
一比十八是多少	一比六是多少
iphone八plus防水吗	iphone七plus防水吗
宁波网站优化排名	杭州网站优化排名
五月二十七号日子好不好	五月四日日子好不好
山西离内蒙古远吗	山西离广西远吗
商品房九楼好不好	商品房五楼好不好
山西二线城市有哪些	广西二线城市有哪些
郑州生活节奏快吗	天津生活节奏快吗
七除五十六	七除一
香港的区号	商丘的区号
忠县好玩的地方	隆化县好玩的地方
苹果手机和三星手机哪个好	华为手机和三星手机哪个好
云南三支一扶报名时间二千零一十九	江西三支一扶报名时间二千零一十九
星巴克是上市公司吗	腾讯是上市公司吗
拔一颗牙多少钱	拔四颗牙多少钱
山西大致在北京的什么方向	内蒙古大致在北京的什么方向
青海是哪个省的	新疆是哪个省的
八除九加一除九	一除九加一除九
孕后期能喝银耳红枣汤吗	孕期能喝银耳红枣汤吗
南阳至绍兴火车时刻表	南阳至苏州火车时刻表
华南师大招生分数线	华东师大招生分数线
去贵州车费多少钱	去浙江车费多少钱
西宁属于哪个省	南京属于哪个省
卖家七天不发货	卖家一天不发货
四位数的读法	九位数的读法
咸阳到华清池有多远	咸阳到青岛有多远
四个月宝宝喉咙有痰怎么办	九月宝宝喉咙有痰怎么办
郑州至乌鲁木齐高铁时刻表	郑州至南宁高铁时刻表
重庆到达州火车时刻表	重庆到合肥火车时刻表
什么动物有四十二条腿	什么动物有三条腿
二十七小时等多少日	十六小时等多少日
深圳哪里可以办理离婚手续	绍兴哪里可以办理离婚手续
谁的四次方等二百五十六	谁的四次方等四
钢铁是怎样炼成的第七章赏析句子	钢铁是怎样炼成的第六章赏析句子
西安到许昌高铁	北京到许昌高铁
华理二千零二十研究生招生专业目录	华东师大二千零二十研究生招生专业目录
牡丹江有哪些县	日本有哪些县
济阳有啥好玩的景点	日本有啥好玩的景点
澳门恢复旅游了吗	西藏恢复旅游了吗
广东有哪里好玩的	四川有哪里好玩的
徐闻到桂林多少公里	北京到桂林多少公里
原平市属于哪个省哪个市	固原属于哪个省哪个市
血小板七十正常吗	血小板一百正常吗
苏州高三二模成绩	沈阳高三二模成绩
深圳和旧金山的时差	深圳和哈尔滨的时差
德国是哪个洲的	冰岛是哪个洲的
八减八等几	十四减八等几
徐州至泗阳高铁	南京至泗阳高铁
三亚学院教师待遇	襄樊学院教师待遇
叶子先生的标日十七到二十四	叶子先生的标日十七到二十三
月经完第二天是安全期吗	月经完第七天是安全期吗
新乡到安康多少公里	新乡到上海多少公里
宜昌哪个医院可以做核酸检测	宜宾哪个医院可以做核酸检测
济南有什么好玩的地方吗	西安有什么好玩的地方吗
十六岁的孩子该怎么教育	十二岁的孩子该怎么教育
八十五年属于哪个年代	八十六年属于哪个年代
糖尿病餐后两小时血糖正常值	糖尿病餐后六小时血糖正常值
山西师范大学研究生拟录取名单	海南师范大学研究生拟录取名单
四十二年生的人是什么生肖	四十三年生的人是什么生肖
九和四十八最小公倍数是多少	十六和四十八最小公倍数是多少
长沙到运城多少公里	福州到运城多少公里
战国时期的山西	战国时期的北京
属鼠四月份出生的命运	属鼠六月份出生的命运
浙大江苏录取分数线	浙江工商大学江苏录取分数线
长春到敦化	长春到宣化
许昌学院属于哪个区	宜春学院属于哪个区
白洋淀到白沟高铁	北京到白沟高铁
中信周末上班吗	工行周末上班吗
高压一百六十低压九十严重吗	高压一百一十低压九十严重吗
四月二十八是什么星座女	四月九是什么星座女
八百六十除八竖式计算	一除八竖式计算
小米八冲不上电	小米九冲不上电
南方医院怎么样	济南医院怎么样
双峰县属于哪	柞水县属于哪
郑州属于哪个省的	中国属于哪个省的
一百的质数	十的质数
大庆重点初中排名	肇庆重点初中排名
济南大还是南京大	济南大还是大连大
一加八的尺寸	一加五的尺寸
惠州到娄底的火车	惠州到武汉的火车
二千零一十六快乐男生十强排名	二千零一十七快乐男生十强排名
三星和小米哪个好	三星和华为哪个好
北师二十年考研分数线	首都师范大学二十年考研分数线
华南理工校长	南理工校长
强生控股股票代码	中天控股股票代码
甘肃离四川有多远	甘肃离内蒙有多远
姓吕的辈分排列	姓牟的辈分排列
十一岁男孩长毛	十二岁男孩长毛
剑河县区号	河口县区号
江苏离青海有多远	江苏离重庆有多远
二十一年是不是世界末日	二十二年是不是世界末日
广州公务员省考时间	成都公务员省考时间
贵阳到铜仁梵净山	贵阳机场到铜仁梵净山
上海人口二千零一十九总人数	中国人口二千零一十九总人数
河西学院在哪个省	皖西学院在哪个省
中行存款规模	工行存款规模
上海到烟台机票价格	上海到巴黎机票价格
三十八乘五十怎么列竖式	三十八乘四十怎么列竖式
今天星期天几	几月几日星期日几
北师大一年学费多少	河北师范大学一年学费多少
南京林业大学研究生复试时间	南京中医药大学研究生复试时间
怀孕三十二周肚子发紧发硬是怎么回事	怀孕三十四周肚子发紧发硬是怎么回事
苹果三手机怎么解锁	苹果五手机怎么解锁
生长在黄泉路的花	生长在广东的花
天津体育学院教师待遇	武汉体育学院教师待遇
三分之一加二分之一	三分之一加五分之一
华中西湖在哪	江南西湖在哪
广东现在过去还要隔离吗	新疆现在过去还要隔离吗
孕十四周还会胎停吗	孕二十四周还会胎停吗
德州最大的医院	澳门最大的医院
万州到太原	万州到广州
青岛啤酒十九年销售额	华为十九年销售额
十七和十三的最小公倍数和最大公因数	十五和十三的最小公倍数和最大公因数
外地去石家庄要隔离吗	外地去哈尔滨要隔离吗
二千零二十开学时间河南	二千零二十开学时间吉林
什么季节去长白山旅游最好	什么季节去澳大利亚旅游最好
内蒙古小吃	四川小吃
庐山有哪些名人	中国有哪些名人
六百一十三除两列竖式	六百一十四除两列竖式
月经来了六天了	月经来了八天了
三百二十六乘八等几	三百二十六乘三百二十等几
二百三十六除八等多少	二百三十六除四十等多少
十三的二进制数	零的二进制数
二十八岁生日祝福语	二十九岁生日祝福语
江苏人吃不吃辣椒	河北人吃不吃辣椒
用你喜欢的方式表示四十三	用你喜欢的方式表示四十五
七月十二日是什么星座	七月一日是什么星座
十号令解读	一号令解读
南京体育学院难考吗	广州体育学院难考吗
十二乘十二等多少	十二乘四等多少
一路公交车的英文	五路公交车的英文
贾宝玉在红楼春趣的性格特点	宝玉在红楼春趣的性格特点
厦门到莆田动车时刻表	厦门北站到莆田动车时刻表
徐州工业学院怎么样	徐州一中怎么样
青州市有哪些旅游景点	锦州有哪些旅游景点
八肾丸是什么	三肾丸是什么
二十乘八十	四乘八十
邵阳到广西	邵阳到武汉
泉州师范学院是一本吗	烟台师范学院是一本吗
六岁的孩子穿多大码的衣服	八岁的孩子穿多大码的衣服
天津中考怎么报志愿	哈尔滨中考怎么报志愿
四月二十七日是什么星座的	五月二十七日是什么星座的
三十一除一百一十九	三十一除三
三除七等多少	三除三十等多少
十年有多少天	十一年有多少天
齐齐哈尔房价走势	宜都房价走势
郑州那个好玩	合肥那个好玩
济南飞南京航班时刻表	西宁飞南京航班时刻表
徐州建行营业网点	杭州建行营业网点
广州到南平物流专线	广州到天津物流专线
西安去苏州需要隔离吗	西安去深圳需要隔离吗
顺丰上海到昆明要多久	顺丰上海到北京要多久
昆明是个什么城	北京是个什么城
鞍山到邯郸的火车时刻表	鞍山到哈尔滨的火车时刻表
r十一乘五	r十一乘四十
低压一百高压一百三十正常吗	低压八十五高压一百三十正常吗
十五岁的青少年需不需要补锌	十七岁的青少年需不需要补锌
一百八十乘四十	一百八十乘一百六十
英国的城市排名	新西兰的城市排名
血压九万零一百三十正常吗	血压十万零一百三十正常吗
五十以内九的倍数	五十以内八的倍数
中行二千零二十贷款利率	中国人民银行二千零二十贷款利率
哈尔滨师范大学排名全国第几	华中师大排名全国第几
亚洲是世界上最大的洲吗	澳大利亚是世界上最大的洲吗
香港城市大学什么时候开学	香港教育大学什么时候开学
小米九的屏幕是什么	小米八的屏幕是什么
许昌学院属于哪个区	贺州学院属于哪个区
西宁到湟源县	西宁到杭州
蒙古的明星有哪些	广东的明星有哪些
科目二怎么预约考试	科目四怎么预约考试
二千零二十天津医大研究生拟录取名单	二千零二十哈尔滨医科大学研究生拟录取名单
南宁到祁阳火车时刻表	南宁到福州火车时刻表
中国的七大古都是	中国的八大古都是
华盛顿是哪国的首都	柏林是哪国的首都
成都四月份天气温度	成都五月份天气温度
二十八乘十五等	二十八乘九等
郑州属于哪个省	昆明属于哪个省
安徽财经大学mpacc分数线	安徽理工大学mpacc分数线
林本川是谁	林四娘是谁
七月英文	十月英文
西安哪里有匡威专卖店	重庆哪里有匡威专卖店
新密房价	日本房价
十二和三十五最大公因数	十二和九最大公因数
湖北大学二千零二十研究生分数线	西北大学二千零二十研究生分数线
刘伯承是谁	刘铜锣是谁
兴义到南宁高速过路费多少	成都到南宁高速过路费多少
广西疫情控制住了吗	河南疫情控制住了吗
青春路在哪里	青山路在哪里
十七乘十七	十五乘十七
四川师范大学校训	辽宁师范大学校训
小太阳幼儿园学费多少	济南幼儿园学费多少
西安低保标准	连云港低保标准
南开福建录取分数线	南昌大学福建录取分数线
国清寺有什么好玩的	清水湾有什么好玩的
翼城县属于哪个市	连城县属于哪个市
浙江海洋大学就业率	浙江理工大学就业率
河南工业大学的分数线是多少	河南大学的分数线是多少
孕一个月可以吃小龙虾吗	孕七个月可以吃小龙虾吗
三明到武昌火车时刻表	三明到昆明火车时刻表
大连职业技术学院好不好	运城职业技术学院好不好
三十八乘六	三十八乘四
外省回广东的人员需要隔离吗	外省回广西的人员需要隔离吗
昆明寺庙开放了吗	银川寺庙开放了吗
西藏有没有大学	贵州有没有大学
广州哪些公园好玩	洛阳哪些公园好玩
宁海县妇联地址	宁海县人民法院地址
内蒙古啥时候下雨	山西啥时候下雨
葫芦岛离大连多少公里	葫芦岛离沈阳多少公里
定个八点的闹钟	定个十八点的闹钟
西安公安局领导	上海公安局领导
黄兴路房价	吴兴路房价
苹果六是否支持otg	苹果十一是否支持otg
六月三日是什么节日	六月九日是什么节日
集宁到西安高铁	深圳到西安高铁
福州网吧什么时候营业	西宁网吧什么时候营业
四十五乘八	四十五乘六
十八年青岛gdp	十九年青岛gdp
一到一百的英语序数词	一到八的英语序数词
辽宁公积金提取条件	河南公积金提取条件
十九年清明节哪一天	二十年清明节哪一天
利物浦大学有什么专业	利兹大学有什么专业
金汤勺大酒店怎么样	金陵饭店怎么样
一百四十万一年利息多少	十二万一年利息多少
杭州有哪些二本大学	济南有哪些二本大学
云南师范大学研究生补助	华南师大研究生补助
西安职工医保报销比例	合肥职工医保报销比例
孕十六周肚子有多大图片	孕二十六周肚子有多大图片
山东发河北顺丰多少钱	山东发江苏顺丰多少钱
印度男女比例	几内亚男女比例
十八年上海平均工资	十九年上海平均工资
五千一百四十四大写	五千零三十四大写
中行和光大哪个好	中信和光大哪个好
抚顺有啥好玩的地方	哈市有啥好玩的地方
六十一岁属啥	三十一岁属啥
大同一中高考成绩	宣化一中高考成绩
阳历七月的是什么星座	阳历十月的是什么星座
内江到保定多少公里	内江到上海多少公里
北京协和医院急救电话	北京佑安医院急救电话
湖南帅哥多不多	湖北帅哥多不多
取消二十点的闹钟	取消晚上十点的闹钟
十八年好看的电影	十九年好看的电影
广西国考职位表二千零二十	云南国考职位表二千零二十
中午吃什么饭	明天吃什么饭
葫芦岛到江西多少公里	葫芦岛到江苏多少公里
郑州到马尔代夫	昆明到马尔代夫
广西会计初级职称考试时间	湖北会计初级职称考试时间
一百二十五乘八	一百二十五乘六
眼睛有时感觉睁不开	眼睛经常感觉睁不开
今天是几号	惊蛰是几号
四十w快充是多少a	三十w快充是多少a
apple怎么读	know怎么读
武汉住院报销比例	西安住院报销比例
虎门离塘厦有多少公里	虎门离昆明有多少公里
松江河到白河火车时刻表	西安到白河火车时刻表
连平县赶集时间表	连城县赶集时间表
南京哪里工厂最多的地方	兰州哪里工厂最多的地方
吉林邮政物流电话	广东邮政物流电话
二十天的宝宝一天拉十次	四十二天的宝宝一天拉十次
疫情对临沂房价有影响吗	疫情对西安房价有影响吗
北大排名全国第几	交大排名全国第几
南宁历届市长是谁	洛阳历届市长是谁
八个月的宝宝十八斤正常吗	八个月的宝宝十五斤正常吗
辽宁师范大学历任校长	辽宁科技大学历任校长
柘城县扫黑除恶举报电话	平邑县扫黑除恶举报电话
哪个软件可以看湖南卫视直播	哪个软件可以看东方卫视直播
睢阳区邮政编码	朝阳区邮政编码
八和十四的最大公因数短除法	十五和十四的最大公因数短除法
什么的倒数是二	什么的倒数是四
济南大学的专业排名	同济的专业排名
四川师范大学代码	西华师大代码
西安理工大学研究生分数线二千零一十九	西安交大研究生分数线二千零一十九
临沂距离沈阳多远	临沂距离重庆多远
山东离温州有多远	四川离温州有多远
怀孕三天能不能测出来	怀孕六天能不能测出来
南宁到机场打车多少钱	南宁站到机场打车多少钱
湛江海关关长	霍尔果斯海关关长
南京到福建	南京到天津
萧伯纳的名言	马克思的名言
南方人去长春能适应吗	南方人去兰州能适应吗
宜城到荆门汽车时刻表	应城到荆门汽车时刻表
你早上几点起床	你每天几点起床
一减根号三的平方	一减根号二的平方
六点二八乘三	六点二八乘二十
三点五乘五点四	三点五乘三点五
河南农业大学二千零一十九录取分数线	吉林农业大学二千零一十九录取分数线
南京中医药大学代码	南京林业大学代码
延吉到内蒙古	延吉到广东
西安哪里有算命的	石家庄哪里有算命的
南京到泗县火车时刻表	南京到北京火车时刻表
五百五十除六的竖式	八除六的竖式
新干县有哪些乡镇	勐腊县有哪些乡镇
香港大学读研一年费用	香港城市大学读研一年费用
清河县到乌鲁木齐多少公里	西安到乌鲁木齐多少公里
宁波有几个商场	遵义有几个商场
江苏到连云港多少公里	杭州到连云港多少公里
九十一年冬月初六是什么星座	九十二年冬月初六是什么星座
switch上海电信最快的dns	switch北京电信最快的dns
罗青羽的小说	于青的小说
什么减五等八	什么减九等八
庆安县属于哪个地区	香港属于哪个地区
太原师范学院历任院长	安阳师范学院历任院长
胡清越名字打分	胡夏名字打分
当阳到襄阳火车时刻表	天津到襄阳火车时刻表
徐州工业学院怎么样	常州工学院怎么样
八月十九是什么星座的	八月六是什么星座的
华为畅享十怎么长截屏	华为畅享七怎么长截屏
婴儿三天不拉屎正常吗	婴儿四天不拉屎正常吗
华莱士怎么样	菲利华怎么样
石家庄到吉林物流专线	石家庄到山西物流专线
三乘十五等多少	十五乘十五等多少
哈尔滨到重庆	上海到重庆
八乘五	八乘八
内蒙古低保一个月多少钱二千零一十九	江苏低保一个月多少钱二千零一十九
外地人在张家港怎么交社保	外地人在深圳怎么交社保
兖矿集团本科生待遇	古井集团本科生待遇
一百四十乘五十	一百四十乘六
本溪人口	鹰潭人口
二百二十代表什么含义	二百一十代表什么含义
爱情数字一百四十是什么意思	爱情数字七是什么意思
长春有几个镇	南昌有几个镇
四月十九日是什么星座	四月四日是什么星座
哈尔滨在北京什么方向	济南在北京什么方向
奔驰glc是进口的吗	奔驰gle是进口的吗
九十三年农历十二月初十生的是属什么星座	九十三年农历十二九月初十生的是属什么星座
马鞍山有几个	马鞍山火车站有几个
a五的价格	k五的价格
上海到三亚飞机几个小时	上海到杭州飞机几个小时
保定到十堰多少公里	武汉到十堰多少公里
五十五岁的男人喜欢什么样的女人	五十二岁的男人喜欢什么样的女人
四川事业单位考试分数	陕西事业单位考试分数
浙大江苏录取分数线	浙江师范大学江苏录取分数线
二尺九是多少cm	二尺八是多少cm
覃的多音字	晏的多音字
青岛到重庆自驾路线	青岛到郑州自驾路线
皖南医学院分数线	蚌埠医学院分数线
九十九年农历十月十七是什么星座	九十九年农历十月十四是什么星座
产后四十天来月经正常吗	产后四十二天来月经正常吗
西安哪里有匡威专卖店	郑州哪里有匡威专卖店
开普勒三个定律	普勒三个定律
今年满六十七岁属什么生肖	今年满二十七岁属什么生肖
七月七日是什么节	七月一日是什么节
河南到兰州多少公里路	河南到北京多少公里路
图形的放大与缩小只改变什么	图形的放大与缩小不改变什么
沂水一中怎么样	临沂一中怎么样
香港大学研究生有哪些专业指南者	香港科技大学研究生有哪些专业指南者
南京有多少三甲医院	南宁有多少三甲医院
枣庄服装厂哪里多	中国服装厂哪里多
二十八岁用什么护肤品	二十六岁用什么护肤品
十九年河南师范大学艺术类录取分数线	十九年南京师大艺术类录取分数线
四平东到丹东动车时刻表	四平东到北京动车时刻表
十五年比亚迪f三是国几	十六年比亚迪f三是国几
苹果xr不能连接wifi	苹果xs不能连接wifi
根号六	根号四
垫江到梁平多少公里	成都到梁平多少公里
中国明代名医	中国现代名医
西安石油大学二千零一十九录取分数线	西安石油大学二千零一十七录取分数线
河南农业大学二千零一十九录取分数线	华南农业大学二千零一十九录取分数线
上原梨奈作品	上原优作品
陕西师大收费标准	河南师范大学收费标准
餐后两小时血糖标准	餐后五小时血糖标准
二十年洛阳什么时候开始限号	二十年太原什么时候开始限号
石家庄哪里可以借钱	西安哪里可以借钱
增城区有什么景点	望城区有什么景点
北京到雄县有多少公里	北京到青岛有多少公里
一千八百四十八年有什么大事发生	一千八百四十九年有什么大事发生
五除十二乘九	一除十二乘九
帮我设置一个十二点半的闹钟	帮我设置一个十二点的闹钟
义乌到佛山快递要多久	义乌到福州快递要多久
苹果七什么时候上市	苹果五什么时候上市
昆明蹦极多少钱	贵阳蹦极多少钱
三分之一加五分之两	四分之一加五分之两
现代建筑的特点	近代建筑的特点
哪里和中国时差一小时	哪里和中国时差六小时
台骀山有什么好玩的地方	台山市有什么好玩的地方
世界四大古典芭蕾舞剧	世界三大古典芭蕾舞剧
佛山到新乡高铁时刻表	佛山到重庆高铁时刻表
福建地理知识	甘肃地理知识
月经推迟七天了怎么办	月经推迟四天了怎么办
达州火车时刻表	锦州火车时刻表
吉林农业大学是几本	吉利大学是几本
惠州到商丘多少公里	惠州到香港多少公里
十八年新增人口	十九年新增人口
上海十九年度社会平均工资	北京十九年度社会平均工资
苹果六怎么设置来电铃声	苹果七怎么设置来电铃声
扬子江药业股票代码	以岭药业股票代码
天津中考成绩	西宁中考成绩
清明节是几月几日二十年	清明节是几月几日二十一年
六除五	六除七
龙口到成都	龙口到长沙
做人流第一天可以吃榴莲吗	做人流第四天可以吃榴莲吗
四川到汕头	江西到汕头
陕西区域代码	辽宁区域代码
漯河到衡阳的火车票	漯河到衡水的火车票
梦幻西游一百五十武器可以转换造型吗	梦幻西游一百六十武器可以转换造型吗
八年级英语五单元两b翻译	八年级英语九单元两b翻译
属鼠九月出生命运如何	属鼠十月出生命运如何
白细胞酯酶一加	白细胞酯酶三加
十八点是几点	昨天是几点
二十年脱贫标准	二十一年脱贫标准
九百减七百三十五等几	一减七百三十五等几
商丘师范学院河南排名	周口师范学院河南排名
五加几等十三怎么	七加几等十三怎么
惠东县最繁华的地方	日本最繁华的地方
四十一年什么年	四十二年什么年
佛山西离狮山镇有多远	佛山西离广州有多远
西亚的人口主要分布在	俄罗斯的人口主要分布在
国贸中心附近的小区	北京国贸附近的小区
蔡春妮是哪部电视剧	蔡晓春是哪部电视剧
形容十三岁	形容十六岁
十八岁适合什么面膜	十五岁适合什么面膜
两点目前湖泊等水体富营养化的原因主要是由排放的大量氮和磷所造成	六点目前湖泊等水体富营养化的原因主要是由排放的大量氮和磷所造成
上饶县的发展潜力	中国的发展潜力
湖南城市学院是几本	湖南大众传媒学院是几本
北京第二外国语学院分数线二千零一十九	越秀外国语学院分数线二千零一十九
五月十四生日是什么星座	五月五生日是什么星座
长沙去南京	洛阳去南京
葫芦岛是属于哪个省	湖北是属于哪个省
二十年武汉音乐学院研究生分数线	二十年清华研究生分数线
怀孕十周孕酮十七正常吗	怀孕十周孕酮十六正常吗
七十三年有没有发生过什么重大事件	七十四年有没有发生过什么重大事件
大连大学计算机专业分数线	大连民族大学计算机专业分数线
合肥哪里有心理医生比较好的	成都哪里有心理医生比较好的
桂林医学院口腔专业分数线	牡丹江医学院口腔专业分数线
植树节的由来一百字	植树节的由来三十字
大同到赤城多少公里	大同到天津多少公里
左侧乳房特别疼	左侧乳房有点疼
苹果七plus参数	苹果八plus参数
哈尔滨到延吉高铁	哈尔滨到石家庄高铁
湖北电视台帮忙热线	石家庄电视台帮忙热线
八下英语六单元重点句子	八下英语一单元重点句子
iphone八plus换屏幕多少钱	iphone六plus换屏幕多少钱
浙江的专科大学	内蒙古的专科大学
六个月宝宝鼻塞咳嗽怎么办	两月宝宝鼻塞咳嗽怎么办
怎么求六和十五的最小公倍数	怎么求六和八的最小公倍数
一和九最大公因数	一和二十五最大公因数
十九年中考录取分数线武汉	十九年中考录取分数线兰州
德州到苏州的火车票	德州到上海的火车票
刘亦菲是谁	吴亦凡是谁
三天没有大便了怎么办	二天没有大便了怎么办
广东到云南的运费	广东到吉林的运费
牟定一中校长	乌苏一中校长
西北政法大学是不是九百八十五	华东政法大学是不是九百八十五
云南财经大学会计专业排名	上海财大会计专业排名
阜阳十大景点	日本十大景点
八十三乘五十五	八十三乘零
九十二除三	九十二除四
十五除三十二等多少	三除三十二等多少
黄山到宁夏多少公里	黄山到大连多少公里
十九年何时打春	二十年何时打春
海淀区离八达岭有多远	海淀区离北京有多远
华南农业大学研究生开学时间	华南师大研究生开学时间
中通市值多少亿	微软市值多少亿
无锡到临沂开车几个小时	深圳到临沂开车几个小时
四十五加十九	四十五加十三
郑州三十九中分数线	郑州十九中分数线
江阴一路公交车路线图	江阴十路公交车路线图
十八年杭州人均可支配收入	十八年江苏人均可支配收入
三天不排便怎么办	六天不排便怎么办
重庆到多哈机票多少钱	重庆到泰国机票多少钱
二十二周可以做四维彩超吗	二十三周可以做四维彩超吗
农历六月十四是几月几日	农历六月十三是几月几日
宜昌到石家庄火车时刻表查询	宜昌到兰州火车时刻表查询
一百二十乘六十等	一百二十乘三十等
七十二乘一千	七十二乘一百零二
无锡到商丘多远	乌鲁木齐到商丘多远
阴历四月初十八是什么日子	阴历四月初四是什么日子
成都到安康多远	成都到南昌多远
湖州师范学院二千零一十九分数线	湖南师大二千零一十九分数线
上海财大就业率	天津财经大学就业率
七十一年出生的是属什么的	七十二年出生的是属什么的
张京云是男是女	张芸京是男是女
零字有几种写法	壹字有几种写法
考研英语一推荐资料	考研英语二推荐资料
重庆有什么称号	济南有什么称号
十五乘三	十五乘四
零点四八除六	零点四八除四
面试是否通过的暗示	面试不通过的暗示
农历十月二十二什么星座	农历五月二十二什么星座
内蒙古工业大学一本专业	安徽工业大学一本专业
四川十九年公务员考试职位表	四川二十年公务员考试职位表
西安到韩城汽车	西安到广州汽车
国历五月一日是什么星座	国历五月四日是什么星座
龙江县法院电话	龙江县政府电话
武汉内痔疮怎么治疗	南昌内痔疮怎么治疗
赤峰看男科的医院哪个好	无锡看男科的医院哪个好
近视四百度看到的画面	近视三百度看到的画面
合肥到丽江飞机票	广州到丽江飞机票
内蒙古民族大学多少分	大连民族大学多少分
0四十三万二千八百七十八x哪里区号	0四十三万一千八百七十八x哪里区号
六月九日是什么星座	三月九日是什么星座
呼和浩特到集宁动车	呼和浩特到成都动车
十九年排名最穷省	二十年排名最穷省
假如四代火影来到博人传的时间线三	假如四代火影来到博人传的时间线四
姓徐的男孩名字洋气	姓杨的男孩名字洋气
苹果八后玻璃碎了多少钱	苹果七后玻璃碎了多少钱
主角叫李凌天的玄幻小说	主角叫凌天的玄幻小说
四十五乘九	四十五乘二十
苹果八的屏幕分辨率	苹果十二的屏幕分辨率
河南理工大学会计学怎么样	南理工会计学怎么样
直肠癌术后十天大便带血	直肠癌术后两个月大便带血
十七和三十二的最大公因数	十六和三十二的最大公因数
淮安电话区号	泰安电话区号
今天天气晴吗	明天天气晴吗
泉州到于都的动车	泉州到深圳的动车
今天江苏有雨吗	今天山东有雨吗
六除十化成小数	五除十化成小数
工行星期六上班吗	招行星期六上班吗
一百四十八的因数有几个	三的因数有几个
井冈山大学什么时候开学	温州大学什么时候开学
操场的面积大约是一万二千	操场的面积大约是三
重庆哪里可以鉴定翡翠	长春哪里可以鉴定翡翠
零点八十三化成分数	五点八十三化成分数
南开福建录取分数线	南京大学福建录取分数线
涡阳到扬州多少公里	涡阳到蚌埠多少公里
十六开和二十二开哪个大	十六开和四开哪个大
广州燃气安装收费标准	长沙燃气安装收费标准
三和六分解质因数	五和六分解质因数
七十七年出生男演员	七十八年出生男演员
一分钟可以做什么事情	三分钟可以做什么事情
中国好声音徐州歌手	中国好声音唐山歌手
济南到湖南高铁	济南到兰州高铁
广州在那里	南京在那里
晋城离阳泉有多远	晋城离合肥有多远
怀孕初期肚子隐隐疼	怀孕初期肚子总是疼
传祺ga五多少钱	传祺gs五多少钱
珠海和佛山哪个发达	珠海和东莞哪个发达
一千减八等多少	五减八等多少
福州娱乐场所什么时候恢复营业	西宁娱乐场所什么时候恢复营业
九十三年正月二十六是阳历多少	九十四年正月二十六是阳历多少
江西医学院排名多少	长沙医学院排名多少
漯河到衡阳的火车票	重庆到衡阳的火车票
荣耀十什么时候上市	荣耀三什么时候上市
八月十四日什么星座	七月十四什么星座
二十四小时多少分	五小时多少分
成都磨骨瘦脸手术多少钱	天津磨骨瘦脸手术多少钱
成都至广州的火车	成都至福州的火车
郑州到江西火车票	郑州到石家庄火车票
四百零五除两	八除两
湖北什么时候实行国六	辽宁什么时候实行国六
苹果六可以越狱吗	苹果八可以越狱吗
钦州到岑溪有多少公里	钦州到上海有多少公里
房管局是干啥的	交管局是干啥的
新乡医学院大专分数线	桂林医学院大专分数线
南山村怎么样	南庄村怎么样
工行崇州网点	工行深圳网点
日本侵占上海是哪一年	日本侵占台湾是哪一年
建行怎么修改手机号码	中行怎么修改手机号码
二百一十乘三十	二百一十乘五
同济与山大哪个好	同济与东南大学哪个好
十月一日是什么星座	九月一日是什么星座
呼和浩特有什么特色	长沙有什么特色
常州到张家港车票多少钱	连云港到张家港车票多少钱
临沂到丽水物流	临沂到江苏物流
通江到成都有多少公里	西安到成都有多少公里
吉林体育学院多大面积	河北体育学院多大面积
二十年黑龙江退休人员涨工资	二十年贵州退休人员涨工资
二点五乘二点五乘三点一四	二点五乘二点五乘三点五
建瓯到南平多少公里	北京到南平多少公里
深圳和旧金山的时差	深圳和新加坡的时差
一月九日是什么星座	三月九日是什么星座
黑龙江可以打hpv疫苗吗	台湾可以打hpv疫苗吗
信阳离阜南县有多远	信阳离厦门有多远
十八年的古装电视剧有哪些	十九年的古装电视剧有哪些
云南民族大学属于几本	大连民族大学属于几本
一加六怎么换电池	一加三怎么换电池
一个字名字好听	三个字名字好听
中移动云视讯怎么收费	移动云视讯怎么收费
十二月四日是什么星座	五月四日是什么星座
吴忠是哪个省	黑龙江是哪个省
亚马孙河的河流流向	日本的河流流向
广东养殖基地	云南养殖基地
安徽哪里产盐	山东哪里产盐
十楼跳下去会死吗	五楼跳下去会死吗
涉县叫车电话	故城县叫车电话
安徽师范大学全国排名二千零一十九	江西师范大学全国排名二千零一十九
福州医院隆鼻多少钱	武汉医院隆鼻多少钱
十四乘五等多少	十四乘十四等多少
外地人可以在慈溪高考吗	外地人可以在广州高考吗
湖南公积金最高贷款额度	山西公积金最高贷款额度
徐州到宁波汽车时刻表	郑州到宁波汽车时刻表
glc奔驰价格	gls奔驰价格
六十八年阳历三月十五阴历是几月初几	六十八年阳历三月十五阴历是几七月初几
拔牙第二天可以刷牙吗	拔牙第三天可以刷牙吗
我的手机早就没电了	我的手机快没电了
十五乘二十	十六乘二十
快递广州到福州要多久	快递广州到山东要多久
广州南到榕江	广州南到南海
朱梅的歌曲	韩梅梅的歌曲
沈阳修锁换锁电话多少	上海修锁换锁电话多少
洛阳新八景	西宁新八景
南京邮电大学什么水平	南京大学什么水平
定一个五点的铃	定一个四点的铃
小腹有点疼	小腹一直疼
长沙肉类批发市场在哪里	广州肉类批发市场在哪里
中国和俄罗斯的贸易	中国和澳大利亚的贸易
贵大浙江录取分数线	兰大浙江录取分数线
七十六年的多少岁	七十七年的多少岁
二十五岁心跳六十次正常吗	三十五岁心跳六十次正常吗
苹果七如何打开后台	苹果十一如何打开后台
东南亚的经纬度	日本的经纬度
广东卫视直播节目表	北京卫视直播节目表
叠石桥哪个牙科好	大石桥哪个牙科好
洪家楼有什么好玩的	澳门有什么好玩的
兖州到莱西火车时刻表	兖州到哈尔滨火车时刻表
黑龙江十二年义务教育什么时候开始	辽宁十二年义务教育什么时候开始
华中科大本科分数线	中国医科大学本科分数线
西京医院体检电话	北医三院体检电话
北京协和医院的分数线	北京联合大学的分数线
广州火车站到驻马店	重庆到驻马店
八开头的网名两个字	一开头的网名两个字
附近天津银行网点	附近民生银行网点
战狼三出品方和发行方	战狼一出品方和发行方
天津到成都的物流	天津到长沙的物流
sumn什么意思	bomn什么意思
中行亲属回避政策	农行亲属回避政策
合肥到恩施飞机	武汉到恩施飞机
孕二十六周存活率	孕二十八周存活率
八月四日农历	四月四日农历
十九年绵羊毛行情	二十年绵羊毛行情
二十年四月四号新闻内容	二十年四月六日新闻内容
云南最大矿山	安徽最大矿山
山东各大学什么时候开学	广西各大学什么时候开学
贵阳到桐梓过路费多少钱	贵阳到上海过路费多少钱
德州到三亚多少公里	德州到上海多少公里
仓一小怎么样	仓四小怎么样
王骞是哪里人	王小骞是哪里人
根号一千一百六十九	根号一千一百七十九
济南灯具批发市场在哪	武汉灯具批发市场在哪
常熟菜鸟电话	石家庄菜鸟电话
贵州师范学院多大	湖州师范学院多大
江西财经大学改名	西南财大改名
iphone六plus换电池	iphone八plus换电池
两万八千加币等多少人民币	两万四千加币等多少人民币
英国有没有沙漠	智利有没有沙漠
昆山到连云港汽车票	重庆到连云港汽车票
安信证券费率多少	广发证券费率多少
四十除四的竖式计算	八除四的竖式计算
拉肚子很严重	拉肚子不严重
丽江离重庆有多远	丽江离南宁有多远
重庆蔬菜价格	石家庄蔬菜价格
心脏经常刺痛	心脏有点刺痛
新干县有哪些乡镇	新邵县有哪些乡镇
烟台汽车划痕修复	西宁汽车划痕修复
血压一百三十除一百正常吗	血压九十除一百正常吗
济南律师平均收入	郑州律师平均收入
六和十一的最小公倍数	三和十一的最小公倍数
十和五的最大公因数和最小公倍数是多少	九和五的最大公因数和最小公倍数是多少
镇海中学有多少学生	鄱阳中学有多少学生
苹果六plus照相机黑屏	苹果七plus照相机黑屏
离扬州最近的古镇	离天津最近的古镇
泰山到新乡的火车时刻表查询	泰山到上海的火车时刻表查询
湘潭有哪些区	新乡有哪些区
新疆医科大学代码	大连医科大学代码
上海到广西高铁	上海到湖南高铁
九十三年红酒价格	九十四年红酒价格
石渠县有几个乡镇	石门县有几个乡镇
山东到成都邮费	山东到杭州邮费
几除几等零	几除几等六
河南媒体求助电话	浙江媒体求助电话
第一财经日报电话	红河日报电话
开封到聊城的火车	开封到厦门的火车
涟水高档小区有哪些	香港高档小区有哪些
黑龙江最新开学时间通知	山西最新开学时间通知
宝宝反复低烧	宝宝偶尔低烧
乌鲁木齐传祺四s店地址	成都传祺四s店地址
十八和三十五的最大公因数是多少	一和三十五的最大公因数是多少
从昆明到西安有多少公里	从南宁到西安有多少公里
西安大悦城在哪个区	天津大悦城在哪个区
八十二乘三十二	八十二乘五
乙肝表面抗体多少不正常	乙肝表面抗体多少才正常
四个月宝宝流鼻涕打喷嚏怎么办	十月宝宝流鼻涕打喷嚏怎么办
科二雾灯怎么开	科三雾灯怎么开
泉州师范学院是一本吗	齐鲁师范学院是一本吗
江西事业单位考几门	陕西事业单位考几门
苹果售后服务网点洛阳	苹果售后服务网点太原
十四因数有哪些数	五因数有哪些数
火锅汤放三天还能吃吗	火锅汤放一天还能吃吗
六十二除五	六十二除三
济南二十年中考政策	济南二十一年中考政策
房子买十四楼好不好	房子买五楼好不好
福州广播主持人名单	重庆广播主持人名单
四川警校招生条件	成都警校招生条件
哈工大税号	湖南工业大学税号
十一月十四日的人适合什么时候结婚	十一点十四分的人适合什么时候结婚
浦东新区的邮编	中国的邮编
哈萨克斯坦零食	西班牙零食
设置五点四十的闹铃	设置六点四十的闹铃
包头医学院面积	海南医学院面积
零点五乘零点五	零点八乘零点五
哈尔滨到青岛高铁多长时间	哈尔滨到石家庄高铁多长时间
两个月宝宝三天没拉大便怎么办	两个月宝宝一天没拉大便怎么办
宜昌人口二千零二十	香港人口二千零二十
南昌大学有院士吗	江南大学有院士吗
一个西瓜的体积约是一百二十	一个西瓜的体积约是三
什么是甲功三项	什么是甲功四项
北京至长沙机票	北京至成都机票
山东卫视播放过的电视剧	浙江卫视播放过的电视剧
成都晚上去哪里玩	上海晚上去哪里玩
三十六℃算低烧吗	三十二℃算低烧吗
怎样用手机看湖南卫视直播	怎样用手机看江苏卫视直播
查干湖到哈尔滨多少公里	天津到哈尔滨多少公里
最近来广州的明星有哪些	最近来天津的明星有哪些
包头至西安飞机票	包头至深圳飞机票
十二岁女孩还会长高吗	十六岁女孩还会长高吗
苏州公积金缴存基数	遵义公积金缴存基数
盐城到淮安汽车	盐城到昆明汽车
二十楼层风水好不好	六楼层风水好不好
开封离郑州远吗	广州离郑州远吗
从昌黎到成都有多少公里	从合肥到成都有多少公里
脑出血第一天	脑出血第七天
中国农大兽医研究生分数线	湖南农业大学兽医研究生分数线
吉林体育学院多大面积	南京体育学院多大面积
四川师范大学校训	湖南师大校训
信丰到西安多少公里	沈阳到西安多少公里
小米八关机键失灵修复方法	小米六关机键失灵修复方法
通辽到郑州多远	长沙到郑州多远
二十乘一点五	五乘一点五
高密到银川火车时刻表	高密到天津火车时刻表
一平方等多少安	四平方等多少安
安徽现在哪里好玩	黑龙江现在哪里好玩
三的后面是多少	一百的后面是多少
汇丰银行待遇怎么样	交行待遇怎么样
杭州到天津多少公里	杭州到长沙多少公里
咸阳好玩的地方推荐	衡阳好玩的地方推荐
昆山疫情电话	绍兴疫情电话
东航白云机场几号航站楼	海航白云机场几号航站楼
r十一乘九	r十一乘五
建行怎么设置人脸识别	百度怎么设置人脸识别
河南附近有什么旅游景点	山东附近有什么旅游景点
王羲之是哪个朝代的人	王之涣是哪个朝代的人
东营去哪里好玩	北京去哪里好玩
广州人少的公园	昆明人少的公园
东北大学详细地址	西北大学详细地址
荣耀手环四重启	荣耀手环三重启
湖南大学文科优势专业	湖北大学文科优势专业
中国民生银行资产总额	国家开发银行资产总额
四个月宝宝发烧怎么办	七月宝宝发烧怎么办
从哈尔滨到北京的机票	从哈尔滨到昆明的机票
六岁发烧三十九度怎么办	八岁发烧三十九度怎么办
徐州到济南的飞机票多少钱	徐州到广州的飞机票多少钱
湖北到郑州有多少公里	湖北到大连有多少公里
南理工书记	重庆理工大学书记
重庆换工作医保断了三个月	武汉换工作医保断了三个月
两号地铁路线福州	两号地铁路线南京
广州天气如何	洛阳天气如何
六十乘一百二十cm是什么意思	八十乘一百二十cm是什么意思
曲靖到马关	曲靖到新疆
科一好过嘛	科三好过嘛
药流第二天可以洗头吗	药流第八天可以洗头吗
餐后两小时血糖八点七	餐后三小时血糖八点七
西安到洋县多少公里	西安机场到洋县多少公里
西宁到北京的飞机票价	洛阳到北京的飞机票价
低压五十高压一百正常吗	低压六十高压一百正常吗
五分类血液分析仪价格	三分类血液分析仪价格
浙商银行董事长	徽商银行董事长
六十三年两月十日是什么星座	六十四年两月十日是什么星座
成都周边哪里可以爬山	南宁周边哪里可以爬山
拉萨至丽江机票	南昌至丽江机票
洛杉矶是哪个州	横滨是哪个州
东北电力大学专业设置	东北农大专业设置
a七十三包装清单	a七十二包装清单
鞍山师范学院怎么样	淮南师范学院怎么样
八十八除六的竖式怎么列	八十八除五的竖式怎么列
删除十点半的闹钟	删除十点的闹钟
两的九次方怎么算	两的十次方怎么算
合肥区gdp	长沙区gdp
大连到南昌的高铁	长沙到南昌的高铁
wife是什么词	safe是什么词
江苏到福建邮费	江苏到河北邮费
儿子六岁祝福语	儿子三岁祝福语
西安那些医院是三甲医院	重庆那些医院是三甲医院
辽宁最大民营企业	甘肃最大民营企业
湖州到婺源多少公里	湖州到上海多少公里
三年级用什么笔	五年级用什么笔
芜湖县有火车站吗	房县有火车站吗
南京在哪个省份	南宁在哪个省份
给老董打电话	给董军打电话
五十乘六等多少	五十乘一百等多少
保定到洛阳火车票	佛山到洛阳火车票
焦作电大全称	焦作大学全称
科目二怎么才能过	科目一怎么才能过
一档社保跟三档社保的区别	一档社保跟二档社保的区别
安徽什么大专好	福建什么大专好
ipadmini五分辨率	ipadmini三分辨率
长春看妇科哪家好	石家庄看妇科哪家好
南京四大名校高中	西安四大名校高中
最有意义的四个字	最有意义的五个字
雅安到西昌大巴坐多久	成都到西昌大巴坐多久
月经推迟六天了验孕棒显示没怀孕	月经推迟五天了验孕棒显示没怀孕
西北民族大学有多少学生	西北师大附中有多少学生
十一月七号是星期几	十一月十七号是星期几
白细胞一点二十八	白细胞一点二十六
二千零一十七春晚主持人名单	二千零一十八春晚主持人名单
婴儿老放屁是怎么回事	婴儿不放屁是怎么回事
华农录取分数	华中师大录取分数
西安的体检中心有哪些	石家庄的体检中心有哪些
四边形的面积如何求	五边形的面积如何求
二百五十乘二	二百五十乘六十
零是复数吗	九是复数吗
阳历七月二十一号什么星座	阳历七月什么星座
南充到重庆	南充到太原
兰州那个省	洛阳那个省
南京到景德镇火车票	南京到郑州火车票
广州中考录取规则	合肥中考录取规则
二千零一十九西北大学艺术录取分数线	二千零一十九西北政法大学艺术录取分数线
威海有哪些日企	无锡有哪些日企
西安有哪些山	天津有哪些山
南山村怎么样	吉祥村怎么样
宣城到菏泽火车时刻表	宣城到深圳火车时刻表
馆陶县属于哪里	夏邑县属于哪里
佳木斯到金州的火车票	佳木斯到厦门的火车票
小孩反复发烧	小孩偶尔发烧
十七里地是多远	一百里地是多远
玉溪哪里的烧烤好吃	德州哪里的烧烤好吃
怀孕一个月可以药流吗	怀孕八十天可以药流吗
万州到湖北	万州到广州
安徽各城市人口	浙江各城市人口
成都到上海的动车	合肥到上海的动车
六月三十日是什么座	六月四日是什么座
二十五乘三十二加四	二十五乘五加四
北京物资学院一本还是二本	北京舞蹈学院一本还是二本
郑州的上市公司名单	洛阳的上市公司名单
七年闺蜜生日祝福语	五年闺蜜生日祝福语
十九乘三	十九乘十九
无锡公交卡充值点营业时间	成都公交卡充值点营业时间
快递从浙江到漯河要多久	快递从浙江到江苏要多久
小孩子偶尔流鼻血是怎么回事	小孩子老是流鼻血是怎么回事
网易和腾讯哪个市值高	百度和腾讯哪个市值高
总是打嗝怎么办	偶尔打嗝怎么办
血压一万一千零六十一正常吗	血压一百正常吗
江西疫情严重吗	新疆疫情严重吗
删除六点十分的闹钟	删除六点四十分的闹钟
启赋三段适合多大宝宝	启赋五段适合多大宝宝
龙虎山到长沙多少公里	北京到长沙多少公里
本田什么道	五羊本田什么道
天津到偃师火车时刻表	天津到北京火车时刻表
八月二十七日是什么星座	八月一日是什么星座
西南交大校长级别	西安交大校长级别
九月一是什么日子	九月五是什么日子
兰州到山东多少公里	兰州到沈阳多少公里
一加七是什么字	一加八是什么字
黄山到宁夏多少公里	黄山到福州多少公里
达州到广州途径哪些站	达州到南京途径哪些站
河北高考五百分难吗	河南高考五百分难吗
十九年黑龙江长	二十年黑龙江长
英国大还是美国大	日本大还是美国大
温县律师电话	上海律师电话
南阳到合肥距离	南阳到哈尔滨距离
北京工商大学计算机专业怎么样	南京工业大学计算机专业怎么样
湖南师大具体地址	辽宁师范大学具体地址
河北大学软件工程怎么样	西北大学软件工程怎么样
五和八和十最小公倍数	四和八和十最小公倍数
华中师大考研录取分数线	华南师大考研录取分数线
海大什么专业最好	南京大学什么专业最好
金寨到贵阳的高铁	金寨到济南的高铁
北京租房公积金提取额度	成都租房公积金提取额度
泰州到山海关火车站时刻表	兖州到山海关火车站时刻表
一百零五除三	一百零五除五
绵阳财政收入二千零一十九	常州财政收入二千零一十九
六十八年正月十二阳历	六十八年正月十六阳历
一除八的通分	六除八的通分
川大和北航哪个好	川大和哈工大哪个好
广东到海口需要隔离吗	河北到海口需要隔离吗
十一点十五日什么星座	两点十五日什么星座
七万二千米每小时等多少米每秒	一千米每小时等多少米每秒
古代七大文体	古代三大文体
湖南师大具体地址	云南师范大学具体地址
南昌去苏州	洛阳去苏州
既是两的倍数又是五的倍数有哪些	既是两的倍数又是十的倍数有哪些
南京到武当山	昆明到武当山
桐乡到临平怎么坐车	杭州到临平怎么坐车
泾源有啥好玩的地方	香港有啥好玩的地方
六月二十七日什么星座	六月十七什么星座
四字歌名疯狂猜歌	七字歌名疯狂猜歌
潍坊到安徽有多少公里	潍坊到济南有多少公里
济南到合肥高铁时刻表查询	成都到合肥高铁时刻表查询
月山到济南火车时刻表	北京到济南火车时刻表
上海到屯溪火车	上海到合肥火车
昆山离黑龙江多少公里	昆山离杭州多少公里
郑州机动车迁入标准	南京机动车迁入标准
国航股票能买吗	中国中铁股票能买吗
零零年九月份现在多少岁	零零年四月份现在多少岁
昆明的电影院	长沙的电影院
七十七除四等多少	八除四等多少
六安到许昌	六安到大连
东京大学交换生项目	东华大学交换生项目
二十八和七十八的最大公因数	七十八和七十八的最大公因数
小米十怎么关闭打字震动	小米八怎么关闭打字震动
南宁高校排名	天津高校排名
带六的结拜称号	带七的结拜称号
常德晚上哪里有好吃的地方	重庆晚上哪里有好吃的地方
佛山离唐山多远	佛山离杭州多远
遵义医学院怎么样	滨州医学院怎么样
港头镇属于哪个县	林头镇属于哪个县
五千三百一十是哪里的身份证	五千三百二十是哪里的身份证
usdt价格昨日行情	usdt价格今日行情
北魏是国家吗	西周是国家吗
浙江传媒学院帅哥多吗	浙江警察学院帅哥多吗
二十年江苏大学生开学时间	二十年湖南大学生开学时间
北理工各专业分数线	沈阳理工大学各专业分数线
成都到拉萨高铁时刻表查询	成都到杭州高铁时刻表查询
遵义医学院全国排名	蚌埠医学院全国排名
情人湾在哪里	情人崖在哪里
重庆到泸沽湖自驾游攻略	重庆到长沙自驾游攻略
湖南大学二千零一十九江苏录取分数线	湘潭大学二千零一十九江苏录取分数线
五年定期提前一年取出	三年定期提前一年取出
小米六nfc功能	小米四nfc功能
猫咪可以不吃罐头吗	猫咪可以只吃罐头吗
七十一年属什么生肖配对	七十二年属什么生肖配对
中国平安成立于哪一年	中国平安银行成立于哪一年
独山有什么好吃的小吃	中国有什么好吃的小吃
界龙实业是做什么的	荣华实业是做什么的
呼和浩特的气温	兰州的气温
中卫到武汉火车时刻表	中卫到成都火车时刻表
十九周肚子发紧发硬	三十九周肚子发紧发硬
今日西宁油价调整最新消息	今日重庆油价调整最新消息
贵阳八中在哪	郑州八中在哪
虎门到小榄多少公里	虎门到兰州多少公里
一千六百六十ti好还是一千零六十ti好	一千六百六十ti好还是一千零八十ti好
广州哪里有蹦极	西安哪里有蹦极
草蜢乐队主唱	train乐队主唱
湖南城市学院是几本	湖南商学院是几本
身体老是发热	身体有点发热
奔驰gls多少钱	奔驰glc多少钱
秦皇岛到塘沽火车时刻表	哈尔滨到塘沽火车时刻表
乌鲁木齐的明星	重庆的明星
产后第一天吃什么	产后第九天吃什么
南京到鄱阳多少公里	南京到西安多少公里
南昌到济宁的火车	南昌到天津的火车
昭通到广西多少公里	昭通到西藏多少公里
衡阳离贵州有多远	南京离贵州有多远
交通事故八级伤残标准	交通事故九级伤残标准
七十七年的一分硬币值多少钱	七十八年的一分硬币值多少钱
昌都到重庆多少公里	哈尔滨到重庆多少公里
江西农业大学不开学	湖南农业大学不开学
六分之十四怎么约分	六分之三怎么约分
云南艺术学院在江西招多少人	云南艺术学院在山西招多少人
南亚的人口分布	加拿大的人口分布
一百四十万一年利息多少	二十万一年利息多少
西安到玉溪多少公里	洛阳到玉溪多少公里
贵阳离郑州	福州离郑州
河北大学多少学生	河北地质大学多少学生
都匀到郑州多少公里	都匀到银川多少公里
以色列周边有哪些国家	俄罗斯周边有哪些国家
丹东到青岛汽车	成都到青岛汽车
江苏在安徽的哪边	山东在安徽的哪边
狄波拉身高	狄拉克身高
西安到长沙开车多久	深圳到长沙开车多久
唐山到锦州火车时刻表查询	唐山到武汉火车时刻表查询
石家庄公积金贷款买房需要什么条件	昆明公积金贷款买房需要什么条件
奔驰cl三百五十多少钱	奔驰ml三百五十多少钱
贵州会计人员信息采集截止时间	湖北会计人员信息采集截止时间
一百零五除二	一百零五除五
石家庄二手小货车价格及图片	贵阳二手小货车价格及图片
经常打嗝怎么办	偶尔打嗝怎么办
甲状腺五项检查什么	甲状腺八项检查什么
现在湖北人能去温州吗	现在湖北人能去广州吗
西安电信光纤套餐价格表	重庆电信光纤套餐价格表
汉中到石家庄高铁	汉中到郑州高铁
十九年河南高考多少人	十九年浙江高考多少人
邢台新市长	呼和浩特新市长
十除六十等几分之几	十除二十等几分之几
从广州回大连需要隔离吗	从西安回大连需要隔离吗
庐山的来历	苍岩山的来历
临沂到桂林火车时刻表	临沂到济南火车时刻表
七十一年腊月十八是什么属像	七十二年腊月十八是什么属像
浙江会是哪	新疆省会是哪
苹果八面部识别怎么设置不了	苹果十一面部识别怎么设置不了
科四考不过怎么办	科一考不过怎么办
长沙到顺德高铁	长沙到杭州高铁
延庆一中二千零一十八高考成绩	长垣一中二千零一十八高考成绩
三十七度五是低烧吗	三十七度三是低烧吗
内蒙古师范大学所有专业	安徽师范大学所有专业
十九年茂名gdp	十九年美国gdp
八十五年十月初三是几月几号	八十五年九月初三是几月几号
南宁到成都飞机票多少钱一张	南京到成都飞机票多少钱一张
哈工业大学排名	辽宁工业大学排名
于山宾馆电话	相山宾馆电话
吉安到襄阳	吉安到西藏
南昌是哪儿	福州是哪儿
番禺到广州南站要多久	深圳到广州南站要多久
二千零一十九河南艺考文化课分数	二千零一十八河南艺考文化课分数
三百二十kb等多少mb	八十kb等多少mb
四除五是什么拍子	八除五是什么拍子
苏州积分入户流程	苏州新区积分入户流程
十九斤是多少千克	十八斤是多少千克
长沙生鲜配送公司排名	成都生鲜配送公司排名
大连大学录取分数线	牡丹江大学录取分数线
济南公寓水电价格	武汉公寓水电价格
北京到石家庄快递几天	北京到武汉快递几天
空军雷达学院地址	桂林空军学院地址
南昌好玩的地方	长沙好玩的地方
适合甘肃种植的葡萄	适合广西种植的葡萄
k一尺寸	t一尺寸
浙商银行信用卡还款日期	徽商银行信用卡还款日期
西北农大二十年什么时候开学	浙江农林大学二十年什么时候开学
南昌比较好玩的地方	哈尔滨比较好玩的地方
三月二十六日什么星座	三月八日什么星座
十八除三写作	六除三写作
环江有几个镇	香港有几个镇
第一个字是敷的成语有哪些	第三个字是敷的成语有哪些
十八年十二月结婚吉日	十九年十二月结婚吉日
究极风暴三角色	究极风暴四角色
十二和三十五最大公因数	十二和四最大公因数
南京财经大学在哪里	南华大学在哪里
什么软件可以看湖南卫视直播	什么软件可以看江苏卫视直播
身份证还有三天到期	身份证还有一周到期
什么是三大四小	什么是一大四小
西宁哪里能治癫痫	银川哪里能治癫痫
历史上姓翟的名人有哪些	历史上姓徐的名人有哪些
四十五乘三	四十五乘二十
澳洲属于欧洲吗	意大利属于欧洲吗
浙江海洋大学就业率	广东海洋大学就业率
华中科大非全日制上课时间	湖南科技大学非全日制上课时间
云南艺术学院是本科吗	四川文化艺术学院是本科吗
中山学校排名	中山医院排名
南充至成都多少公里	潍坊至成都多少公里
南昌防腐木厂家	石家庄防腐木厂家
唐山属于哪个市	南京属于哪个市
两米七分米等多少米	两米八分米等多少米
南阳到太康的大巴车	南阳到昆明的大巴车
可以去佤邦旅游吗	可以去上海旅游吗
青春痘十二岁	青春痘十四岁
三的倍数的特征是什么	七的倍数的特征是什么
八十六是什么数	五是什么数
北京到扬州的飞机	北京到福州的飞机
商丘到徐州有多远	商丘到青岛有多远
宝宝三十八℃算发烧吗	宝宝三十七℃算发烧吗
三分之一加二分之一	三分之一加二分之五
陈彦然是谁	曹然然是谁
十九角等多少元多少角	八角等多少元多少角
二十年山东五一节放假安排	二十年广东五一节放假安排
梦见雷音寺	梦见观音寺
餐后八小时血糖多少正常	餐后六小时血糖多少正常
二十年长沙社会平均工资	二十年北京社会平均工资
一点三十千克等多少吨	十点三十千克等多少吨
太原的银行	西宁的银行
上海到云南	三亚到云南
现在去杭州需要隔离	现在去郑州需要隔离
海大调剂名额	人大调剂名额
珠穆朗玛峰周边有哪些国家	俄罗斯周边有哪些国家
苏州资料员工资一般多少	杭州资料员工资一般多少
正月初三是什么星座	正月初五是什么星座
湖南城市学院改名	襄樊学院改名
长春岭到松原客车时刻表	长山到松原客车时刻表
界首到洛阳高铁时刻表	广州到洛阳高铁时刻表
沂水一中怎么样	浠水一中怎么样
玉溪最好吃的包子	莆田最好吃的包子
罗马必去景点	罗马尼亚必去景点
二乘几等六	二乘几等三十
十七万字的小说	十二万字的小说
武汉只有一个机场吗	南昌只有一个机场吗
工行可以存美元吗	中行可以存美元吗
查乙肝五项需要空腹吗	查乙肝七项需要空腹吗
九十年农历四月十七是什么星座	九十年农历四月十一是什么星座
十七英寸等多少厘米	十八英寸等多少厘米
文山市扫黑除恶举报电话	乐山扫黑除恶举报电话
早上总是想吐怎么回事	早上偶尔想吐怎么回事
沧县中学电话	沧县人民医院电话
有时胸闷气短是怎么回事	常常胸闷气短是怎么回事
河北大学多少学生	湖北大学多少学生
江西各市人口	云南各市人口
阿飞是谁	飞飞是谁
湖北民族大学排名	西藏民族大学排名
陕西科二考试项目	河南科二考试项目
四十五除五	八除五
渤海大学艺术类录取分数线	辽工艺术类录取分数线
英国和中国时差	加拿大和中国时差
延安重点高中排名	烟台重点高中排名
一百kw用多少平方的电缆	三十kw用多少平方的电缆
权力的游戏第五季演员	权力的游戏第三季演员
三除六怎么约分	八除六怎么约分
十三岁女生胸围	十五岁女生胸围
陕西师大收费标准	闽南师范大学收费标准
哈尔滨师范学院分数线二千零一十九	泉州师范学院分数线二千零一十九
贵阳妇科检查收费	天津妇科检查收费
乌鲁木齐最好的装修公司	天津最好的装修公司
澳门五行属什么	福建五行属什么
鸡西到大连的火车票	鸡西到天津的火车票
大直卫生院电话	大直医院电话
二十七小时等多少日	九小时等多少日
李白的名言	毛泽东的名言
九十五年属相什么生肖	九十六年属相什么生肖
朝晖路属于哪个区	中国属于哪个区
建行属于什么编制	农行属于什么编制
威尔士总部电话	中国总部电话
入职体检早上可以抽烟吗	入职体检当天可以抽烟吗
太原理工十九年录取分数线是多少	长春理工大学十九年录取分数线是多少
0八年是什么年	0九年是什么年
早上七时是什么时辰	早上八时是什么时辰
吉安县什么时候开学	安阳县什么时候开学
三百一十二除十三等多少	三百一十二除六等多少
五十三年七月十三日的星座	五十四年七月十三日的星座
喜德盛代言人	百盛代言人
四十五加十九等几	四十五加八等几
孕二十三周肚子涨涨的	孕二十六周肚子涨涨的
西北师大考研分数线	北师大考研分数线
ldo钻戒官网价格	ido钻戒官网价格
二十八的因数有什么	六十八的因数有什么
十三岁男孩晚上睡觉磨牙是什么原因	十五岁男孩晚上睡觉磨牙是什么原因
西安交大天津录取分数线二千零一十九	西南交大天津录取分数线二千零一十九
八千七百零六的近似数是什么	一的近似数是什么
唐三藏的父亲是谁	特朗普的父亲是谁
南湖湿地公园几点关门	龙潭湖公园几点关门
马尼拉到厦门多少公里	阿姆斯特丹到厦门多少公里
华为畅享九plus怎么解锁	华为畅享七plus怎么解锁
台州三甲医院有哪几家	广东三甲医院有哪几家
直肠癌一期症状	直肠癌三期症状
杭州犬舍排名	宁波犬舍排名
苹果三手机怎么解锁	苹果六手机怎么解锁
十七kg等多少升	十七cm等多少升
十五岁一个月来两次月经正常吗	十四岁一个月来两次月经正常吗
北大开学日期	武大开学日期
北京卫视情感节目	湖南卫视情感节目
八十五年每月运势	八十六年每月运势
宝宝老是摇头	宝宝偶尔摇头
浦东新区御桥路邮编	浦东新区严桥路邮编
西北师范大学排名多少	西工大排名多少
八百一十五爱情代表什么意思啊	八百零四爱情代表什么意思啊
贵阳到蚌埠的火车时刻表	天津到蚌埠的火车时刻表
四十七乘七十九	四十七乘八
五个人吃面需要多少面粉	三个人吃面需要多少面粉
广州哪里有蹦极	南昌哪里有蹦极
香港金融中心在哪个区	上海金融中心在哪个区
林肯mkx评价	林肯mkc评价
九十年一角的硬币值多少钱	九十一年一角的硬币值多少钱
北京到雄县有多少公里	北京到杭州有多少公里
五千三百九十泰铢等多少人民币	五千二百九十泰铢等多少人民币
冼星海是谁	谢海涛是谁
哈工大天津分数线	西工大天津分数线
北方工业大学是几本	河南工业大学是几本
沧州到焦作的高铁时刻表	西安到焦作的高铁时刻表
二的五倍	五的五倍
七和九的最大公因数和最小公因数	八和九的最大公因数和最小公因数
车子一直熄火什么原因	车子忽然熄火什么原因
九十三年农历十二月初十生的是属什么星座	九十三年农历十二月底十生的是属什么星座
重庆哪里有宠物市场在哪里	广州哪里有宠物市场在哪里
湖南到衡阳多少公里	湖南到潍坊多少公里
慈溪日报登报电话	汕尾日报登报电话
池州到绍兴	池州到上海
cpa报名费用	cfa报名费用
麦克白第二幕概括	麦克白第一幕概括
a五十三是否支持otg	a五十二是否支持otg
河南到广西邮费多少	河南到新疆邮费多少
福建哪家医院好	深圳哪家医院好
十九年几岁	二十年几岁
八十四和七的最小公倍数	七和七的最小公倍数
曲阜到无锡的火车时刻表	曲阜到青岛的火车时刻表
怀孕会老想睡觉吗	怀孕会不想睡觉吗
甘肃离四川有多远	甘肃离黑龙江有多远
广州有哪些旅行社	南昌有哪些旅行社
五十五年出生的明星	五十六年出生的明星
赵匡胤家庭背景	赵孟頫家庭背景
r十一更换电池多钱	r九更换电池多钱
北京到天柱山火车	北京到莫斯科火车
一百以内十六的倍数	一千以内十六的倍数
九十六年七月初一是什么命	九十六年十月初一是什么命
陕西科技大学开学了吗	山西医科大学开学了吗
滨州到商丘火车时刻表	滨州到哈尔滨火车时刻表
南昌到武汉快递要几天	南昌到成都快递要几天
湖南大学十六年分数线	南京大学十六年分数线
一美金多少人民币	七美金多少人民币
上个星期五是几月几日	星期五是几月几日
南京一百四十五路公交车路线	哈尔滨一百四十五路公交车路线
南京工业大学是名校吗	南京师大是名校吗
十八个月宝宝能吃蛋糕吗	十一月宝宝能吃蛋糕吗
苏州科技大学研究生复试科目	华中科大研究生复试科目
临沧有多少个乡镇	临沂有多少个乡镇
南京医科大学护理研究生好考吗	天津医大护理研究生好考吗
北方工业大学是几本	北京工商大学是几本
民政局一个月多少钱	统计局一个月多少钱
霍金的五大预言	霍金的七大预言
十边形内角和	五边形内角和
十九年江西养老保险缴费基数	十九年陕西养老保险缴费基数
我今年十一岁用英语怎么说	我今年十九岁用英语怎么说
十六年中央电视台春节联欢晚会主持词	十七年中央电视台春节联欢晚会主持词
今天呼和浩特多少度	今天贵阳多少度
沈阳离内蒙古有多远	沈阳离四川有多远
张博轩的含义	张文博的含义
数字二用英语怎么说	数字十用英语怎么说
欧阳震华的电视剧	欧阳娜娜的电视剧
0九年自由舰值多少钱	十年自由舰值多少钱
华邦的含义	华泰的含义
成都三菱服务网点四oo一六百八十一八千七百七十	昆明三菱服务网点四oo一六百八十一八千七百七十
凯立德导航怎么升级	凯翼导航怎么升级
江西大还是日本大	加拿大大还是日本大
八分之三乘三分之一	八分之三乘八分之一
西藏种地吗	台湾种地吗
北京吉利大学学费	北京农业大学学费
广州身份证过期异地可以办理吗	郑州身份证过期异地可以办理吗
昆明比较好的高中有哪些	长沙比较好的高中有哪些
十六岁怎样长高	十七岁怎样长高
鞍山师范学院怎么样	安阳师范学院怎么样
摩根大通工资待遇	上汽大通工资待遇
洛阳常住人口有多少	拉萨常住人口有多少
三天没有大便了怎么办	八天没有大便了怎么办
华东师大属于几本	华东政法大学属于几本
烟台到徐州距离	烟台到广州距离
大庆到齐齐哈尔客车时刻表查询	哈尔滨到齐齐哈尔客车时刻表查询
修水到萍乡多少公里	南京到萍乡多少公里
十一月一日是什么节	十一月九日是什么节
怎么把圆分成二十等分	怎么把圆分成三等分
广州属于那里	昆明属于那里
哈工大税号	湖北工业大学税号
郑州到滕州有多少公里	郑州到南京有多少公里
南京到泗县火车时刻表	南京到广州火车时刻表
河南中小学什么时候开学	新疆中小学什么时候开学
珠海哪里好玩	珠海公园哪里好玩
新生儿经常呛奶正常吗	新生儿偶尔呛奶正常吗
五除四十五等多少	五除七等多少
四和十的最小公倍数是多少	十二和十的最小公倍数是多少
六十六年十二月二十一日生阳历是什么星座	六十七年十二月二十一日生阳历是什么星座
描写夜幕的诗词	描写晚间的诗词
三分之一是不是有理数	七分之一是不是有理数
西南交大研究生拟录取名单	西南石油大学研究生拟录取名单
餐后两小时血糖正常值	餐后八小时血糖正常值
白沟到葫芦岛火车时刻表	白沟到合肥火车时刻表
邬思道为什么要那么多钱	邬先生为什么要那么多钱
七十年代三转一响是什么	五十年代三转一响是什么
苹果八plus坏了	苹果七plus坏了
成都靠谱的装修公司	银川靠谱的装修公司
西宁哪里能治癫痫	重庆哪里能治癫痫
武汉现在去南京要隔离吗	武汉现在去石家庄要隔离吗
南京体育学院学工处电话	南京工程学院学工处电话
西藏各个城市	内蒙各个城市
海大什么专业最好	南昌大学什么专业最好
三万零一十读作	三千零一十读作
沈阳到潍坊多少公里	沈阳到青岛多少公里
开封十大旅游景点	日本十大旅游景点
顺丰到四川多少钱	顺丰到新疆多少钱
二十一和二十三的最大公因数和最小公倍数	五和二十三的最大公因数和最小公倍数
叙利亚位于哪个洲	加拿大位于哪个洲
门头沟最高的塔	日本最高的塔
中信证券股票价格	兴业证券股票价格
北京到贵阳多少公里路	北京到西安多少公里路
云大附中网址	山大附中网址
k一解锁方式	k七解锁方式
广州山竹多少钱一斤	拉萨山竹多少钱一斤
北京电影学院校区分配	北京服装学院校区分配
营口到榆树多少公里	内蒙古到榆树多少公里
十二和三十五最大公因数	一和三十五最大公因数
肚子有点胀气	肚子经常胀气
五月和十月是什么星座	五月和九月是什么星座
武汉婚宴酒席价目表	南宁婚宴酒席价目表
合肥到宿迁物流	合肥到长沙物流
评价诸葛亮	评价贾乃亮
菏泽有无印良品吗	安阳有无印良品吗
小米六清内存	小米八清内存
二十分钟之后关闭音乐	十五分钟之后关闭音乐
十七和三十二的最大公因数	十五和三十二的最大公因数
现在坐高铁去天津安全吗	现在坐高铁去北京安全吗
早上七时是什么时辰	早上四时是什么时辰
哈医大怎么预约挂号	哈医大一院怎么预约挂号
五百五十除六的竖式	一除六的竖式
十年银行房贷利率	十一年银行房贷利率
十月二十五生日的明星	十月十六生日的明星
战地一载具第三人称	战地四载具第三人称
武汉工资平均水平	成都工资平均水平
北京吉利大学学费	北京电影大学学费
赣马高级中学校长	大丰高级中学校长
东南大学人才引进待遇	东华大学人才引进待遇
工行可以报几个岗位	农行可以报几个岗位
二十人会议室面积	六十人会议室面积
五十乘二	五十乘五十
郴州离安仁有多远	郴州离长沙有多远
二十七的算术平方根	一百的算术平方根
描写冬天的四字词语	描写夏季的四字词语
十一点半自动关机	十二点半自动关机
一分钟英文	三分钟英文
四和十二最小的公倍数	八和十二最小的公倍数
十堰到宜昌有多远	十堰到成都有多远
湖南大学教育学研究生分数线	湖北大学教育学研究生分数线
北京南站是在哪个区	惠州南站是在哪个区
莒县到五莲火车	莒县到西安火车
西宁保姆市场价格	温州保姆市场价格
郑州哪家白癜风医院信誉好	福州哪家白癜风医院信誉好
邢台的邮编号码	绵阳的邮编号码
云南财经大学会计专业排名	山东财经大学会计专业排名
一百三十的百分之三十	八十的百分之三十
韶关学院专业分数线	河池学院专业分数线
冀州在哪个省	深州在哪个省
益盛堂的产品怎么样	百度的产品怎么样
通辽到张家界的飞机票	通辽到天津的飞机票
河南科技大学是几本	北京科大是几本
巴山在哪里	芦山在哪里
苹果八怎么设置应用锁	苹果七怎么设置应用锁
湖南科技大学领导	江苏科技大学领导
九十年一角的硬币值多少钱	九十一年一角的硬币值多少钱
华阳董事长是谁	东京董事长是谁
北大传播学分数线	北师大传播学分数线
九十八年六月初十是什么星座农历	九十八年八月初十是什么星座农历
十七英寸等多少厘米	十四英寸等多少厘米
不换一首歌	重新换一首歌
福州口罩生产厂家联系方式	南宁口罩生产厂家联系方式
形容声音不清晰	形容声音非常清晰
湛江什么医院好	德州什么医院好
七十三年农历九月十二是什么星座	七十三年农历十月十二是什么星座
三寸口径是多少厘米	四寸口径是多少厘米
新股第三天买入法	新股第二天买入法
美的集团电话	香江集团电话
太原距离徐州多少公里	太原距离济南多少公里
陇东学院怎么样	山东体育学院怎么样
直径五十的圆周长	直径二十的圆周长
北师大一年学费多少	理工大学一年学费多少
深圳到铜仁高铁票	深圳到青岛高铁票
海南离武汉有多少公里	浙江离武汉有多少公里
近年什么单机游戏好玩	十年前什么单机游戏好玩
九十七年农历三月二十七	九十七年农历三月二十八
建行存折可以开通手机银行吗	农行存折可以开通手机银行吗
长安在哪里	中国在哪里
黑河到长春火车时刻表	天津到长春火车时刻表
怎么注册小米账户	怎么注册谷歌账户
今天岳阳有雨吗	今天连云港有雨吗
丽水到青田高铁时刻表	上海到青田高铁时刻表
十九年中考录取分数线武汉	十九年中考录取分数线济南
姜氏辈分排列	章氏辈分排列
随州离南阳有多远	随州离合肥有多远
八月二十日是什么星座	八月一日是什么星座
六天线路由器辐射大吗	四天线路由器辐射大吗
长沙有没有蜜雪冰城	乌鲁木齐有没有蜜雪冰城
韦参军的名字	韦德的名字
洛阳属哪个省	天津属哪个省
二千零一十五香港电影票房排行	二千零一十三香港电影票房排行
青海属于什么气候	贵州属于什么气候
平顶山到山东多少公里	平顶山到哈尔滨多少公里
八月四日是什么星座	五月四日是什么星座
五月底的句子	五月末的句子
蝴蝶飞飞歌词	蝴蝶飞飞飞歌词
四个月宝宝拉肚子怎么办	两月宝宝拉肚子怎么办
八除十五加一除六等几分之几	八除十二加一除六等几分之几
五百的一倍	五百的三倍
枣庄到泰安高铁	枣庄到兰州高铁
东北师大综合排名	东北财经大学综合排名
中国有几个迪士尼乐园	日本有几个迪士尼乐园
和顺县的邮政编码	延长县的邮政编码
四川喝什么白酒	云南喝什么白酒
九百五十的英文	九百三十的英文
荆门到盐城火车站时刻表	西安到盐城火车站时刻表
十三画属木的繁体字	十八画属木的繁体字
七十三年农历九月十二是什么星座	七十三年农历五月十二是什么星座
今天能不能下雨	明天能不能下雨
新疆医科大学代码	河北医科大学代码
哈尔滨冬天气温	昆明冬天气温
怎么取消农行短信通知业务	怎么取消建行短信通知业务
重庆音乐电台fm	兰州音乐电台fm
秦海璐学历	秦洪涛学历
十九年何时打春	二十年何时打春
一月份的环比怎么计算	最近一月的环比怎么计算
五百三十六除四的竖式	五百三十四除四的竖式
六百除二十	六百除四
芜湖到泰兴火车时刻表	芜湖到杭州火车时刻表
二十四小时等多少分钟	四点两小时等多少分钟
华中蔬菜批发市场价格	黔西南蔬菜批发市场价格
六福珠宝怎么样	百度怎么样
三的x次方等六	三的x次方等五
一和九最大公因数	一和十四最大公因数
剖腹产第三天吃什么好	剖腹产第五天吃什么好
cad填充三百乘六百地砖	cad填充三百乘三百地砖
和顺县的邮政编码	安溪县的邮政编码
世界排名前六百的中国大学	世界排名前五百的中国大学
二千零二十华师大考研复试分数线	二千零二十华东师大考研复试分数线
云南农业大学怎么样	湖南农业大学怎么样
衡阳一中怎么样	安阳一中怎么样
张小凡是哪部小说主角	小凡是哪部小说主角
总胆固醇六点八十五严重吗	总胆固醇六点八十四严重吗
偃师到阜阳多少公里	偃师到重庆多少公里
艾玛罗伯茨三围	凤玛罗伯茨三围
中信证券业绩	中原证券业绩
七十七年的一分硬币值多少钱	七十八年的一分硬币值多少钱
鲁滨逊漂流记电影九十六年版	鲁滨逊漂流记电影九十七年版
内蒙古民族大学有专科吗	中央民大有专科吗
徐州寄快递到成都多少钱	徐州寄快递到北京多少钱
最近总是小腹疼	最近偶尔小腹疼
谁是第一个	谁是第四个
北理工的邮编	昆明理工大学的邮编
上海理工大学就业怎么样	上海海洋大学就业怎么样
哈尔滨商业大学校园邮箱	哈尔滨师范大学校园邮箱
沂水一中怎么样	历城一中怎么样
农行忘记卡号怎么办	中行忘记卡号怎么办
五十二年的立春是几月几号以及什么时间	五十二年的立春是五月几号以及什么时间
墨西哥最美的城市	加拿大最美的城市
西北政法大学是不是九百八十五	法大是不是九百八十五
小丽的电话	王俊凯的电话
一百个单词	三百个单词
西递到芜湖有多少公里	南京到芜湖有多少公里
杭州离贵州远吗	杭州离浙江远吗
北邮附近酒店	北京协和医院附近酒店
华东师大属于几本	东华大学属于几本
天津区属于哪个区	郑州区属于哪个区
三十八年出生的演员	三十九年出生的演员
盐城离镇江有多远	盐城离昆明有多远
山西春节习俗	江西春节习俗
成都充电费	石家庄充电费
十二和二十五的最大公因数是谁	十二和四的最大公因数是谁
十七和三十二的最大公因数	十七和二十二的最大公因数
八十八年是什么生肖	八十九年是什么生肖
绵阳到南京飞机要多久	北京到南京飞机要多久
二点七乘四	二点五乘四
浦发银行贷款要求	广发贷款要求
长江多少公里	松花江多少公里
贵州一共有几个地级市	河北一共有几个地级市
重庆有水吗	拉萨有水吗
中国五大节日有哪些	中国七大节日有哪些
xs充电没反应	xr充电没反应
农行怎么查询开户银行	中行怎么查询开户银行
申通查不到单号	圆通速递查不到单号
十三乘十三等多少	十三乘四等多少
兰州在哪里	兰州站在哪里
六的倍数的特征是什么样的	四的倍数的特征是什么样的
安徽农业大学复试难吗	江西农业大学复试难吗
九十五年农历六月初四是什么星座	九十五年农历五月初四是什么星座
成都最贵酒吧	南宁最贵酒吧
三十五分钟后提醒我收衣服	四十分钟后提醒我收衣服
十八乘二	十八乘十八
林志颖的老婆是谁	特朗普的老婆是谁
二分之三化成小数	四分之三化成小数
西华师大的排名	广西师范大学的排名
初三科学第三章知识点	初三科学第四章知识点
长春到重庆火车时刻表查询结果	长春到西安火车时刻表查询结果
把三又七除八化成假分数	把七又七除八化成假分数
印度出生率死亡率	美国出生率死亡率
三亚到中山有多少公里	三亚到北京有多少公里
九十年润五月初九是几号	八十九年润五月初九是几号
百度的股价	网易的股价
江苏高速绿通限多少吨	云南高速绿通限多少吨
十五和二十四的最小公倍数是几	十五和六的最小公倍数是几
南京民营企业排名榜	郑州民营企业排名榜
尿常规白细胞三加是什么意思	尿常规白细胞七加是什么意思
曲阜师范大学山东录取分数线	华中师大山东录取分数线
关闭九点五十的闹钟	关闭五点五十的闹钟
湖北产什么汽车	云南产什么汽车
民政局有哪些部门	气象局有哪些部门
墨尔本是哪里的首都	北京是哪里的首都
泉州师范学院是一本吗	伊犁师范学院是一本吗
近视四百度看到的画面	近视一百度看到的画面
中山几个区	龙岩几个区
厦门地理位置	菏泽地理位置
从烟台怎么去长岛	从北京怎么去长岛
深圳家具市场有哪些	抚顺家具市场有哪些
徐氏是怎么来的	唐氏是怎么来的
广东的省会是哪里	澳大利亚的省会是哪里
河北师范大学分数线	河南师范大学分数线
南京保安工资多少钱一个月	南宁保安工资多少钱一个月
西安文理学院好不好	宝鸡文理学院好不好
三点六除零点九	六点三除零点九
距离鸡西最近的城市	距离洛杉矶最近的城市
常熟防疫部门电话	天津防疫部门电话
扬州找工作怎么这么难	杭州找工作怎么这么难
东北师大学费多少钱	辽宁师范大学学费多少钱
九百零七除四的竖式	十除四的竖式
商丘到无锡汽车	商丘到济南汽车
五什么什么来	八什么什么来
二千零一十九广西事业单位考试时间	二千零一十九宁夏事业单位考试时间
晋江失恋博物馆在哪里	晋江二中在哪里
醴陵到深圳的火车票	醴陵到长沙的火车票
福州激光脱毛的价格多少	南昌激光脱毛的价格多少
七什么七什么	七什么八什么
女孩姓俞的名字	女孩姓罗的名字
济南回民中学升学率	济南育英中学升学率
外地人在上海买公寓需要什么条件	外地人在成都买公寓需要什么条件
零点二五乘三	零点二五乘十二
南京高科的股价	网易的股价
来完大姨妈第三天是安全期吗	来完大姨妈第九天是安全期吗
给r九打电话	给发哥打电话
衡阳一中怎么样	平邑一中怎么样
江西新农合咨询电话	广西新农合咨询电话
红岩第四章好句赏析	红岩第九章好句赏析
榆树市公积金电话	锡林浩特市公积金电话
吉林到集安多少公里	吉林到深圳多少公里
中山到武汉多少公里	中山到西宁多少公里
过去什么行业好做	如今什么行业好做
长安在哪里	长安街在哪里
石家庄经济学院录取分数线	湖南涉外经济学院录取分数线
两个月不剪头发	七月不剪头发
北航研究生怎么样	北邮研究生怎么样
西北师范大学冷门专业	西北大学冷门专业
高压一百五十低压一百严重吗	高压一百八十低压一百严重吗
东方卫视主持人	东风卫视主持人
农历三月十三日是什么星座	农历三月八日是什么星座
金坛市面积多少平方公里	遵义面积多少平方公里
vage什么意思	duge什么意思
现流行什么装修风格	去年流行什么装修风格
蔡徐坤帅吗	边伯贤帅吗
二百零一乘八约	二百零一乘四约
焦作疫情情况	长春疫情情况
西华大学多少人	华东交通大学多少人
李鹏是谁	高尔基是谁
上海师大何时开学	上海交大何时开学
湖南到郑州	湖南到长沙
桂林二手房价	黑河二手房价
世人都爱牡丹的原因	世人皆爱牡丹的原因
西安交大联系电话	重庆交通大学联系电话
苏州哪个区美女多	哈尔滨哪个区美女多
周口到湛江有多少公里	周口到兰州有多少公里
亚邦股票今日价格	恒邦股票今日价格
九十六除三	九十六除四
旧历十月初六是什么星座	旧历十月初二是什么星座
武汉做核酸检测要预约吗	南京做核酸检测要预约吗
二十一年春节是几月几号	二十二年春节是几月几号
一百五十除二十五	四百五十除二十五
爱情数字一百四十是什么意思	爱情数字八是什么意思
七乘五表示什么	零乘五表示什么
苹果十一如何添加黑名单	苹果八如何添加黑名单
江苏警官学院二千零一十九录取分数线	中央司法警官学院二千零一十九录取分数线
上海到深圳汽车时刻表	上海到保定汽车时刻表
贵阳到桐梓过路费多少钱	贵阳到武汉过路费多少钱
河北工程大学是二百一十一吗	西安工程大学是二百一十一吗
北京到九台火车时刻表查询	北京到济南火车时刻表查询
麦考瑞大学世界排名	卡迪夫大学世界排名
两和五的最小公倍数	两和四的最小公倍数
五月二十一日是什么星座	五月四日是什么星座
如东到张家港	如东到张家口
十九年都有什么电视剧	二十年都有什么电视剧
如何长期定居澳门	如何长期定居日本
五十一乘五十	四十一乘五十
零加九等多少	十六加九等多少
移植第五天肚子胀痛怎么回事	移植第八天肚子胀痛怎么回事
墨脱县的邮政编码是多少	青岛的邮政编码是多少
杨宇轩名字怎么样	杨浩宇名字怎么样
五十五乘十等多少	九乘十等多少
饭后跑步好吗	饭前跑步好吗
今天建行上班吗	周末建行上班吗
温州男女比例	无锡男女比例
息烽到綦江高铁时刻表	广州到綦江高铁时刻表
二百八十八除三	二百八十八除十二
怀孕第三十三周注意事项	怀孕三十三周注意事项
0六年武侠电视剧	二百零七年武侠电视剧
赣南医学院多大	皖南医学院多大
南京离辽宁有多远	南京离青岛有多远
二十四乘二十四	五百零六乘二十四
runningman尹施允有哪几期	runningman允儿有哪几期
三减减六	零减减六
顺丰从安徽到上海要多久	顺丰从沈阳到上海要多久
豫是那个省的车牌号	湘是那个省的车牌号
浙江工业大学考研专业排名	浙大考研专业排名
菲律宾和北京有时差吗	成都和北京有时差吗
三除十的通分	四除十的通分
三乘十八等多少	十八乘十八等多少
陕西科技大学开学了吗	香港科技大学开学了吗
五除八化成百分数	一除八化成百分数
赣马高级中学校长	杭州高级中学校长
沈阳理工大学属于哪个社区	上海理工大学属于哪个社区
八分之五减八分之一	八分之五减八分之三
西安到天津汽车票	贵阳到天津汽车票
华为手机如何注销谷歌账号	华为手机如何注销华为账号
苹果十一邮件怎么添加qq邮箱	苹果八邮件怎么添加qq邮箱
贵州福利彩票开奖时间	四川福利彩票开奖时间
三级耗能空调	一级耗能空调
漳州到徐州多少公里路	广州到徐州多少公里路
南部县法院院长	南郑县法院院长
咸宁哪个县最穷	中国哪个县最穷
人大法硕非法学学费	北大法硕非法学学费
上海理工大学属于哪个街道	安徽理工大学属于哪个街道
长春理工大学研究生学费	昆明理工大学研究生学费
太原切包皮手术多少钱	重庆切包皮手术多少钱
描写金秋十月的诗句	描写金秋九月的诗句
河北大学怎么样	河南大学怎么样
兰州到河北多少公里	银川到河北多少公里
湖南科技大学领导	华中科大领导
宜宾离绵阳有多远	宜宾离广州有多远
南京林业大学开设专业	南京财经大学开设专业
廊坊有名的景点	香港有名的景点
金华私立小学排名	金华小学排名
一米六十三的标准体重	一米五的标准体重
小米九内存不足	小米八内存不足
四万八千等多少升	四万四千等多少升
十二月十九是什么星座的	十二月一是什么星座的
柳州到兖州火车时刻表	柳州到广州火车时刻表
一月二十五是什么节日	一月二十二是什么节日
天津电话区号多少	兰州电话区号多少
九十一年腊月初三是什么命	九十二年腊月初三是什么命
五字情感语录	三字情感语录
上海动物园游玩多长时间	成都动物园游玩多长时间
六十四乘八	六十四乘四
涡阳到广德火车时刻表	涡阳到西安火车时刻表
湖南理工学院二千零二十什么时候开学	湖南文理学院二千零二十什么时候开学
聊城园林处处长	平顶山园林处处长
南阳到拉萨飞机票多少钱	南阳到上海飞机票多少钱
荆门到青岛多少公里	荆门到重庆多少公里
鱼为什么不张嘴	鱼为什么一直张嘴
苏州到鄂州多少公里	苏州到重庆多少公里
提前六小时能换登机牌吗	提前十小时能换登机牌吗
福建是亚热带吗	江苏是亚热带吗
二百零四乘三十	二百零四乘五
重庆师范大学考研复试时间	云南师范大学考研复试时间
玉树到西宁飞机票价格	哈尔滨到西宁飞机票价格
梧州到田东动车时刻表	梧州到深圳动车时刻表
五十五年四月十八日	五十六年四月十八日
承德人口二千零一十九总人数口	德阳人口二千零一十九总人数口
八加三专项整治是什么	一加三专项整治是什么
福建历史名人	海南历史名人
徐州有什么特产	喀什有什么特产
长春特色文化	长沙特色文化
海南哪些城市	河南哪些城市
打电话给王丽英	打电话给萧
捷豹xe油耗	捷豹xj油耗
《西游记》第一回主要内容	《西游记》第二回主要内容
东北大学秦皇岛分校地址和邮编	美国东北大学地址和邮编
十七英寸等多少厘米	十六英寸等多少厘米
十八年的上半年有多少天	十九年的上半年有多少天
濉溪二中地址	当涂二中地址
云南组织机构代码	湖北组织机构代码
拉萨至丽江机票	西安至丽江机票
适合湖北地区种的花	适合广东地区种的花
郑州八中好吗	枣庄八中好吗
阳新到广州多少公里	阳新到合肥多少公里
让胡路区房价	日本房价
邯郸园艺博览会地址	北京园艺博览会地址
七百二十除五十的竖式和验算	七百二十除七十的竖式和验算
一万美元等多少人民币	三十美元等多少人民币
帮我设置明天早上五点的闹钟	帮我设置明天早上八点的闹钟
山东都有什么州	江苏都有什么州
昆明牙齿矫正医院排名	合肥牙齿矫正医院排名
那今天下雨吗	那明天下雨吗
二十的合数有哪些	八的合数有哪些
安徽立医院是医保定点医院吗	济南省立医院是医保定点医院吗
北理工教师待遇	北工大教师待遇
重庆至遂宁火车	重庆至兰州火车
许昌到哈尔滨	许昌到重庆
北京回成都需要集中隔离吗	北京回上海需要集中隔离吗
百字在田字格的写法	万字在田字格的写法
心跳一百二十正常吗	心跳一百八十正常吗
昆明二千零一十九常住人口	成都二千零一十九常住人口
0八年北京奥运会的导演	二百零九年北京奥运会的导演
苏州属于哪个省	维也纳属于哪个省
兰州到山东多少公里	兰州到济南多少公里
老是打喷嚏是怎么回事	偶尔打喷嚏是怎么回事
五十kva变压器能带多少千瓦	六十kva变压器能带多少千瓦
四个月宝宝发烧怎么办	三月宝宝发烧怎么办
长春妇科哪家好	深圳妇科哪家好
四十四岁月经不规律	四十七岁月经不规律
一到夏天就烦躁不安	一到晚上就烦躁不安
罗莱家纺鹅绒被怎么样	博洋家纺鹅绒被怎么样
贵州十九年人均gdp	云南十九年人均gdp
四十三岁月经提前七天正常吗	四十三岁月经提前五天正常吗
华西医学院院长	浙大医学院院长
黑龙江二十年单招学校有哪些	新疆二十年单招学校有哪些
青海特产有哪些	西宁特产有哪些
安徽理工大学多大	北理工多大
内蒙古广播电视大学报名时间	广州广播电视大学报名时间
来安县有什么旅游景点	怀来县有什么旅游景点
二十年济南天然气价格	二十年南京天然气价格
西安哪家医院肠胃科好	昆明哪家医院肠胃科好
一万美金是多少人民币	三美金是多少人民币
怀孕五个月肚子隐隐疼	怀孕五个月肚子一直疼
月经期刚过一天会怀孕吗	月经期刚过两天会怀孕吗
三十七是吉利数字吗	四是吉利数字吗
六十乘三	六十乘十五
柘荣县多少人口	桐柏县多少人口
十匹空气能热水器多少钱	三匹空气能热水器多少钱
广东木材批发市场在哪里	浙江木材批发市场在哪里
重庆最新规划	济南最新规划
三千刀是多少人民币	五十刀是多少人民币
阜阳明天有雨吗	洛阳明天有雨吗
一百零二是什么东西	六十八是什么东西
九十减四十八	五十减四十八
七上语文人教版知识点	九上语文人教版知识点
现在去天津安全吗	现在去南昌安全吗
华泰证券是上市公司吗	华福证券是上市公司吗
浙江到惠东快递要多久	浙江到东莞快递要多久
七十三年十二月十三日是什么星座	七十四年十二月十三日是什么星座
四百除二十五	四百除六
阜阳到南通有多少公里	成都到南通有多少公里
西江大学好吗	沈阳大学好吗
例假推迟十天正常吗	例假推迟十几天正常吗
合肥夜总会有哪些	南昌夜总会有哪些
五十五乘十等多少	六乘十等多少
胶州离青岛多远	胶州离青岛机场多远
杭州什么整形医院好	秦皇岛什么整形医院好
零零年二月有多少天	零零年二月二有多少天
山东高新区属于哪个区	青岛高新区属于哪个区
奔驰gls四百报价	奔驰gle四百报价
r十七换内屏多少钱	r十五换内屏多少钱
利比亚属于中东地区吗	叙利亚属于中东地区吗
哈利波特九上映时间	哈利波特六上映时间
兰大一九年录取分数线	郑大一九年录取分数线
十一月二十二日是星期几	十一月十五是星期几
宫颈癌三期严重吗	宫颈癌四期严重吗
青大校长什么级别	青海民族大学校长什么级别
二十五乘三百九十九的简便算法	二十五乘六的简便算法
辽宁工业大学地址	哈工大地址
成都到郑州航班	成都到长春航班
六和四十的最大公因数是多少	六和三的最大公因数是多少
孕三十七周羊水八十四mm正常吗	孕三十七周羊水八十六mm正常吗
十八年好看的电影	十九年好看的电影
泰州是地级市还是县级市	济宁是地级市还是县级市
今天下雨还是出太阳	明天下雨还是出太阳
疫情期间韩国对中国的态度	疫情期间法国对中国的态度
吉林到长春火车票	深圳到长春火车票
世勋抽烟吗	吴世勋抽烟吗
西藏的房子贵吗	杭州的房子贵吗
居里夫人第一章主要内容	居里夫人第五章主要内容
广州到成都要多久	广州到石家庄要多久
一的序数词英语	三的序数词英语
杨真真的电视剧	杨真的电视剧
奔驰gla值得买吗	奔驰glc值得买吗
南京室内装修设计报价	南昌室内装修设计报价
广东属于四川吗	安徽属于四川吗
五十八乘二	五十八乘四
我来自三年级八班用英语怎么说	我来自三年级二班用英语怎么说
苹果六可以越狱吗	苹果十可以越狱吗
韩泰轮胎有正反面吗	米其林轮胎有正反面吗
湖南专科学院排名二千零一十九	山东专科学院排名二千零一十九
上海工程技术大学待遇	海军工程大学待遇
天津到芦台火车时刻表查询	天津到济南火车时刻表查询
五个月宝宝喉咙有痰怎么办	四月宝宝喉咙有痰怎么办
上海理工大学多少亩	成都理工大学多少亩
今天是不是晴天	明天是不是晴天
海曙区有哪些街道	日本有哪些街道
海大毕业论文一般多少分	江南大学毕业论文一般多少分
广东石子多少钱一吨	海南石子多少钱一吨
太原到洪洞的动车时刻表	西安到洪洞的动车时刻表
什么的两次方等一百	什么的两次方等三
五十除十	六除十
什么是一类人员	什么是九类人员
七月十一是什么节日	五月十一是什么节日
长沙到安徽多少公里	长沙到武汉多少公里
安徽出名人物	江西出名人物
把息屏时间调成一分钟	把息屏时间调成两分钟
汉中到包头多少公里	汉中到四川多少公里
华南师大书记	南京师大书记
六十八乘六除三	四乘六除三
白洋淀到白沟高铁	上海到白沟高铁
青海的大学什么时候解封	山东的大学什么时候解封
上海海关周末上班吗	北京海关周末上班吗
芜湖八十八路公交路线	北京八十八路公交路线
农历九月二十八是星期几	农历九月二十九是星期几
太原师范学院历任院长	烟台师范学院历任院长
台山地理位置	狼牙山地理位置
青海的地方	河北的地方
深圳中医院一门诊地址	深圳中医院二门诊地址
东北师大学费多少钱	东北电力大学学费多少钱
清明节是几月几号啊	今天是几月几号啊
辽宁海拔最高的山	广东海拔最高的山
三亚地理位置地图	温州地理位置地图
东南风四级怎么表示	东南风六级怎么表示
新疆的幼儿园啥时候开学	河南的幼儿园啥时候开学
河南有什么河	湖南有什么河
湖北有什么烟	辽宁有什么烟
去年hpv五十八今年转hpv五十二	去年hpv五十八今年转hpv五十三
十年儿童电视剧	十一年儿童电视剧
pacmoo是什么意思	pbdmoo是什么意思
遵义医学院怎么样	泸州医学院怎么样
泾县到重庆多少公里	北京到重庆多少公里
小米九代言人	小米八代言人
曲阜市发展怎么样	岳阳发展怎么样
不朽二什么时候出	不朽三什么时候出
昆山到泰安的火车票	昆山到南昌的火车票
浙江工业大学和沈阳工业大学哪个好	天津工业大学和沈阳工业大学哪个好
离上海近的旅游景点	离深圳近的旅游景点
黄钲轩和谁在一起了	黄轩和谁在一起了
雷克萨斯es价格	雷克萨斯is价格
郑州个人档案存放在哪里	宁波个人档案存放在哪里
山东是亚热带吗	江苏是亚热带吗
取消六点半的闹铃	取消六点的闹铃
关掉五点四十的闹钟	关掉六点四十的闹钟
河南职工住院报销比例	甘肃职工住院报销比例
脚后跟越来越疼	脚后跟很疼
湖北有哪些古建筑	宁夏有哪些古建筑
七月二十六日是什么星座	七月一日是什么星座
国家邮政局上班时间	国家基金委上班时间
华为十外屏碎了多少钱	华为七外屏碎了多少钱
怀孕能吃王瓜吗	怀孕能吃黄蘑吗
贵州最好的康复医院	内蒙古最好的康复医院
离唐县最近的景点	离杭州最近的景点
宝鸡到兰州有多少公里	宝鸡到杭州有多少公里
烟台是属于哪里	汉口是属于哪里
苹果六plus尺寸	苹果八plus尺寸
手机为什么有时充不进去电	手机为什么总是充不进去电
温州到金华客车	温州到厦门客车
乌鲁木齐属于新疆吗	兰州属于新疆吗
流沙河的特点	中国的特点
息屏时间调至三分钟	息屏时间调至半小时
无锡到盘锦多少公里	锦州到盘锦多少公里
心脏老是刺痛	心脏有点刺痛
八月十三是什么星座	八月十五是什么星座
小米九可以添加门禁卡吗	小米六可以添加门禁卡吗
曾几何时天魔的黑兔第一集	曾几何时天魔的黑兔第八集
男生早年流行什么样的发型	男生今年流行什么样的发型
外省回来长春的人员需要隔离吗	外省回来太原的人员需要隔离吗
重庆到合肥飞机几个小时	北京到合肥飞机几个小时
江苏哪个城市好玩	浙江哪个城市好玩
达州到西双版纳有多少公里	成都到西双版纳有多少公里
成都老年公交卡办理	郑州老年公交卡办理
山西占地面积最大的大学	河南占地面积最大的大学
美国科技大学排名	河南科技大学排名
八十六年农历七月十二日是什么星座	八十六年农历七月一日是什么星座
平湖到南通多少公里	平湖到南昌多少公里
黑龙江工程学院校规	湖南工程学院校规
六十八年的今年多大岁数了	六十九年的今年多大岁数了
海南的旅游城市	泰国的旅游城市
四到六月是什么季节	三到六月是什么季节
潍柴发动机气门怎么调	锡柴发动机气门怎么调
三月八日是什么星座	三月九日是什么星座
双鱼座今天运势	双鱼座这个月运势
处女膜破了会一直流血	处女膜破了会不流血
二百一十乘四十	二百三十乘四十
相对评价的特点	绝对评价的特点
星期一下雨吗	星期天下雨吗
一万七千小时等多少天	十六小时等多少天
襄阳有哪些玩的地方	哈尔滨有哪些玩的地方
乌鲁木齐到哈尔滨机票多少钱	拉萨到哈尔滨机票多少钱
白细胞酯酶一加	白细胞酯酶四加
国六柴油车油耗多少	国五柴油车油耗多少
武汉劳动监察部门投诉电话	天津劳动监察部门投诉电话
南京市长	南康市市长
属龙四月份运势如何二十年	属龙六月份运势如何二十年
十加二十等多少	十加五等多少
大连大学啥时候开学	大连海大啥时候开学
三十五岁女性适合的护肤品	四十五岁女性适合的护肤品
孝感市区人口多少	抚顺市区人口多少
德州最大的医院	西宁最大的医院
离平江县最近的高铁站	离广州最近的高铁站
绵阳大还是成都大	南京大还是成都大
山西的简称是啥	新疆的简称是啥
九除四等几分之几	九除六等几分之几
如东特色小吃	日本特色小吃
鹤壁到杭州高铁	鹤壁到沈阳高铁
中国一线城市有哪些	中国七线城市有哪些
四百八十加三十等多少	六十加三十等多少
二千一百六十六什么意思	二千一百五十六什么意思
武昌区各社区电话	江汉区各社区电话
会理县到宁南县有多少公里	会理县到昆明有多少公里
山西医科大学法医系分数线	南京医科大学法医系分数线
餐后一小时血糖八点零	餐后六小时血糖八点零
餐后两小时血糖十点一严重吗	餐后一小时血糖十点一严重吗
二十六个月宝宝身高体重标准表	十八月宝宝身高体重标准表
新沂市到临沂多少公里	长沙到临沂多少公里
陇东学院怎么样	普洱学院怎么样
错误代码六百九十一	错误代码六百九十二
四川警校招生条件	吉林警校招生条件
六和十二的最大公因数和最小公因数	七和十二的最大公因数和最小公因数
七月一日是什么星座	八月一日是什么星座
深圳哪个区最繁华	潮州哪个区最繁华
八十一年有哪些国产电影	八十二年有哪些国产电影
郓城到杭州的火车票	郓城到德州的火车票
乐山人口有多少	鞍山人口有多少
十一乘十八的竖式怎么写	十一乘十一的竖式怎么写
西安文理学院好不好	湖南文理学院好不好
北大哪个街道	北京交大哪个街道
南京有什么好玩的	澳门有什么好玩的
沈阳音乐学院明星校友	中国音乐学院明星校友
浙江海洋大学考研报录比	江苏海洋大学考研报录比
南通在哪个省	兴平市在哪个省
十五乘三等多少	十五乘十五等多少
咸阳电信电话	潮阳电信电话
厦门到芒市机票	厦门到澳门机票
河北工程大学新校区地址	河北大学新校区地址
信丰到西安多少公里	信丰到贵阳多少公里
成都到海口机票	成都到武汉机票
一百零二除十二	一百零二除四
霞浦到广州	霞浦到深圳
四点五乘三百零二等多少	四点五乘五十等多少
无锡gdp二千零一十八	徐州gdp二千零一十八
怀化一百一十六路公交路线	上海一百一十六路公交路线
重庆师范大学考研复试时间	江西师范大学考研复试时间
一百和二十五的公因数是多少	二十和二十五的公因数是多少
今日缅甸疫情情况	今日中国疫情情况
重庆有哪些市	拉萨有哪些市
四十三的比值	四十五的比值
七月与八月中国有哪些节日	七月与八月底中国有哪些节日
一百三十二台币是多少人民币	五台币是多少人民币
新疆籍女演员	辽宁籍女演员
长安在哪里	张家口在哪里
丙氨酸氨基转移酶八十五	丙氨酸氨基转移酶二十五
邯郸离江苏多远	邯郸离合肥多远
二百八十除十二	二百六十除十二
二十二是什么生肖	二十三是什么生肖
上海至菏泽大巴	上海至香港大巴
河南到江苏开车多少小时	河南到杭州开车多少小时
考文垂大学雅思要求	麦考瑞大学雅思要求
温州有什么好玩的地方	秦皇岛有什么好玩的地方
馆陶县城区人口	香港城区人口
宁波到兰州飞机票	宁波到贵阳飞机票
防灾科技学院在哪	郑州科技学院在哪
后天有不有雨	明天有不有雨
汉寿县邮政编码	长丰县邮政编码
昌吉学院专科有哪些专业	宜宾学院专科有哪些专业
五百的一倍	五百的五倍
哈尔滨到新疆邮费	南昌到新疆邮费
小米十红外遥控在哪	小米六红外遥控在哪
十六年十一月美元汇率	十七年十一月美元汇率
江西医学院排名多少	潍坊医学院排名多少
合肥周边赶集时间表	天津周边赶集时间表
二十年四月份假日	二十年七月份假日
二十年六月四日星座	五月四日星座
阳光保险的app叫什么	平安保险的app叫什么
昆明到新余多少公里	昆明到石家庄多少公里
太仓到徐州物流专线	成都到徐州物流专线
深圳和浙江距离多远	深圳和吉林距离多远
五除五	五除六
零点二五时等多少分	零点六时等多少分
吉林农大占地面积排名	东北农大占地面积排名
皖南医学院分数线	华西医学院分数线
从西宁到兰州	从青岛到兰州
贵定到金华高铁票查询	贵定到杭州高铁票查询
新生儿老是吐奶正常吗	新生儿偶尔吐奶正常吗
周末可以办理港澳通行证吗	明天可以办理港澳通行证吗
西安音乐学院附属高中分数线	上海音乐学院附属高中分数线
三千刀是多少人民币	十二刀是多少人民币
苏丹的人种	叙利亚的人种
苹果六屏幕发黄	苹果五屏幕发黄
宋庆龄哪里人	宋美玲哪里人
八和二十八的最小公倍数	三和二十八的最小公倍数
北大荒电话	北大荒酒店电话
戴沐白第九魂技是什么	戴沐白第四魂技是什么
五千七百五十九什么意思	五千六百五十九什么意思
安徽财经大学mpacc分数线	广东财经大学mpacc分数线
十和十二公倍数	八和十二公倍数
东方卫视女主持人	辽宁卫视女主持人
张家界离怀化多远	张家界离昆明多远
天津西和天津站哪个离机场近	天津西和天津哪个离机场近
南昌至赣州有多少公里	南昌至成都有多少公里
滁州到无锡火车	滁州到沈阳火车
沧州到大连高铁	重庆到大连高铁
农历七月十七是什么星座	农历七月九是什么星座
济南大学是哪个省的	南开是哪个省的
血压九十除五十正常吗	血压一百三十除五十正常吗
胃疼经常打嗝怎么回事	胃疼偶尔打嗝怎么回事
北大复试时间	北师大复试时间
骆驼祥子十一到十六章概括	骆驼祥子十四到十六章概括
奔驰glk价格	奔驰gla价格
一米六十三的标准体重	一米四的标准体重
如果五月有五个星期六那么六月一日是星期几	如果五月有五个星期六那么五月一日是星期几
成都信访局地址	石家庄信访局地址
上虞到义乌汽车时刻表	成都到义乌汽车时刻表
三十二乘三	三十二乘八
二百一十除十等多少	七除十等多少
总后勤部历任领导名单	外交部历任领导名单
太原哪家医院妇科比较好	兰州哪家医院妇科比较好
奥地利的首都在哪里	加拿大的首都在哪里
欢乐喜剧人第五季嘉宾	欢乐喜剧人第六季嘉宾
财达证券的佣金	财通证券的佣金
二百九十八是什么数	五是什么数
九十二年属狗的是什么命	九十三年属狗的是什么命
萧县多少个乡镇	嵩县多少个乡镇
工行什么分行	招行什么分行
武宁县有多少人口	武平县有多少人口
湛江公租房申请条件	延吉市公租房申请条件
岩寺镇邮编	岩坦镇邮编
一和九最大公因数	一和五最大公因数
德阳公交时刻表	承德公交时刻表
八的平方数	十的平方数
南昌最好的耳鼻喉医院	郑州最好的耳鼻喉医院
第一个字奇的成语	第三个字奇的成语
贵州去广州会被隔离吗	浙江去广州会被隔离吗
藤野先生写作背景	鲁迅先生写作背景
兰考县温度	微山县温度
苏州科技大学研究生复试科目	湖南科技大学研究生复试科目
五十九和八十九的最大公因数	一和八十九的最大公因数
郑州至长沙机票	西宁至长沙机票
二十五乘六十四	八十五乘六十四
云南相亲节目	内蒙古相亲节目
呼和浩特到乌兰察布多少公里	呼和浩特到西安多少公里
二千零二十济宁老旧小区改造名单	二千零二十杭州老旧小区改造名单
商丘到泰州火车时刻表	许昌到泰州火车时刻表
南京大学在全国排名第几名	南昌大学在全国排名第几名
重庆驾校投诉电话	银川驾校投诉电话
清华研究生分数	北大研究生分数
几除四等几余几	几除六等几余几
中大专业排名	上海交大专业排名
数字六在田字格怎么写	数字三在田字格怎么写
佳木斯到抚远的火车时刻表	佳木斯到南昌的火车时刻表
深圳到汝州火车	深圳到深圳火车
海南是属于哪里的	安徽是属于哪里的
雷斯林是谁	雷古鲁斯是谁
三年级下册花钟二类字组词	三年级下册花钟一类字组词
老是发烧怎么回事	偶尔发烧怎么回事
八十六年属虎和什么属相最配	八十七年属虎和什么属相最配
三十六的相邻数	四的相邻数
南京到青岛机票多少钱一张	杭州到青岛机票多少钱一张
三千立方厘米等多少平方米	一立方厘米等多少平方米
江苏的人口有多少	内蒙的人口有多少
一分钟可以做什么事情	五分钟可以做什么事情
大连职业技术学院好不好	克拉玛依职业技术学院好不好
五十二cm是多少厘米	四十二cm是多少厘米
合肥有哪些卫校	成都有哪些卫校
爱情数字0三百二十四什么意思	爱情数字八什么意思
一天赚二千的软件	一天赚三百的软件
天津新生儿落户需要什么材料	长沙新生儿落户需要什么材料
餐后两小时血糖正常值	餐后半小时血糖正常值
十九年很火的明星	二十年很火的明星
什么软件可以看湖南卫视直播	什么软件可以看辽宁卫视直播
七十一年属什么生肖属相	七十二年属什么生肖属相
二十五岁会得食道癌吗	三十五岁会得食道癌吗
黑龙江内什么快递最快	贵州内什么快递最快
浙江上学时间	黑龙江上学时间
东海县旅游景点有哪些	海盐县旅游景点有哪些
江苏离湖南远吗	江苏离北京远吗
上海找工作上什么网	南宁找工作上什么网
苹果十一有没有siri	苹果七有没有siri
十月八号出生是什么星座	七月八号出生是什么星座
月经延迟十天正常吗	月经延迟三天正常吗
西青区有几个镇	西秀区有几个镇
西安财经大学考研分数线	广东财经大学考研分数线
二百一十一大学江苏录取分数线排名	二百一十一大学湖南录取分数线排名
河师大研究生复试比例	湖南师大研究生复试比例
农行贷款二十万三年利息多少	建行贷款二十万三年利息多少
剖腹产第三天吃什么好	剖腹产第四天吃什么好
山东著名的建筑有哪些	澳门著名的建筑有哪些
哈工大有几个校区	中大有几个校区
俄罗斯企业排名	中国企业排名
澳门大学本科分数线	澳门科技大学本科分数线
云南属于南方还是北方	四川属于南方还是北方
江苏汽车消费补贴	江西汽车消费补贴
綦江中学小升初录取分数线	黔江中学小升初录取分数线
广东农工商职业技术学院什么时候开学	广东岭南职业技术学院什么时候开学
十八年九月七号是什么星座	十九年九月七号是什么星座
北邮附近酒店	南京邮电大学附近酒店
浙江公务员名单	内蒙古公务员名单
可以自己预约科目四考试吗	可以自己预约科目三考试吗
遵义医学院全国排名	协和医学院全国排名
首都经贸大学校长是谁	经贸大学校长是谁
四的多少次方等七	五的多少次方等七
河南公务员分数线	辽宁公务员分数线
鹿邑县都有哪些乡镇	涿鹿县都有哪些乡镇
大同城市人口	广东城市人口
二十以内退位减法是什么意思	一百以内退位减法是什么意思
ios十三自带按键精灵	ios十一自带按键精灵
农发行待遇怎么样	农行待遇怎么样
武汉的邮政编码	邵武市的邮政编码
不再的反义词	最的反义词
两万乘三	两万乘一万
海南属于哪个族	内蒙古属于哪个族
北京友谊医院外科专家	北京佑安医院外科专家
昆明哪里可以接种九价疫苗	西安哪里可以接种九价疫苗
西安灵活就业医保卡返多少	武汉灵活就业医保卡返多少
空腹血糖七点二十五需要吃药吗	空腹血糖七点三十五需要吃药吗
武汉迁户口条件	南京迁户口条件
青岛至上海的火车票	深圳至上海的火车票
东京到北京的直线距离	杭州到北京的直线距离
石家庄到吉林的飞机票多少钱	长沙到吉林的飞机票多少钱
九十三年农历十二月初十生的是属什么星座	九十三年农历十二八月初十生的是属什么星座
苹果八连接电脑没反应	苹果四连接电脑没反应
0八年长沙房价多少	0八年福州房价多少
北邮二千零一十九浙江录取分数线	南京邮电大学二千零一十九浙江录取分数线
九减三	九减六
中山服装批发市场在哪里	中山古镇服装批发市场在哪里
丰宁晚上好玩的地方	香港晚上好玩的地方
新生儿一小时吃一次母乳正常吗	新生儿三小时吃一次母乳正常吗
上海和河南的距离	上海和郑州的距离
六岁女孩穿多大鞋子	七岁女孩穿多大鞋子
金庸五部曲	金庸三部曲
南京邮电大学在四川录取分数线	南理工在四川录取分数线
浑源县属于哪个市	香港属于哪个市
荣耀八x上市时间	荣耀八z上市时间
基金周末有收益吗	基金星期一有收益吗
辽宁回上海要隔离十四天吗	江苏回上海要隔离十四天吗
西班牙确诊病例人数	韩国确诊病例人数
swich买哪个版本	swith买哪个版本
六岁孩子不长肉怎么办	五岁孩子不长肉怎么办
郑州的大专学校	锦州的大专学校
平阳县是哪个省的	平邑县是哪个省的
珠海到长安有多少公里	北京到长安有多少公里
连云港隔离点	长春隔离点
上海至三亚多少公里	上海至青岛多少公里
西安租房投诉电话	天津租房投诉电话
台州学院一本专业	合肥学院一本专业
张家港到泰州多少公里	张家口到泰州多少公里
十二减六加五	十二减六加七
八十五年十一月两日是什么星座	八十六年十一月两日是什么星座
在苏州可以办理外地身份证吗	在重庆可以办理外地身份证吗
九十三年正月二十六是阳历多少	九十四年正月二十六是阳历多少
九和十二的公因数有几个	九和四的公因数有几个
西北师大考研分数线	东北师大考研分数线
青岛到西藏火车票	青岛到合肥火车票
渤海是属于哪个省	黑龙江是属于哪个省
八月份去哪旅游最好	六月份去哪旅游最好
十一月份是什么星座的	六月份是什么星座的
亚洲的气候特点是	美国的气候特点是
十一月二十二是什么星座的	十一月五是什么星座的
南通到昆山怎么坐车	南通机场到昆山怎么坐车
深圳至衡水火车票	北京至衡水火车票
形容走路不着急的成语	形容走路很着急的成语
郑州明天天气怎么样	郑州今天天气怎么样
二道门是什么意思	一道门是什么意思
台北在哪个省	贵阳在哪个省
到酒泉多少公里	到香港多少公里
云南师范大学研究生录取分数线二千零二十	华南师大研究生录取分数线二千零二十
十和一百的最小公倍数	十和五的最小公倍数
太原到河北的火车票多少钱	太原到深圳的火车票多少钱
浙江确诊人数最新	台湾确诊人数最新
吉林可以进京吗	湖南可以进京吗
二千零一十九端午节放假	二千零一十八端午节放假
四月二十八是什么星座女	四月六是什么星座女
四月份去西安需要隔离吗	六月份去西安需要隔离吗
二的老写字怎么写	六的老写字怎么写
杜兰特和詹姆斯谁厉害	安东尼和詹姆斯谁厉害
浙江卫视台长是谁	浙江电视台台长是谁
邹城到青州多少公里	邹城到哈尔滨多少公里
一点二五除五	一点二五除八
成都到泸定的汽车票	成都到郑州的汽车票
瑞通卡客服电话	中铁银通卡客服电话
哈尔滨师范大学排名全国第几	哈佛大学排名全国第几
几的立方是三十六	几的立方是一百
梧州学院王牌专业	贺州学院王牌专业
九hpv是什么	一hpv是什么
贵州是高风险地区吗	吉林是高风险地区吗
宁波特色餐饮	中国特色餐饮
黑龙江科技大学属于二百一十一吗	武汉科技大学属于二百一十一吗
湖北民族大学排名	广西民族大学排名
怀孕六个月可以吃黄皮吗	怀孕七个月可以吃黄皮吗
五两五钱男命一生运气	三两五钱男命一生运气
五十一千卡等多少斤	七千卡等多少斤
十七和三十二的最大公因数	十三和三十二的最大公因数
心里时常难受怎么回事	心里很难受怎么回事
三十三岁开始吃降压药	四十三岁开始吃降压药
六开头的快递单号是什么快递	八开头的快递单号是什么快递
昆山十八路公交车路线	上海十八路公交车路线
五个月宝宝发烧三十八点五度怎么办	两月宝宝发烧三十八点五度怎么办
删除五点半的闹钟	删除四点半的闹钟
滁州西门子冰箱售后服务电话	滁州美的冰箱售后服务电话
男孩叫涵什么好听	男孩叫维什么好听
西宁到南京飞机	西宁到杭州飞机
昆明去哪家医院做流产好	石家庄去哪家医院做流产好
五月十二日的新闻联播内容	五月四日的新闻联播内容
宜宾到沈阳多少公里	香港到沈阳多少公里
孩子嘴唇很红	孩子嘴唇不红
一和九最大公因数	一和十一最大公因数
十九年有什么好看的穿越剧	二十年有什么好看的穿越剧
唐山到运城多少公里	广州到运城多少公里
郑煤集团是不是国企	同煤集团是不是国企
0一年农历十月十日是什么星座	0一年农历九月十日是什么星座
湖北身份证前六位	江苏身份证前六位
安徽属于哪个区	河南属于哪个区
新疆的特产有哪些水果	江苏的特产有哪些水果
奔驰gla三百二十价格	奔驰gle三百二十价格
沈阳师范大学研究生复试科目	吉林师范大学研究生复试科目
武汉在哪个省	太原在哪个省
江苏离菏泽有多远	江苏离湖北有多远
南昌最好玩的地方是哪里	贵阳最好玩的地方是哪里
十八年残疾军人抚恤金标准表	十九年残疾军人抚恤金标准表
十九乘五等多少	十九乘十九等多少
济南飞南京航班时刻表	香港飞南京航班时刻表
邵阳县有多少人口	阳谷县有多少人口
西藏有没有大学	河北有没有大学
河南卫视新台标	陕西卫视新台标
大连到日照的机票	北京到日照的机票
缅甸离印度多少公里	缅甸离广州多少公里
永成县属于哪个市	福永属于哪个市
科大分数线	神学院分数线
零零年一月十六是什么星座	一年一月十六是什么星座
八月二十九日是什么星座	八月一日是什么星座
上海至岳阳高铁时刻表	北京至岳阳高铁时刻表
上海交大什么专业好	西安交大什么专业好
十三年护士资格证考试的分数线	十四年护士资格证考试的分数线
邢台是哪个省的	徽州是哪个省的
一至五十的英文	一至九的英文
临汾到石家庄高铁时刻表	临汾到青岛高铁时刻表
湛江海关关长	天津海关关长
西安到贵州动车	北京到贵州动车
浙江到上海快递	杭州到上海快递
安阳共享汽车怎么收费	益阳共享汽车怎么收费
nono怎么读	eno怎么读
江西新冠肺炎风险等级	海南新冠肺炎风险等级
八和二十五是互质数吗	十和二十五是互质数吗
洛阳属哪个省	南昌属哪个省
河南大学声乐分数线	河北大学声乐分数线
a三十一恢复出厂设置	w三十一恢复出厂设置
玉溪有哪些大学	日本有哪些大学
清涧县有多少个乡镇	清河县有多少个乡镇
首都体育学院拟录取名单	天津体育学院拟录取名单
平顶山属于哪个省	南平属于哪个省
沈阳到乾安客车时刻表	沈阳到郑州客车时刻表
贵阳到义乌汽车票	上海到义乌汽车票
哈尔滨理工大学是重本吗	哈尔滨商业大学是重本吗
十四是四的倍数吗	九是四的倍数吗
山东好玩的地方	福建好玩的地方
零零年二月有多少天	一年二月有多少天
南京区货车限行时间	武汉区货车限行时间
青岛海洋大学校训	浙江海洋大学校训
七十二和五十四最大的公因数是	七十二和六十四最大的公因数是
赵本山的电影	山本彩的电影
杭州到首尔	休斯敦到首尔
吉林监理公司排名	甘肃监理公司排名
阳城县方言	中国方言
长春在哪个省	石家庄在哪个省
一米六十三的标准体重	一米七的标准体重
苇子坑邮编	内坑镇邮编
牙齿老是出血	牙齿偶尔出血
奔驰gls四百五十多少钱	奔驰gle四百五十多少钱
二十一乘二十四的竖式计算	二十三乘二十四的竖式计算
五个月宝宝咳嗽怎么办	三月宝宝咳嗽怎么办
月经完的第一天是安全期吗	月经完的第四天是安全期吗
京剧的四大行当是	京剧的五大行当是
二十八的三分之一	二十八的五分之一
humbly什么意思中文	hurriedly什么意思中文
三十六乘三十	三十六乘四十
月经完第六天会排卵吗	月经完第二天会排卵吗
运城去西藏	运城去北京
九十七年四月二十一日出生的是什么星座	九十八年四月二十一日出生的是什么星座
白城到吉林火车	白城到青岛火车
一个月的宝宝老是吐奶怎么回事	一个月的宝宝偶尔吐奶怎么回事
沈阳理工大学男女比例	华理男女比例
十九年青岛海洋大学录取分数线	十九年海大录取分数线
义乌到高邮	义乌到四川
南昌航空大学好就业吗	南澳大学好就业吗
宁波至潢川火车时刻表	重庆至潢川火车时刻表
辽宁师范大学历任校长	辽宁工业大学历任校长
沈阳到英国多少公里	沈阳到香港多少公里
七的写法怎么写视频	四的写法怎么写视频
附近oppo服务中心	附近oppo客户服务中心
cad怎么打印一千一百的图	cad怎么打印一千二百的图
六月二十七日什么星座	三月六日什么星座
西安外事学院专业有哪些	西安石油大学专业有哪些
太原到襄垣火车时刻表查询	太原到成都火车时刻表查询
八分之三乘三分之一	八分之三乘三分之八
现任北京供电局局长	现任南宁供电局局长
深圳到冠豸山动车时刻表	深圳到石家庄动车时刻表
郴州有几个高速出口	驻马店有几个高速出口
广东疫情最新进展	河北疫情最新进展
兰州飞洛杉矶	重庆飞洛杉矶
成都体育学院院校代码	西安体育学院院校代码
广州到恩施	广州到北京
浙江财经类院校排名	河南财经类院校排名
鼻头突然有点痛	鼻头突然很痛
一千九百四十四是什么生肖	一千九百四十五是什么生肖
一百五十港币等多少人民币	零港币等多少人民币
三元六角等多少元多少角	三元八角等多少元多少角
亚洲周刊十大好书二千零一十九	亚洲周刊十大好书二千零一十八
试管移植第二天恶心想吐	试管移植第五天恶心想吐
五的二千次方等多少	五的零次方等多少
梧州到遵义多少公里	喀什到遵义多少公里
长沙到三门峡	长沙到北京
九和十八的最大公因数是几	六和十八的最大公因数是几
川北医学院录取分数线二千零一十九是多少分	清华录取分数线二千零一十九是多少分
玉林师范学院美术录取分数线	宁夏师范学院美术录取分数线
印度与西藏的关系	印度与伊朗的关系
星期六日可以考科二吗	星期六日可以考科一吗
十月二十六日是什么星座	十月一日是什么星座
湖南农业大学和湖南工商大学哪个好	山西农业大学和湖南工商大学哪个好
北京天坛医院门诊几点上班	北京同仁医院门诊几点上班
昆明有什地方好玩	济南有什地方好玩
贵州有几个火车站	广西有几个火车站
长沙到顺德高铁	南京到顺德高铁
四十和七的最小公倍数是多少	九和七的最小公倍数是多少
合肥一中邮编	重庆一中邮编
中国的七大古都是	中国的四大古都是
二十七周突然感觉不到胎动	二十八周突然感觉不到胎动
二千零一十九东京人口数量	二千零一十九东阳人口数量
江苏科技大学怎么样	陕西科技大学怎么样
对中国现代教育的看法	对中国以往教育的看法
昆明到北京的机票多少钱一张	昆明到长沙的机票多少钱一张
一千九百六十九正月十六是几号	一千九百六十九腊月十六是几号
五十加六十	六十加六十
四百度近视严重吗	六百度近视严重吗
健力宝是国企吗	百度是国企吗
中建一局在哪里	中建五局在哪里
西安是一线吗	昆明是一线吗
十一岁男孩身高体重标准	十二岁男孩身高体重标准
金华到滁州多少公里	金华到重庆多少公里
ipad二千零二十死机	ipad四死机
韶关到义乌火车时刻表	韶关到杭州火车时刻表
二的五倍	三的五倍
沈阳护士免费景点	洛阳护士免费景点
威海常住人口有多少	大同常住人口有多少
一百一十一以内的奇数	九以内的奇数
揭阳到无锡顺丰要多久	成都到无锡顺丰要多久
中行存款规模	中国人民银行存款规模
九月一是什么日子	九月三是什么日子
长兴县属于哪里	长安县属于哪里
谷歌账号怎么注册	百度账号怎么注册
四除十七等多少	十一除十七等多少
天津在哪里	南京在哪里
华西医学院院长	西南林学院院长
宝日希勒镇人口	中国人口
alyssa的意思	alisha的意思
经常失眠怎么调理	偶尔失眠怎么调理
四字名字游戏名字	二字名字游戏名字
空调二十四小时不关	空调四十八小时不关
河北工程大学是二百一十一吗	空军工程大学是二百一十一吗
芜湖到株洲的火车时刻表	芜湖到西安的火车时刻表
武汉附近哪里有摘樱桃的地方	济南附近哪里有摘樱桃的地方
西安到拉萨高铁票价	西安到杭州高铁票价
钢铁是怎样炼成第五章概括	钢铁是怎样炼成第二章概括
广东公务员一年考几次	广西公务员一年考几次
上海到杞县大巴车电话	上海到合肥大巴车电话
兰州有几个火车站	石家庄有几个火车站
鲍姓男孩取名	吉姓男孩取名
五十五乘二十七	五十五乘二十二
成都到福州顺丰要多久	成都到西安顺丰要多久
十八年国内电视剧	十九年国内电视剧
辽宁工业大学书记	浙江工业大学书记
绥化宝马四s店地址	十堰宝马四s店地址
十七岁可以办工行卡吗	十八岁可以办工行卡吗
钱塘江有多长	珠江有多长
一百二十乘六十等	六乘六十等
鸡西什么时候开学二千零二十	香港什么时候开学二千零二十
五年级十一班用英语怎么说	五年级五班用英语怎么说
六楼会有蚊子吗	五楼会有蚊子吗
威海到广州的火车	威海到哈尔滨的火车
九十六年六月六号是什么星座	九十七年六月六号是什么星座
今天泸州有雨吗	今天青岛有雨吗
哈尔滨师范大学黑龙江录取分数线	沈阳师范大学黑龙江录取分数线
巴斯夫总部在哪里	微软总部在哪里
什么除三等十八	什么除三等四
中信电子回单怎么打印	中行电子回单怎么打印
大连医科大学是几本	哈尔滨医科大学是几本
华师大简称	西华师大简称
韩国战斗机数量	美国战斗机数量
六和十二的最大公因数最小公倍数	七和十二的最大公因数最小公倍数
十五岁是初中吗	十六岁是初中吗
江苏二本院校有哪些学校	重庆二本院校有哪些学校
植树节的由来一百字	植树节的由来十字
湖南有什么族	江苏有什么族
杭州到沧州高铁	杭州到福州高铁
福建离安徽有多少公里	福建离广西有多少公里
十七英寸等多少厘米	十五英寸等多少厘米
二百六十除四	二百六十除五
成都修表的地方	长春修表的地方
奔驰gls五百保养复位	奔驰gls三百保养复位
七十五年的电影	七十六年的电影
许昌学院属于哪个区	钦州学院属于哪个区
河南离拉萨有多远	湖北离拉萨有多远
六安到上海的火车票	哈尔滨到上海的火车票
沈阳农业大学是一本么	吉林农业大学是一本么
哈工大有几个校区	哈师大有几个校区
厦门到莆田动车时刻表	厦门到西安动车时刻表
咸阳至安康多少公里	咸阳至安康苑多少公里
青岛的邮政编码是	泸州的邮政编码是
双色球六加一多少钱	双色球三加一多少钱
二级建造师教材十二年与十三年一样吗	二级建造师教材十二年与十四年一样吗
九十二年九月初四是什么星座	九十三年九月初四是什么星座
北外翻译博士	广外翻译博士
二千零一十九重庆师范学院分数线	二千零一十九廊坊师范学院分数线
十九年三月份的电影	十九年七月份的电影
在北京当服务员怎么样	在北京酒店当服务员怎么样
身高一米五的英文	身高一米六的英文
无锡到周庄多少公里	无锡机场到周庄多少公里
吉林到聊城快递几天	浙江到聊城快递几天
浙江服装企业排名	四川服装企业排名
一百二十和一百六十的最大公因数	一百二十和一百八十的最大公因数
复旦有大专吗	北师大有大专吗
青岛区域排名	香港区域排名
三亚哪里最好玩	郑州哪里最好玩
十一月二十五是什么节日	五月二十五是什么节日
有关尼尔的小说	有关奥尼尔的小说
格力智睿中央空调一拖五的价格	格力智睿中央空调一拖四的价格
西北师范大学特色专业	西北民族大学特色专业
五和四十五最大公因数是多少	五和七最大公因数是多少
成都有几个省	西安有几个省
六除一点五	六除二点五
现在武汉到合肥需要隔离吗	现在武汉到广东需要隔离吗
科三怎么考过	科一怎么考过
世界六大车系	世界五大车系
北大二千零二十考研分数线	北京农业大学二千零二十考研分数线
佳木斯是哪个省的	商丘是哪个省的
枕头太高睡不着	枕头不高睡不着
十八字短句	三字短句
正月十五的习俗急啊	腊月十五的习俗急啊
张羽茉名字打分	张梦琪名字打分
苹果六代替home键的小圆点哪里设置	苹果十一代替home键的小圆点哪里设置
什么是肿瘤四项	什么是肿瘤六项
战地五内存要求	战地一内存要求
历史上姓翟的名人有哪些	历史上姓苏的名人有哪些
八十五除一百	八十五除二
胎儿头围偏小	胎儿头围越来越小
一百乘二十	五百乘二十
赣马高级中学校长	潮州高级中学校长
月经干净后第一天会排卵吗	月经干净后第九天会排卵吗
阴历三月初四是什么命	阴历四月初四是什么命
云南警官学院怎么样	云南中医学院怎么样
中行客服工资	中信客服工资
四川师范大学校训	广西师范大学校训
十一年年三十是多少号	十二年年三十是多少号
大写七字怎么写笔顺	大写一字怎么写笔顺
山东方言	内蒙古方言
九百五十一除五的竖式怎么列	零除五的竖式怎么列
二十乘八	二十乘六
齐齐哈尔到昂昂溪多少公里	齐齐哈尔到郑州多少公里
和田到张掖的飞机票	和田到天津的飞机票
苏州到沈阳火车票价格	北京到沈阳火车票价格
山西师范大学是双一流吗	陕西师大是双一流吗
上海交大和北大哪个好	上海交大和人大哪个好
形容青春的一个字	形容青春的四个字
三十八年出生男演员	三十九年出生男演员
三月十一日是什么星座	三月九日是什么星座
第九的英语怎么说	第二的英语怎么说
八千开根号等多少	一万三千开根号等多少
太原到湖州火车时刻表	太原到南昌火车时刻表
深圳至衡水火车票	深圳至广州火车票
淮南景点大全	澳门景点大全
肾功三项能查出什么病	肾功二项能查出什么病
二里面有几个一除六	三里面有几个一除六
邓丽君怎么死	邓九公怎么死
中国民生银行资产总额	中国人民银行资产总额
五除十二乘九等多少	五除十二乘十六等多少
七百八十乘二十	二十乘二十
爱尔兰药企排名	安国药企排名
南京师大历史系在哪个校区	湖南师大历史系在哪个校区
岳阳至通城多少公里	岳阳至成都多少公里
建行etc怎么注销	农行etc怎么注销
九价疫苗影响怀孕吗	四价疫苗影响怀孕吗
长宁火车票代售点	永宁火车票代售点
浙江百强企业排名	甘肃百强企业排名
历史上姓杨的名人	历史上姓卜的名人
形容人很胖的句子	形容人不胖的句子
太原到邯郸火车	太原到成都火车
泰安有哪些医院	枣阳市有哪些医院
贵阳到玉屏火车票	贵阳到武汉火车票
郑州在哪儿	成都在哪儿
上海到明光市火车	上海到深圳火车
安达市面积	四平面积
华泰证券是上市公司吗	华西证券是上市公司吗
中卫到武汉火车时刻表	中卫到济南火车时刻表
四个月宝宝发烧怎么办	十一月宝宝发烧怎么办
梦见数字十九是什么意思	梦见数字一是什么意思
南理工分数线	武汉理工分数线
石狮到青岛物流	石狮到香港物流
华为诺娃七的价格	华为诺娃六的价格
北京最好的皮肤科医院	重庆最好的皮肤科医院
小米十白名单	小米八白名单
六和十五的公倍数是	六和八的公倍数是
西安的体检中心有哪些	南宁的体检中心有哪些
沈丘到滁州高铁	武汉到滁州高铁
郑州至昆明多少公里	北京至昆明多少公里
北大录取分数线	北师大录取分数线
西北师范大学具体地址	西北师大附中具体地址
哪些人不能去北京	哪些人不能去美国
内蒙古工业大学一本专业	天津工业大学一本专业
十二和三十五最大公因数	十二和二十五最大公因数
钢铁是怎样炼成的第一部第九章好句	钢铁是怎样炼成的第一部第三章好句
六乘四十五等几	四十乘四十五等几
南京到杭州快递要多久	南京到深圳快递要多久
牡丹江到明水县多少公里	牡丹江到武汉多少公里
八十五年十月初三是几月几号	八十六年十月初三是几月几号
一到一百的英语序数词	一到十的英语序数词
西安到三门峡多少公里	天津到三门峡多少公里
进贤到丰城火车	进贤到西安火车
北邮附近酒店	重庆邮电大学附近酒店
乌兰浩特到阿尔山多远	乌兰浩特到成都多远
哈尔滨洗浴开了吗	天津洗浴开了吗
石家庄的重点大学	英国的重点大学
污染防治八大战役	污染防治七大战役
现在什么行业好做	将来什么行业好做
淮河有多长	沂河有多长
二千六百五十立方厘米等多少毫升	四立方厘米等多少毫升
十三基数词	十六基数词
三的倍数特征	五的倍数特征
韵达永丰客服电话	韵达桂林客服电话
五十四除三	五十四除四
二千零一十五香港电影票房排行	二千零一十五中国电影票房排行
二十年幼儿园啥时候开学宁夏	二十年幼儿园啥时候开学甘肃
睢阳区邮政编码	双阳区邮政编码
传祺gm八好不好	传祺ga八好不好
石家庄社保最低缴费标准	成都社保最低缴费标准
江西有多少个飞机场	内蒙有多少个飞机场
宜昌有多少人口	日本有多少人口
五十一表示什么	二十一表示什么
宜昌到天津动车时刻表	石家庄到天津动车时刻表
扬州有什么好玩的地方	郑州有什么好玩的地方
山大硕士毕业要求	燕山大学硕士毕业要求
今天最高温度	明天最高温度
沈阳到台安火车	沈阳到哈尔滨火车
二字拼音怎么写的拼音怎么写	五字拼音怎么写的拼音怎么写
合肥学院一本专业	合肥师范学院一本专业
合肥生活节奏快吗	济南生活节奏快吗
中建一局一级建造师补贴	中建七局一级建造师补贴
深圳至西双版纳高铁	成都至西双版纳高铁
头发有点硬怎么变软	头发太硬怎么变软
七月份怀孕预产期是什么时候	八月份怀孕预产期是什么时候
南宁到温州动车	西安到温州动车
我是零零年农历十一月初九	我是零零年农历五月初九
鞍山师范学院怎么样	鞍山一中怎么样
新历三月十二日是什么星座	新历三月六日是什么星座
今天成都限行吗	今天广州限行吗
张家口二十一路公交车路线时间表	成都二十一路公交车路线时间表
二十六除五用竖式计算	三十六除五用竖式计算
景德镇到新乡火车时刻表	景德镇到南京火车时刻表
黄山到宁夏多少公里	上海到宁夏多少公里
怀孕第五天能测出来吗	怀孕第三天能测出来吗
潍坊到昌邑物流	潍坊到江苏物流
松江到菏泽火车时刻表	杭州到菏泽火车时刻表
西华师大有几个学院	华师大有几个学院
孕三十七周都需要做什么检查	孕三十九周都需要做什么检查
赤峰三十年规划	广州三十年规划
二十三年是什么年什么命什么属性	二十四年是什么年什么命什么属性
一千八百一十五啥意思	一千八百一十八啥意思
奔驰gle价格	奔驰gla价格
科目四多少分过	科目三多少分过
十三楼有蚊子吗	十二楼有蚊子吗
ucom是什么牌子	comcom是什么牌子
北京去天津要隔离吗	北京去合肥要隔离吗
昆明飞西宁	广州飞西宁
井底之蛙告诉我们什么道理十字	井底之蛙告诉我们什么道理一百字
七十二岁算长寿吗	七十三岁算长寿吗
新乐市消费者投诉电话	泸州消费者投诉电话
三月八是什么日子	三月十三是什么日子
五和两的因数	三和两的因数
上海哪个医院看男科最好	邯郸哪个医院看男科最好
低压六十高压一百一十正常吗	低压六十高压七十正常吗
一除零等多少	一除五十等多少
西宁到宝鸡多少公里	兰州到宝鸡多少公里
龙门到汕头	龙门到西安
韩国四代女团排行	韩国三代女团排行
怀化学院名人	吉林化工学院名人
河北大学多少学生	西北大学多少学生
社保局管什么	安监局管什么
nba门票哪里买	cba门票哪里买
北师大一年学费多少	复旦一年学费多少
今天喝酒明天可以献血吗	今晚喝酒明天可以献血吗
为什么肚子特别大	为什么肚子一直大
山东选调生待遇	四川选调生待遇
南理工招生分数线	山东理工大学招生分数线
八十一和十五的最大公因数是多少	八十一和八的最大公因数是多少
吴江市属于哪个省份	江山市属于哪个省份
备注十八有什么寓意	备注十六有什么寓意
韶关到云南多少公里	韶关到佛山多少公里
九十六年六月六号是什么星座	九十七年六月六号是什么星座
科大分数线	人大分数线
宿迁到天津有多少公里	宿迁到东莞有多少公里
晋江到昆明的飞机票多少钱	晋江到厦门的飞机票多少钱
吉林是在哪个省	西藏是在哪个省
十八年高考报名时间	十九年高考报名时间
云南师范大学研究生补助	江西师范大学研究生补助
碱性磷酸酶三百四十九	碱性磷酸酶三百一十九
宝鸡到兰州有多少公里	宝鸡到济南有多少公里
九十六年四月二十九是什么命	九十六年四月二十八是什么命
三百五十乘二	四百五十乘二
五号天气怎么样	八号天气怎么样
九周岁男孩标准身高体重对照表	五周岁男孩标准身高体重对照表
兰州天燃气电话	广州天燃气电话
冷氏现代名人	房氏现代名人
成年人心率九十正常吗	成年人心率一百正常吗
例假第一天可以洗澡吗	例假第三天可以洗澡吗
七和二十三最大公因数和最小公倍数	七和二十八最大公因数和最小公倍数
从吉林到南京需要隔离吗	从贵州到南京需要隔离吗
iphone七plus电池多少钱	iphone八plus电池多少钱
中华女子学院邮编	中国美术学院邮编
比零小的数都是负数	比一小的数都是负数
内蒙古到西安	湖北到西安
产后第一天吃什么	产后第五天吃什么
福州到吉林多少公里	福州到厦门多少公里
河北滑石粉生产厂家	新疆滑石粉生产厂家
深圳到汝州火车	深圳到上海火车
月经完的第一天是安全期吗	月经完的第二天是安全期吗
十五乘四	十五乘三
湖南最穷的城市	西藏最穷的城市
十五乘十三等	十五乘十二等
济南律师平均收入	太原律师平均收入
怀孕一个月可以自然流产吗	怀孕五个月可以自然流产吗
上海哪里批发衣服	郑州哪里批发衣服
二百一十除七	二百一十除三
凌源邮编	辽源邮编
石家庄到平定县多少公里	石家庄到西安多少公里
cad二千零一十四和二千零一十三哪个好	cad二千零一十四和二千零一十九哪个好
甲数是二十四	甲数是七
沈阳到阜新火车站列车时刻表	沈阳站到阜新火车站列车时刻表
七年级下册英语unit九知识点	七年级下册英语unit四知识点
老是吐痰是怎么回事	偶尔吐痰是怎么回事
非常的近义词	常常的近义词
西安换护照需要什么材料	济南换护照需要什么材料
九十四岁是什么之年	九十六岁是什么之年
八月二十六日是什么星座	八月一日是什么星座
月经刚结束会怀孕吗	月经未结束会怀孕吗
南京哪里工厂最多的地方	南宁哪里工厂最多的地方
安徽特产茶叶	海南特产茶叶
广州到珠海多少钱	广州到上海多少钱
朱厚照在位多少年	邓小平在位多少年
华东师大怎样	西华师大怎样
北大录取分数线	北交大录取分数线
武夷山到广州动车	武夷山到厦门动车
一美金多少人民币	四美金多少人民币
天津哪个医院看哮喘好	西安哪个医院看哮喘好
八十九年农历五月二十五日出生的人是什么星座	八十九年农历五月四日出生的人是什么星座
建行股票代码是多少	中国铁建股票代码是多少
心率八十六正常吗	心率二百正常吗
长春到迁安多少公里	洛阳到迁安多少公里
南京有捷达四s店吗	天津有捷达四s店吗
古代散文有哪些	近代散文有哪些
共青城离九江有多远	共青城离南昌有多远
合肥到霍山有多远	合肥到上海有多远
七十二年十二月两日出生是什么命	七十三年十二月两日出生是什么命
六十亿是多少亿	六千万是多少亿
比五十少一的数是几	比一千少一的数是几
诗意的网名古风三个字	诗意的网名古风五个字
王姓女孩起名	吕姓女孩起名
华硕笔记本如何取消开机密码	微软笔记本如何取消开机密码
十九年双色球四十四期开奖号码	二十年双色球四十四期开奖号码
八百除五	八百除八十
六数字含义	三数字含义
疫情期间的印度	疫情期间的德国
十四年日元汇率	十五年日元汇率
十九年安徽教师招聘人数	二十年安徽教师招聘人数
芒果怎么开启自动续费	苹果怎么开启自动续费
青岛理工大学考研复试分数线	兰州理工大学考研复试分数线
四百一十七除三的竖式计算	九除三的竖式计算
长沙县什么医院最好	上海什么医院最好
无锡到天津有多少公里	无锡到南京有多少公里
潍坊到安徽有多少公里	潍坊到湖南有多少公里
当除数是四时余数可能是几	当除数是一时余数可能是几
十六年四月有几天	十七年四月有几天
西溪海房价	海西路房价
十三年lpr利率	十四年lpr利率
邓州到宝鸡火车时刻表	邓州到济南火车时刻表
呼和浩特到伊金霍洛旗动车	呼和浩特到西安动车
faceu是什么相机	faceo是什么相机
九十减八等多少	六减八等多少
武汉科技大学湖北录取分数线	江苏科技大学湖北录取分数线
促甲状腺激素一点八十三	促甲状腺激素一点八十二
阿里巴巴是几几年上市的	百度是几几年上市的
犹他大学排名	温州大学排名
月经第二天雌二醇正常值	月经第五天雌二醇正常值
浙江工业大学有专升本吗	湖北工业大学有专升本吗
上海到德国飞机多少钱	上海到昆明飞机多少钱
hpv五十二阳性怎么治疗	hpv六阳性怎么治疗
南昌去苏州	天津去苏州
怀孕二十八周宝宝头朝上怎么办	怀孕二十九周宝宝头朝上怎么办
王姓女孩起名	蒋姓女孩起名
十二分之七乘三	十二分之七乘十四
美兰区的邮编是多少	美国的邮编是多少
铁道游击队是谁写的	石家庄铁道大学是谁写的
十八人圆桌尺寸	三人圆桌尺寸
成都电信信号怎么样	南宁电信信号怎么样
建行信用电话	农行信用电话
怀孕三个月可以做人流吗	怀孕六个月可以做人流吗
济南到沈阳特价机票	济南到重庆特价机票
三级美术师怎么考	四级美术师怎么考
五百四十除二十	五百四十除五
明天日子好吗	昨天日子好吗
贵阳在哪个省	中国在哪个省
山西有哪些大专学校	辽宁有哪些大专学校
朗诗地产成都项目	朗诗地产西安项目
小孩偶尔咳嗽	小孩老是咳嗽
佛潭到漳州客车	成都到漳州客车
长春到迁安多少公里	长春到合肥多少公里
上海到桐城物流专线	上海到广东物流专线
耳洞突然很痛	耳洞突然有点痛
vivox七plus价格	vivox九plus价格
历史上姓杨的名人	历史上姓徐的名人
杭州购房政策	菏泽购房政策
骨伤科医院电话	临沂医院电话
西南政法大学转专业	西南石油大学转专业
西安二十五路公交车路线	上海二十五路公交车路线
珠海空置房物业费	重庆空置房物业费
四十四岁还有怀孕的可能吗	四十五岁还有怀孕的可能吗
南宫到临西客车时刻表	石家庄到临西客车时刻表
坪山有哪些医院	坪山新区有哪些医院
上海戏剧学院专业分数线	上海商学院专业分数线
梧州学院王牌专业	泰州学院王牌专业
东华理工大学是一本吗	华东政法大学是一本吗
锦州到大连火车	锦州到厦门火车
上海到拉萨火车软卧图片	成都到拉萨火车软卧图片
西南政法大学绩点	西南石油大学绩点
南充到重庆	马鞍山到重庆
衡阳到桂林有多远	长沙到桂林有多远
深圳湾怎么预约	深圳湾公园怎么预约
石家庄的公园有哪些	上海的公园有哪些
定一个三点五十的闹铃	定一个四点五十的闹铃
河北高速公路什么时候收费	内蒙古高速公路什么时候收费
南京工业大学是名校吗	湖南工业大学是名校吗
江西十九年艺术录取分数线	江西二十年艺术录取分数线
西悉尼大学地址	西江大学地址
八级木匠相当于	七级木匠相当于
新车第三次保养项目	新车第一次保养项目
阳历三月两日	阳历三月九日
河南有影响力的媒体	湖南有影响力的媒体
泰和县属于哪个市	泰顺县属于哪个市
六岁儿童身高和体重标准	八岁儿童身高和体重标准
扬中到宿州多少公里	西安到宿州多少公里
六月份什么农作物成熟	五月份什么农作物成熟
广东有哪些古城	山西有哪些古城
韩国著名城市	香港著名城市
牟定一中校长	牟平一中校长
浦发银行卡丢失	广发卡丢失
一百除七	五除七
高密到银川火车时刻表	武汉到银川火车时刻表
距离七月十七还有多少天	距离七月十九还有多少天
沈阳师范大学研究生复试科目	云南师范大学研究生复试科目
十八画的词语	十七画的词语
广州比较好的蛋糕店	郑州比较好的蛋糕店
cma哪个网校好	cpa哪个网校好
现在从武汉到岳阳需要隔离吗	现在从武汉到沈阳需要隔离吗
沈阳到大同机票	沈阳到西安机票
和八相邻的两个数是	和一千相邻的两个数是
重庆适合孩子玩的景点	济南适合孩子玩的景点
梅宏园居委会电话	吴川梅录保健院电话
西南政法大学转专业	西南财大转专业
驻马店到界首多少公里	驻马店到成都多少公里
低压六十高压一百一十正常吗	低压六十高压一百六十正常吗
息屏时间设为一分钟	息屏时间设为五分钟
长沙至兰州高铁时刻表	广州至兰州高铁时刻表
长沙补助政策	西安补助政策
哈佛大学人数	哈尔滨理工大学人数
本溪到保定火车时刻表查询	长沙到保定火车时刻表查询
湖南城市学院是几本	湖南警察学院是几本
二千零二十山西中考分数	二千零二十河南中考分数
驻马店居住证怎么办理	胶州市居住证怎么办理
十六字方针是什么意思	十二字方针是什么意思
成都河粉生产厂家	郑州河粉生产厂家
九十八年阴历九月二十一阳历	九十八年阴历九月二十二阳历
昨晚梦见三条蛇	今天晚上梦见三条蛇
六月十五日是什么星座	六月四日是什么星座
二十五周胎盘成熟度一级正常吗	二十三周胎盘成熟度一级正常吗
绍兴文理学院艺术类分数线	南理学院艺术类分数线
八月十四日出生的人命运	八月十五出生的人命运
中考总分多少各科都是多少分新疆	中考总分多少各科都是多少分安徽
龙牡壮骨颗粒适合十二岁孩子吗	龙牡壮骨颗粒适合十一岁孩子吗
吉林到乌海火车时刻表	郑州到乌海火车时刻表
十月四日是什么星座	五月四日是什么星座
一百乘五十	二百乘五十
从广州去深圳需要隔离吗	从广州去长沙需要隔离吗
九十四年几岁	九十五年几岁
十二年生肖	十三年生肖
例假第一天可以洗澡吗	例假第六天可以洗澡吗
南宁著名饭店	武汉著名饭店
七月五日出生的明星	三月七日出生的明星
武汉到南阳需要隔离吗	长春到南阳需要隔离吗
四川最著名的人物	河南最著名的人物
六十八年阳历三月十五阴历是几月初几	六十八年阳历三月十五阴历是几八月初几
从甘肃回乌鲁木齐需要隔离吗	从青岛回乌鲁木齐需要隔离吗
河北到威海多少公里	淮北到威海多少公里
三十和十最大的公因数	四和十最大的公因数
二十七乘八	二十七乘六
湖南什么地方好玩	浙江什么地方好玩
约旦在哪个国家	新西兰在哪个国家
唐山到平顶山多少公里	胶州到平顶山多少公里
成都总体规划	拉萨总体规划
吉林农业大学是几本	新疆农业大学是几本
高压一百六十低压九十严重吗	高压一百六十低压一百严重吗
三的多少次方等四	六的多少次方等四
三至四岁儿歌	三至六岁儿歌
小米十滑动卡顿	小米八滑动卡顿
广州长历任	昆明长历任
七十四年四月初一是什么星座	七十五年四月初一是什么星座
合肥附近有哪些好玩的城市	郑州附近有哪些好玩的城市
最近总是拉肚子怎么回事	最近有点拉肚子怎么回事
女生说很闲怎么回复	女生说不闲怎么回复
长江有多长	珠江有多长
十五楼蚊子能飞上来吗	八楼蚊子能飞上来吗
古诗词二十八字	古诗词七字
取消十三点的闹钟	取消十六点的闹钟
肌酐四十二正常吗	肌酐九正常吗
六乘十	八乘十
狂犬疫苗多少钱一针	狂犬疫苗多少钱三针
三天没有大便了怎么办	七天没有大便了怎么办
去青海最佳时间	去云南最佳时间
广安面积	武安市面积
怎么让猫乖乖睡觉	怎么让猫不睡觉
天津娱乐场所什么时候开业	长春娱乐场所什么时候开业
三百一十七除两	三百一十三除两
深圳出发自驾游推荐	遵义出发自驾游推荐
七千八百四十二是什么意思	七千八百五十二是什么意思
八福临门是哪五福	五福临门是哪五福
西安石油大学历任校长	西安交大历任校长
深圳寺庙有哪些	香港寺庙有哪些
去郴州的高铁	去重庆的高铁
三阴四阳是什么意思	三阴三阳是什么意思
济南到长春的火车票多少钱	济南到北京的火车票多少钱
重庆有到上海的高铁吗	重庆有到广州的高铁吗
五百四十除五	五百四十除四
湖南工业大学明星校友	河南工业大学明星校友
whatareyou是什么意思	whoareyou是什么意思
洛阳属哪个省	兰州属哪个省
嵩山北路属于哪个区	太行北路属于哪个区
八十除四	八百除四
明天西安什么天气	明天太原什么天气
太原到河北的火车票多少钱	重庆到河北的火车票多少钱
小米六充电功率	小米五充电功率
七百五十除二	七百五十除十五
九和六最大的公因数	九和八最大的公因数
北大开学日期	北师大开学日期
六的最大因数是多少	十的最大因数是多少
黑龙江到辽阳多远	黑龙江到沈阳多远
做人流第一天可以吃榴莲吗	做人流第二天可以吃榴莲吗
六岁女孩身高体重标准	一岁女孩身高体重标准
现任捷克总统是谁	现任白俄罗斯总统是谁
一千除一千	一千除二
北京市长哪里人	重庆市长哪里人
黑瞎子岛面积	微山岛面积
南通到宁波客车	南通到昆明客车
泸州闯红灯扣几分罚多少钱	哈尔滨闯红灯扣几分罚多少钱
十二岁男生适合什么发型	十六岁男生适合什么发型
农历九月二十三阳历	农历九月十八阳历
四十个月宝宝睡眠时间	五月宝宝睡眠时间
上海电力大学学费	上海交大学费
武昌至娄底的火车	武昌至福州的火车
八十七年农历四月初一是什么星座	八十七年农历五月初一是什么星座
上海交大在职研究生好考吗	西安交大在职研究生好考吗
沈阳理工大学属于哪个社区	太原理工属于哪个社区
渥太华消费水平怎么样	美国消费水平怎么样
合肥学院好不好	合肥省立医院好不好
新生儿总是吐奶正常吗	新生儿偶尔吐奶正常吗
一和九最大公因数	十二和九最大公因数
西安哪家医院男科好	哈尔滨哪家医院男科好
三月十二日油价	三月九日油价
陕西新能源项目	海南新能源项目
南大有二本专业吗	南师大有二本专业吗
盘江在什么地方	马江在什么地方
血压一百四十六除七十二正常吗	血压一百三十六除七十二正常吗
山东和湖北气候对比	贵州和湖北气候对比
凑十法九加八	凑十法九加六
合肥有名的体检中心	南京有名的体检中心
苹果七plus参数	苹果六plus参数
泉州师范学院是一本吗	商丘师范学院是一本吗
四十八乘二	四十八乘五
邳州到东海县火车	邳州到上海火车
传祺ga四口碑	传祺gs四口碑
沈阳师范大学学号	四川师范大学学号
南宁著名饭店	合肥著名饭店
济南清除甲醛	昆明清除甲醛
公安县新农合咨询电话	太康县新农合咨询电话
太原晚报热线电话	成都晚报热线电话
三十年代的文学作品	八十年代的文学作品
一百和四十八的最大公因数是多少	八和四十八的最大公因数是多少
南充到济南汽车站时刻表	焦作到济南汽车站时刻表
招远到蓬莱多少公里	成都到蓬莱多少公里
杨宇轩名字怎么样	杨天宇名字怎么样
十四岁的女孩会怀孕吗	十六岁的女孩会怀孕吗
彩虹桥的特点	七彩桥的特点
孕三十一周空腹血糖五点两正常吗	孕三十四周空腹血糖五点两正常吗
八个月的宝宝吃什么辅食	四月的宝宝吃什么辅食
七月三十日出生的人	七月初七出生的人
十月二十六号出生的明星	十月十四出生的明星
成都第一季度gdp二千零二十	长春第一季度gdp二千零二十
济南在哪里可以打狂犬疫苗	长沙在哪里可以打狂犬疫苗
清华地址在哪里	中大地址在哪里
西安医保中心咨询电话	成都医保中心咨询电话
济南到运城飞机票多少钱	济南到天津飞机票多少钱
天津下雨了吗	南宁下雨了吗
天津师范大学二本专业在哪个校区	江西师范大学二本专业在哪个校区
小米和三星哪个好	小米和华为哪个好
八和二十八的最小公倍数	十和二十八的最小公倍数
燕山大学二千零一十九招生人数	清华二千零一十九招生人数
十一月十一是什么星座	十一月十六是什么星座
西南财大工商管理硕士学费	上海财大工商管理硕士学费
山东分几个区	济南分几个区
许昌到南阳的汽车	许昌到西安的汽车
哈尔滨开车到烟台费用	哈尔滨开车到天津费用
十七年图灵奖获得者	十八年图灵奖获得者
大连海大二千零一十九考研录取分数线	大连大学二千零一十九考研录取分数线
伏尔加河世界第几	亚马逊河世界第几
西京医院肾脏内科主任	唐都医院肾脏内科主任
罗马数字十七	罗马数字千
兰州到南阳的火车	兰州到沈阳的火车
香港房价排名	武昌房价排名
吉林农业大学是几本	沈阳农大是几本
合肥堵车严重吗	昆明堵车严重吗
十三乘十三	十三乘十四
佳木斯到淮安多少公里	天津到淮安多少公里
章丘到淄博多少公里	广州到淄博多少公里
五十岁可以打四价吗	五十岁可以打九价吗
海南二级建造师什么时候报名	陕西二级建造师什么时候报名
红米六有红外线吗	红米三有红外线吗
江苏是哪个地区	青海是哪个地区
健康码怎么弄厦门	健康码怎么弄天津
五的二千次方等多少	五的四次方等多少
十九年十月日期	十九年九月日期
江苏移车电话	河南移车电话
湖北有哪些古建筑	北京有哪些古建筑
奔驰glc四十三售价	奔驰gle四十三售价
一加五尺寸	一加三尺寸
运动总是漏尿	运动过度漏尿
十四岁女孩体重标准是多少正常	十五岁女孩体重标准是多少正常
二十三周前置胎盘怎么矫正	二十八周前置胎盘怎么矫正
七十七除四等多少	六除四等多少
三元减一元六角	三元减一元五角
斯里兰卡的货币	罗马的货币
十七加十九	十七加十三
十角飞镖怎么折视频	六角飞镖怎么折视频
徐州到湛江的火车票	徐州到菏泽的火车票
陕西师大收费标准	华南师大收费标准
中关村中学邮编	章丘中学邮编
柳州身份证自助办理点	珠海身份证自助办理点
北理工的邮编	长沙理工大学的邮编
贵阳到十里画廊有多少公里	贵阳到北京有多少公里
中大查重率	复旦查重率
福建到台湾有多少公里	北京到台湾有多少公里
广东科学技术职业学院偏僻吗	广东南方职业学院偏僻吗
南华大学何时开学	南京大学何时开学
邢台是哪个省的	蚌埠是哪个省的
安徽理工大学土木工程专业全国排名	河南理工大学土木工程专业全国排名
河南理工大学和山东理工大学哪个好	河南理工大学和长沙理工大学哪个好
一到一百英文怎么读	一到六英文怎么读
巴基斯坦属于哪个州	智利属于哪个州
月薪三千以上的工作	月薪七千以上的工作
五分钟的演讲要多少字	六分钟的演讲要多少字
莫斯科到上海距离	厦门到上海距离
十九年六月三日大乐透开奖结果	二十年六月三日大乐透开奖结果
农历六月十三是阳历多少	农历六月十二是阳历多少
一千三百五十七代表什么意思	一千五百五十七代表什么意思
十九年广西企业一百强	十九年广东企业一百强
与中国时差十四小时的国家	与中国时差一点五小时的国家
八和十九的最大公因数和最小公倍数	八和十二的最大公因数和最小公倍数
浙江工业大学有专升本吗	浙江理工大学有专升本吗
广州看前列腺炎多少钱	哈尔滨看前列腺炎多少钱
去湖南要隔离吗	去山东要隔离吗
宿迁到深圳大巴车	宿迁到济南大巴车
二百零四乘四	二百零五乘四
关闭六点二十的闹钟	关闭四点二十的闹钟
浙商银行电话	浙商证券电话
哈尔滨的养老院	南京的养老院
科目二怎么预约	科目一怎么预约
郑州至乌鲁木齐高铁时刻表	银川至乌鲁木齐高铁时刻表
西南交大校长级别	交大校长级别
一分钟等多少小时	五分钟等多少小时
爱情数字一千六百四十四是什么意思	爱情数字五是什么意思
九十五年十月十七日阳历	九十六年十月十七日阳历
芜湖城市户口可以迁回农村吗	绍兴城市户口可以迁回农村吗
达州哪个区比较好	杭州哪个区比较好
一点六十八乘五	一点六十八乘十二
设置一个十一点半的闹钟	设置一个十二点半的闹钟
枣庄到无锡的高铁时刻表查询	枣庄到南京的高铁时刻表查询
信阳到常州的汽车票	上海到常州的汽车票
浙江最高温度多少	西藏最高温度多少
石家庄周边适合野餐的地方	西安周边适合野餐的地方
南京失业金可以一次性领取吗	重庆失业金可以一次性领取吗
tx是什么格式	pdfx是什么格式
今天成都气温是多少	今天哈尔滨气温是多少
湖州到南京高铁多少钱	长沙到南京高铁多少钱
一千三百三十六大写怎么写	一千三百二十六大写怎么写
十四年除夕为什么不放假	十五年除夕为什么不放假
四的最小公倍数怎么求	五的最小公倍数怎么求
七十七年农历四月十七	七十七年农历四月十五
四百五十九除三	四百五十九除四
三pack什么意思	六pack什么意思
金龟子又叫什么	金蝉子又叫什么
衡阳在哪里	中国在哪里
经常出虚汗是怎么回事	偶尔出虚汗是怎么回事
张家界门票价格二千零一十五	张家界门票价格二千零一十六
怎样投诉工行	怎样投诉招行
新疆医科大学代码	新疆师范大学代码
邵东到江西多少公里	邵东到成都多少公里
怀孕三个月可以做人流吗	怀孕六个月可以做人流吗
南京大学和南京工业大学哪个好	南京财经大学和南京工业大学哪个好
身体三高是指哪些	身体五高是指哪些
二十年合肥产假多少天	二十年广州产假多少天
加拿大哪个地方和中国时差十二小时	加拿大哪个地方和中国时差十三小时
二千零二十山西中考分数	二千零二十湖南中考分数
河北工程大学是二百一十一吗	河南工业大学是二百一十一吗
来完大姨妈第三天是安全期吗	来完大姨妈第四天是安全期吗
河北医科大学二千零一十九临床医学录取分数线	西南医科大学二千零一十九临床医学录取分数线
抗心磷脂抗体小于十二	抗心磷脂抗体小于三
延吉到唐山多少公里	延吉到深圳多少公里
耐克倒闭	微软倒闭
太原防疫政策	曼谷防疫政策
鲍姓男孩取名	岳姓男孩取名
今天零下几度	明天零下几度
月经推迟七天了怎么办	月经推迟六天了怎么办
武汉理工转专业	沈阳理工大学转专业
盘锦到青岛火车时刻表	盘锦到桂林火车时刻表
湖州师范学院二千零一十九分数线	盐城师范学院二千零一十九分数线
肚子总饿是怎么回事	肚子不饿是怎么回事
六百三十二除八竖式计算	六百三十四除八竖式计算
一百零五乘七	四乘七
台北在哪个省	重庆在哪个省
中国的七大古都是	中国的六大古都是
对公账户建行收费标准	对公账户农行收费标准
三十二周胎儿发育标准	三十四周胎儿发育标准
西安到三门峡多少公里	西安到天津多少公里
怀孕一个月可以药流吗	怀孕五个月可以药流吗
内蒙归哪管	广东归哪管
中通客车是哪里产的	中兴汽车是哪里产的
北大复试时间	上海交大复试时间
云大录取名单二千零一十九	南京大学录取名单二千零一十九
上海财大上海分数线	上海交大上海分数线
永远的君主十四集什么时候播	永远的君主十三集什么时候播
邹城到青州多少公里	南京到青州多少公里
苏州城市面积多少平方公里	香港城市面积多少平方公里
四千二百五十立方厘米等多少升	一立方厘米等多少升
四十五加十九等几	四十五加五等几
八月十日什么星座	八月一日什么星座
包头医学院面积	沈阳医学院面积
南昌今天温度多少	兰州今天温度多少
孕妇肚子微微疼	孕妇肚子很疼
广东高考题难吗	甘肃高考题难吗
描写灵谷寺的古诗词	描写中国的古诗词
六和十二的最大公因数最小公倍数	六和八的最大公因数最小公倍数
武汉工程大学是不是一本	西安工程大学是不是一本
长沙明天温度	天津明天温度
中国一线城市有哪些	中国六线城市有哪些
辽宁工业大学书记	河南工业大学书记
石柱县行政区划	麻阳县行政区划
安徽财经大学mpacc分数线	西安财经大学mpacc分数线
中石大北京保研条件	中国矿大北京保研条件
南理工分数线	太原理工分数线
威海到防城港多少公里	上海到防城港多少公里
云大的录取分数线	哈佛的录取分数线
检查贫血三项多少钱	检查贫血四项多少钱
金华到滁州多少公里	金华到绵阳多少公里
怀孕一个月可以打胎么	怀孕六个月可以打胎么
河南师范大学领导名单	河北师范大学领导名单
西南交大属于二百一十一还是九百八十五	西南大学属于二百一十一还是九百八十五
云南师范大学研究生在哪个校区	华南师大研究生在哪个校区
iphone七plus发烫	iphone八plus发烫
六十四年的一分硬币值多少钱	六十五年的一分硬币值多少钱
二千人民币换多少日元	一人民币换多少日元
防灾科技学院在哪	黄河科技学院在哪
十二岁来月经还能长多高	十一岁来月经还能长多高
陕西那里下雪了	宁夏那里下雪了
pench什么意思	pach什么意思
贵阳防疫中心电话	澳门防疫中心电话
一楼的房子好不好	五楼的房子好不好
三天月经就没了正常吗	四天月经就没了正常吗
武汉历史最高气温	南昌历史最高气温
西宁能打九价疫苗吗	哈尔滨能打九价疫苗吗
无锡到东台火车	无锡到合肥火车
衡阳至西安	衡阳至长春
天津到大连的船票	天津到青岛的船票
七个月宝宝一天吃几次辅食	十月宝宝一天吃几次辅食
茂名近代名人	茂名现代名人
宜家天津客服电话	宜家广州客服电话
南理工录取分数线	太原理工录取分数线
凉州词的意思五十字	凉州词的意思三十字
距离五点半还有多久	距离元旦还有多久
八月三日的生日是什么星座	八月一日的生日是什么星座
塞浦路斯的地理位置	罗马帝国的地理位置
七十五赫兹什么意思	一赫兹什么意思
教育部成员	财政部成员
人大哲学考研分数线	中央民大哲学考研分数线
虹桥中学招生办电话	玉桥中学招生办电话
南宁皮卡限行规定	成都皮卡限行规定
七的写法怎么写视频	五的写法怎么写视频
赤峰到义乌火车站时刻表	南京到义乌火车站时刻表
加装电梯对一楼的影响	加装电梯对二楼的影响
梅河口到南京	梅河口到长沙
中国人寿的股东是谁	华夏人寿的股东是谁
安徽扶贫项目有哪些	新疆扶贫项目有哪些
北京到九台火车时刻表查询	北京到福州火车时刻表查询
触宝人工客服电话多少	百度人工客服电话多少
今天荆州有什么新闻	今天北京有什么新闻
牟定一中校长	固原一中校长
化验甲功三项用空腹吗	化验甲功五项用空腹吗
西安理工大学怎么样就业前景	武汉理工怎么样就业前景
八十三年发生了什么事	一百九十九年发生了什么事
二千零一十九英雄联盟世界总决赛冠军	二千零一十七英雄联盟世界总决赛冠军
西华师大二千零二十复试线	西华大学二千零二十复试线
长春到东莞多远	长春到厦门多远
工行卡结息怎么查	农行卡结息怎么查
遵化的房价	西安的房价
喇叭河可以钓鱼吗	拉萨河可以钓鱼吗
七个月的宝宝咳嗽怎么办	九月的宝宝咳嗽怎么办
鹤壁到义乌高铁	哈尔滨到义乌高铁
宿迁到沭阳的大巴车	宿迁到天津的大巴车
宁波属于哪个省	安徽属于哪个省
和顺县的邮政编码	永顺县的邮政编码
浙江的专科大学	海南的专科大学
美国三大港口	美国四大港口
十九年宁夏总人口	十九年内蒙古总人口
苹果六换充电口多少钱	苹果八换充电口多少钱
苹果五什么时候上市	苹果八什么时候上市
十五万一千一百一十三的最小公倍数	八万一千一百一十三的最小公倍数
通化在哪个省	中国在哪个省
青岛到北京火车票查询时刻表	深圳到北京火车票查询时刻表
南宁到贵阳的动车时刻表	南宁到西安的动车时刻表
成都今天的天气怎么样	武汉今天的天气怎么样
七月三十日出生是什么星座	七月一日出生是什么星座
北京协和医院急救电话	武汉协和医院急救电话
亮度调为三十	亮度调为八十
太原到邯郸火车	重庆到邯郸火车
二百四十五除三估算	二百四十五除八估算
西北政法大学是不是九百八十五	西南政法大学是不是九百八十五
农行今天上班吗	农行周末上班吗
二十四除六的带分数	七除六的带分数
黄冈到长沙的火车	黄冈到北京的火车
绵阳哪里好玩	咸阳哪里好玩
十一点五十五的英文	十一点四十五的英文
江西中考填志愿是考前还是考后	江苏中考填志愿是考前还是考后
济南有几个殡仪馆	沈阳有几个殡仪馆
二十年中科大研究生录取名单	二十年中大研究生录取名单
国信证券是国企吗	国盛证券是国企吗
肌酸激酶三百八十	肌酸激酶八百八十
叶县属于哪个市	正阳属于哪个市
乌鲁木齐到盐城多少公里	杭州到盐城多少公里
南阳至新乡高铁时刻表	合肥至新乡高铁时刻表
巢湖学院二千零一十九录取分数线	武夷学院二千零一十九录取分数线
漳浦至仙游动车时刻表	厦门至仙游动车时刻表
二十五除一千化成小数是多少	二十五除三十七化成小数是多少
榆林到内蒙有多少公里	榆林到宁夏有多少公里
一加五重量	一加八重量
设置一个六点二十五的闹钟	设置一个四点二十五的闹钟
六十八年阳历三月十五阴历是几月初几	六十八年阳历五月十五阴历是几月初几
从一数到一百一共有多少个五	从一到一百一共有多少个五
三减减六	三减减三
临汾到侯马多远	临汾机场到侯马多远
河南专升本通过率多少	浙江专升本通过率多少
四什么万什么	四什么百什么
上海彩虹桥在哪里	衡阳彩虹桥在哪里
高压一百二十低压六十正常吗	高压一百三十低压六十正常吗
最近几天有点便秘怎么办	最近几天一直便秘怎么办
怀化到邵东高铁时刻表	怀化到杭州高铁时刻表
西平离平顶山多远	西平离郑州多远
济南出租车收费标准	拉萨出租车收费标准
蔡家坡到天水高铁时刻表	深圳到天水高铁时刻表
社旗县到南阳多少公里	天津到南阳多少公里
八和十四的最大公因数短除法	八和十一的最大公因数短除法
长春初三开学了吗	石家庄初三开学了吗
高压一百六十低压九十严重吗	高压一百四十低压九十严重吗
铭勋的意思	铭的意思
十三岁男孩标准身高	十二岁男孩标准身高
半年药流一次会怎么样	半年药流三次会怎么样
开机太慢	开机有点慢
二十八岁腰疼是什么原因引起的	二十九岁腰疼是什么原因引起的
上虞到义乌汽车时刻表	上饶到义乌汽车时刻表
八十七年五月十五日是什么星座	八十八年五月十五日是什么星座
七十年农历九月二十七是什么星座	七十年农历五月二十七是什么星座
一千九百九十四出生属什么	一千八百九十四出生属什么
湖南到郑州	长沙到郑州
黄石二手家具市场地址	重庆二手家具市场地址
玉门市是哪个省的	天门是哪个省的
a五十二解锁方式	a七解锁方式
潍坊到昌邑物流	潍坊到山东物流
云南民族大学属于几本	湖南民族大学属于几本
通辽到张家界的飞机票	成都到张家界的飞机票
胎盘下缘距宫颈内口大于三十mm正常吗	胎盘下缘距宫颈内口大于六十mm正常吗
甘肃各地区经济排名	陕西各地区经济排名
地藏菩萨保佑什么	虚空藏菩萨保佑什么
一月一日是什么星座	八月一日是什么星座
湖滨西路属于哪个区	团结西路属于哪个区
牛油果不太熟可以给宝宝吃吗	牛油果不熟可以给宝宝吃吗
重庆师范大学甘肃录取分数线	重庆工商大学甘肃录取分数线
床单六乘七是多大尺寸	床单五乘七是多大尺寸
长城的布局	长安的布局
盐城到滨州多少公里	盐城到大连多少公里
胎儿二十七周发育标准数值	胎儿二十八周发育标准数值
清华简称什么	百度简称什么
甘肃书记省长	福建书记省长
武汉理工转专业	太原理工转专业
成都到包头的火车票	南京到包头的火车票
二十年吉大研究生录取名单	二十年东北林大研究生录取名单
月经推迟七天了怎么办	月经推迟一天了怎么办
淮南到寿县坐几路公交车	淮南南站到寿县坐几路公交车
西安至九江火车时刻表查询	西安至天津火车时刻表查询
民政局属于事业单位	地震局属于事业单位
湖北美术学院就业前景	广州美术学院就业前景
一百二十五除三十等几	一百二十五除六等几
长沙哪里最好玩	郑州哪里最好玩
星海音乐学院好吗	沈阳音乐学院好吗
南京比较好的美容医院	北京比较好的美容医院
南宁到郑州火车票	南宁到南昌火车票
开封属于什么气候	德州属于什么气候
出生于南京的名人	出生于济南的名人
上海铁路局公积金比例	成都铁路局公积金比例
六和四十的最大公因数	八和四十的最大公因数
姨妈后第八天是安全期吗	姨妈后两天是安全期吗
九十五年五月十号是什么星座	九十六年五月十号是什么星座
辽宁海岸线最长的城市	江苏海岸线最长的城市
仪征到临沂多少公里	北京到临沂多少公里
郑州烧伤科最好的医院	石家庄烧伤科最好的医院
二千零二十哈工大复试分数线	二千零二十北工大复试分数线
五月份是什么星座的人	六月份是什么星座的人
蒙自到富宁有多少公里	蒙自到武汉有多少公里
四除十七等多少	四除八等多少
甲功三项是什么	甲功八项是什么
xrv本田价格	crv本田价格
晋是哪里	晋祠是哪里
社保局官网电话	安监局官网电话
南京属于哪里	南京南站属于哪里
唐山哪个医院皮肤科最好	襄阳哪个医院皮肤科最好
五月八号翻译	八月十五翻译
西涝台社区居委会电话	湖州华丰社区居委会电话
呼和浩特离大同多少公里	呼和浩特离哈尔滨多少公里
宜春哪个男科医院最好	深圳哪个男科医院最好
三乘八百等多少	三乘二十五等多少
八十八年是什么蛇	八十九年是什么蛇
餐后两小时血糖正常值	餐后六小时血糖正常值
成都买自行车的地方	昆明买自行车的地方
章丘到淄博多少公里	郑州到淄博多少公里
距离二千零二十一还有多少天	距离圣诞节还有多少天
肇庆有哪些县	中国有哪些县
中国十九年人均gdp	中国二十年人均gdp
七十五年的是什么星座	七十六年的是什么星座
河南离拉萨有多远	西藏离拉萨有多远
石家庄到芜湖	石家庄到天津
现任广东教育厅厅长	现任甘肃教育厅厅长
农历七月十七是什么星座	农历七月十六是什么星座
黄河科技学院多少分能上	郑州科技学院多少分能上
怀孕十天有什么症状	怀孕十五天有什么症状
视力零点八正常吗	视力一点八正常吗
十九年广东高考美术分数线	二十年广东高考美术分数线
历史上姓周的名人	历史上姓翁的名人
李泽什么好听	泽什么好听
宫缩五分钟一次开几指	宫缩两分钟一次开几指
反复发烧怎么回事	偶尔发烧怎么回事
玉林师范学院美术录取分数线	白城师范学院美术录取分数线
十二乘五等多少	十二乘十二等多少
三年几个月	一年几个月
枣庄到沧州高铁	青岛到沧州高铁
郑州到大理多少公里	郑州到石家庄多少公里
剖腹产第七天可以吃虾吗	剖腹产第四天可以吃虾吗
隆回一中中考录取分数线	隆昌一中中考录取分数线
凝血因子五缺乏	凝血因子二缺乏
石家庄经济学院是公办还是民办	湖南涉外经济学院是公办还是民办
十九年三月三十一是星期几	十九年三月十是星期几
合肥十大律师事务所	郑州十大律师事务所
云南离黑龙江有多远	云南离江苏有多远
心率五十正常吗	心率七十正常吗
鹤壁职业技术学院校训	运城职业技术学院校训
北京同仁医院领导名单	北京同仁堂领导名单
二十年五月二十日寓意	二十一年五月二十日寓意
六百除二十	六百除五
三月二十七日是什么星座	三月八日是什么星座
八十五除六	八十五除十七
成都东站到双流地铁路线	成都东站到双流机场地铁路线
做完人流第六天可以洗澡洗头吗	做完人流第二天可以洗澡洗头吗
湖南城市学院改名	湖南文理学院改名
洛阳换锁芯正规公司电话	天津换锁芯正规公司电话
通江到成都有多少公里	长沙到成都有多少公里
德州有哪些小区	北京有哪些小区
五大经济学派	四大经济学派
iphone七plus换屏幕	iphone八plus换屏幕
安徽称什么	广西称什么
上海海洋大学硕士点	上海交大硕士点
祁阳有哪些中学	重庆有哪些中学
现在买哪个股票好	下个月买哪个股票好
跑得什么填三个字	跑得什么填五个字
四川行政编码	江西行政编码
七十除五	七十除十
二十四除三	二十四除九
山东理工大学与山东科技大学哪个好	山东理工大学与青岛科技大学哪个好
二十人民币等多少马币	五人民币等多少马币
一公里多少分钟	八公里多少分钟
十七除三等多少	四除三等多少
四十二除二	四十二除五
东风三十一速度多少马赫	东风四十一速度多少马赫
莆田到郑州快递要多久	莆田到广州快递要多久
人教版七年级下册英语四单元短语	人教版七年级下册英语二单元短语
驾照考试科目三怎么考	驾照考试科目一怎么考
农历三月二十七是几月几日	农历三月二十九是几月几日
辽宁师范大学历任校长	陕西师大历任校长
亚洲怎么样	亚洲城怎么样
龙岩到淄博多少公里	龙岩到宁波多少公里
头一直晕晕的怎么回事	头有点晕晕的怎么回事
姓赖的取什么名字好听	姓杨的取什么名字好听
十月一日是什么星座	八月一日是什么星座
狂犬疫苗多少钱一针	狂犬疫苗多少钱五针
西安文理学院好不好	西安美术学院好不好
一ft等多少cm	四ft等多少cm
杭州离贵州远吗	杭州离河南远吗
七十二乘一千	七十二乘一百二十
九百七十八前后关系	九百九十八前后关系
东北师大考研复试分数线	北师考研复试分数线
西藏海拔最高的乡镇	湖南海拔最高的乡镇
现任广东教育厅厅长	现任福建教育厅厅长
重庆工商大学会计考研难度	北京工商大学会计考研难度
三月二十六日什么星座	三月九日什么星座
湖北健康码可以去四川吗	湖北健康码可以去安徽吗
西江大学好吗	鸡西大学好吗
长沙落后吗	拉萨落后吗
设置明天早上六点十分的闹钟	设置明天早上六点的闹钟
十五除七化成小数	十一除七化成小数
泉州到长沙火车站时刻表	南昌到长沙火车站时刻表
一千九百一十六年多少岁	一千九百一十七年多少岁
一百六十除四十八等多少	七除四十八等多少
诺贝尔瓷砖怎么样	顺辉瓷砖怎么样
石家庄高铁站是南站还是北站	福州高铁站是南站还是北站
蓟州到北京多少公里	蓟州到天津多少公里
兰州一汽服务站电话	石家庄一汽服务站电话
工行利润	建行利润
四月二十日是什么星座	四月四日是什么星座
最喜欢的好莱坞电影	最喜欢的日本电影
人大附中初中难考么	人大附中分校初中难考么
华东师大各专业录取分数线	华中师大各专业录取分数线
嘉兴到福州多少公里	重庆到福州多少公里
南京爱彼维修网点	成都爱彼维修网点
黄山到宁夏多少公里	黄山到四川多少公里
西南交大二千零二十研究生分数线	西安交大二千零二十研究生分数线
六十岁用什么化妆品牌	五十岁用什么化妆品牌
汉中平均工资二千零一十九	武汉平均工资二千零一十九
大时代续文够了没有第三章	大时代续文够了没有第一章
上海体育学院是几本	广州体育学院是几本
黄州到唐山火车票	黄州到厦门火车票
去珠海坐什么车方便	去重庆坐什么车方便
七十二年十二月两日出生是什么命	七十三年十二月两日出生是什么命
徐工集团董事长	震旦集团董事长
南京最有钱的区	贵阳最有钱的区
怀孕六十三天胎儿有多大	怀孕四十五天胎儿有多大
广州比较好的蛋糕店	石家庄比较好的蛋糕店
浙江卫视台长是谁	江苏卫视台长是谁
无锡打车到江阴多少钱	无锡打车到南通多少钱
十九年底上映的电影	十五年底上映的电影
吉安德邦物流电话	武安市德邦物流电话
八月十四日什么星座	八月十五什么星座
十二加五等多少	十二加十二等多少
解放军总医院放射科主任	空军总医院放射科主任
二十年八月份出生的鼠宝宝起名	二十年五月份出生的鼠宝宝起名
四川时令蔬菜	山东时令蔬菜
福建师范大学研究生学费	天津师范大学研究生学费
成都办理健康证需要多少钱	南京办理健康证需要多少钱
双流中学学费多少	合川中学学费多少
杭州哪里好玩	贵阳哪里好玩
八十三年猪二十年运程	八十三年猪二十一年运程
池州学院二千零一十九对口高考录取分数线	宿州学院二千零一十九对口高考录取分数线
嵩山到北京多少公里	深圳到北京多少公里
前天是农历几月几日	昨天是农历几月几日
七十五年七月二十七日晚上十一点多出生的人是什么命	七十六年七月二十七日晚上十一点多出生的人是什么命
红岩第四章好句赏析	红岩第七章好句赏析
甲状腺功能三项是查什么	甲状腺功能八项是查什么
六的立方	三的立方
两和九十的最小公倍数	两和一百的最小公倍数
晨鸣纸业股价	博汇纸业股价
发烧四十二度严重吗	发烧四十一度严重吗
三的成语有哪些	六的成语有哪些
陕西异地办理身份证需要什么材料	河南异地办理身份证需要什么材料
厦门离合肥多远	南昌离合肥多远
八达岭长城有多少公里长	北京长城有多少公里长
宝鸡文理学院属于几本	湖南文理学院属于几本
八月十四日什么星座	八月一日什么星座
邵阳到四川多少公里	邵阳到贵州多少公里
中午吃什么	端午吃什么
小米八换手机后盖多少钱	小米九换手机后盖多少钱
周杰伦在南京开过几次演唱会	周杰伦在郑州开过几次演唱会
三星是华为吗	华为是华为吗
合肥夜总会有哪些	长沙夜总会有哪些
一万零二百八十大写怎么写	一万零一百八十大写怎么写
零点十三换算成分数	一点十三换算成分数
七十九年gdp增长率	八十年gdp增长率
章子怡是那里人	顾顺章是那里人
本田crv二千零一十五款报价	本田xrv二千零一十五款报价
六个月宝宝拉肚子怎么办	两月宝宝拉肚子怎么办
计算机四级证书有用吗	计算机二级证书有用吗
工行身份证过期了怎么办	农行身份证过期了怎么办
0八年的日历	二百零九年的日历
肯尼亚经济发达吗	阿拉伯经济发达吗
删除两点半的闹钟	删除四点半的闹钟
gopro七最大支持内存卡	gopro六最大支持内存卡
界首到洛阳高铁时刻表	界首到上海高铁时刻表
凯立德导航怎样升级	凯德导航怎样升级
山东艺术文化课分数线	甘肃艺术文化课分数线
南京经济支柱产业	西安经济支柱产业
怎么用手机看湖南卫视直播	怎么用手机看山东卫视直播
南宁到祁阳火车时刻表	南宁到武汉火车时刻表
二十五和十九的最小公倍数	二十五和三的最小公倍数
珠海居住证要多久才能办下来	广东居住证要多久才能办下来
导航到南京	导航到太原
冰岛有哪些寨子	中国有哪些寨子
铜陵有哪些镇	乐陵市有哪些镇
楚天科技的股价	百度的股价
定个早上六点十分的闹钟	定个早上六点的闹钟
张家口有什么特色小吃	齐齐哈尔有什么特色小吃
最有意义的四个字	最有意义的三个字
怀化到烟台的火车票	怀化到深圳的火车票
顺产后第一次月经量大	顺产后第三次月经量大
乌鲁木齐到扬州飞机票	西宁到扬州飞机票
武汉理工就业好的专业	昆明理工大学就业好的专业
消防法第八条规定	消防法第九条规定
打电话给刘总	打电话给老刘
加二百五十二是哪个国家的区号	加二百四十二是哪个国家的区号
淘宝怎么设置四十八小时发货	淘宝怎么设置二十四小时发货
呼和浩特机场电话	盐城机场电话
一百以内的加法和减法	五以内的加法和减法
潍坊到淄博的动车	潍坊到苏州的动车
南京距离徐州有多远	南京距离青岛有多远
贵阳到安顺的火车时刻表	贵阳到南京的火车时刻表
伦敦以什么出名	罗马以什么出名
四十七天没有胎心胎芽正常吗	四十五天没有胎心胎芽正常吗
四川交通事故十级伤残赔偿标准	河南交通事故十级伤残赔偿标准
漯河职业技术学院怎么样	运城职业技术学院怎么样
天津怎么交社保	成都怎么交社保
西悉尼大学地址	西澳大学地址
南方医院怎么样	西南医院怎么样
一千加五千	五千加五千
hari什么意思	biri什么意思
成都大学在哪	成都中医药大学在哪
郑州怎么找兼职	昆明怎么找兼职
怀孕第五天能测出来吗	怀孕三天能测出来吗
九月一是什么日子	九月六是什么日子
现在法国到中国机票多少钱	现在日本到中国机票多少钱
济南出租车收费标准	南宁出租车收费标准
九百六十除七等多少	一除七等多少
肇东市总人口是多少	美国总人口是多少
头经常眩晕是怎么回事	头偶尔眩晕是怎么回事
上海到广东物流价格上海迅必物流官网地址	上海到安徽物流价格上海迅必物流官网地址
与中国时差十四小时的国家	与中国时差十六小时的国家
九百五十六除四的竖式	九百五十六除九的竖式
珠海到坦洲的大巴	珠海到深圳的大巴
双色球十六加二多少钱	双色球一加二多少钱
五月天和信乐团哪个乐队更有实力	五月天和信练团哪个乐队更有实力
猪肚洗太干净会苦吗	猪肚洗不干净会苦吗
十二和四十用短除法	十二和三用短除法
五十四天宝宝吐奶	四十二天宝宝吐奶
美国总统是谁	美国总统现在是谁
滴滴app无法使用	滴滴无法使用
今年距离春节还有多少天	距离春节还有多少天
我可以睡觉吗	我现在可以睡觉吗
帮我设置明天八点半的闹钟	帮我设置明天早上八点半的闹钟
现在几点了几点了	现在几点了现在几点了
什么节日	今天什么节日
关音乐关音乐	关音乐
你认识小薇吗	你认识小薇小薇吗
今天农历几号了	农历几号了
你在哪个国家	你现在在哪个国家
今天天气怎样今天天气怎样	天气怎样今天天气怎样
今天天气怎么样今天天气怎么样	今天天气怎么样天气怎么样
设置明天七点五十的闹钟	设置明天早上七点五十的闹钟
你现在能飞吗	你能飞吗
oppo最新款是什么型号	oppo现在最新款是什么型号
今天上海有雨吗	上海有雨吗
什么游戏	现在什么游戏
哈尔滨多少度	哈尔滨现在多少度
最近有没有好玩的游戏	有没有好玩的游戏
更新了不好用	现在更新了不好用
你到底怎么了	你现在到底怎么了
今天农历多少日	农历多少日
晚上适合吃什么饭	今天晚上适合吃什么饭
不今天天气怎么样	不小布今天天气怎么样
脂肪肝严重	脂肪肝严重不
现在疫情怎么样了	疫情怎么样了
六月那天日子好	今年六月那天日子好
早上吃的什么	吃的什么
农历是多少	现在农历是多少
下雨了没有	今天下雨了没有
最近有没有人找我	有没有人找我
上海今天有雨吗	上海有雨吗
怎么进去	现在怎么进去
你想谈恋爱吗	你现在想谈恋爱吗
银行也放假吗	银行今天也放假吗
不几点了	不现在几点了
吃饭了吗	现在吃饭了吗
本机可以语音唤醒吗	本机可以语音唤醒小布吗
后天下不下雨	后天下不下雨后天
不帮我打开手电筒	帮我打开手电筒
孕妇可以吃芒果不	孕妇可以吃芒果
为什么我的手机充电这么慢	为什么我的手机现在充电这么慢
中午多少度	今天中午多少度
什么手机最好	现在什么手机最好
好看的电影	最近好看的电影
设置明天七点四十的闹钟	设置明天早上七点四十的闹钟
有人打我没有	目前有人打我没有
今天外面有风吗	外面有风吗
洛阳高速收费不	洛阳高速收费
你家到底几口人	你家现在到底几口人
张杰今年多少岁了	张杰多少岁了
中午吃什么呀	今天中午吃什么呀
今天美元和人民币的汇率	美元和人民币的汇率
北京时间几点了	北京时间现在几点了
oppowatch不能回复微信了	oppowatch现在不能回复微信了
小布几点钟了	小布现在几点钟了
姨妈期间可以染发不	姨妈期间可以染发
oppo最新款手机是什么	现在oppo最新款手机是什么
我没有用耳机	我现在没有用耳机
设置明天十点的闹钟	设置明天早上十点的闹钟
几点了现在几点了	现在几点了现在几点了
今天美元的汇率	美元的汇率
孕妇可以吃兔子肉不	孕妇可以吃兔子肉
附近最近的餐厅	附近的餐厅
现在还有几度电	还有几度电
高速公路收费吗	高速公路今天收费吗
我问你几点了	我问你现在几点了
请问几点	请问现在几点
现在能否设置充电提示音	能否设置充电提示音
什么血糖仪最好	什么血糖仪比较好
怎么设置画笔	怎么设定画笔
三国演义最有名的片段	三国演义最著名的片段
怎样检查电脑硬件	怎样检测电脑硬件
近义词怎么讲	同义词怎么讲
退出开车模式	退出车载模式
江阴市有啥好玩的地方	江阴有啥好玩的地方
你和小v谁厉害	你和小薇谁厉害
你喜欢旅游吗	你喜欢旅行吗
祝贺考试顺利的成语	祝福考试顺利的成语
为什么男人特别喜欢穿背心	为什么男人都喜欢穿背心
我奶奶漂亮吗	我奶奶美丽吗
为什么嘴巴总起泡	为什么嘴巴总是起泡
香菇怎么做菜	香菇怎么炒菜
捷径近义词	捷径同义词
温江有多少乡镇	温江区有多少乡镇
遵义医学院好吗	遵义医科大学好吗
黑芝麻核桃粉什么时候喝比较好	黑芝麻核桃粉什么时候喝最好
广州比较出名的茶楼	广州最出名的茶楼
火龙果和黄瓜能一起吃吗	火龙果和黄瓜能同时吃吗
天快黑了的	天都黑了的
怀孕两个多月肚子隐隐作痛	怀孕两个半月肚子隐隐作痛
形容宝宝淘气的歌曲	形容宝宝调皮的歌曲
手机铃声比较大	手机铃声太大
什么样的睡觉	什么样的睡眠
有房贷的房子可以赠予吗	有房贷的房子可以赠送吗
你不上学吗	你不用上学吗
ps是提示的意思吗	ps是提醒的意思吗
第一次大概多长时间	第一次大约多长时间
现在有什么好玩的游戏	目前有什么好玩的游戏
汕尾是属于潮汕吗	汕尾是属于潮汕地区吗
描写孔雀美丽的句子	描写孔雀优美的句子
angelababy综艺节目	杨颖综艺节目
生菜如何保存	生菜如何储藏
九龙山墓园地址	九龙山陵园地址
大面积近义词	大面积同义词
狮子座明天运势	狮子座明日运势
干海马怎么存放	干海马怎么保存
疫情十一月份还会来吗	疫情十一月还会来吗
望结尾的成语	看结尾的成语
几点睡觉算熬夜	几点睡眠算熬夜
刘禹锡最有名的一句诗句	刘禹锡最著名的一句诗句
月经迟迟不来怎么办	月经一直不来怎么办
孕妇为什么特别小气	孕妇为什么很小气
祝福长辈生日的诗句	祝贺长辈生日的诗句
dnf为什么老掉线	dnf为什么老是掉线
嬴政的儿子分别叫什么	嬴政的儿子都叫什么
银耳能和地瓜一起吃吗	银耳能和地瓜在一起吃吗
嘴里特别臭是怎么回事	嘴里很臭是怎么回事
用什么相机拍照清晰	用什么相机拍照清楚
流产后流血特别少正常吗	流产后流血很少正常吗
暮色的同义词	暮色的近义词
快走可以减肥吗	快走可以减脂吗
师傅的女师傅喊什么	师傅的女师傅叫什么
华为员工数	华为集团员工数
贝瑞基因地址	贝瑞基因公司地址
两个月没来月经是怎么回事	两月没来月经是怎么回事
小孩不愿意学习怎么办	小孩不愿意读书怎么办
认祖归宗同义词	认祖归宗近义词
轻微酒精过敏怎么办	有点酒精过敏怎么办
什么动物最勤劳	什么动物很勤劳
息屏时间调至三十分钟	息屏时间调至半小时
广东农工商职业技术学院什么时候开学	广东农工商职业技术学校什么时候开学
做梦经常梦到同一个人	做梦时常梦到同一个人
月经刚结束会排卵吗	月经才结束会排卵吗
鼓励孩子学习经典语句	鼓励孩子读书经典语句
经常喝牛奶有什么坏处	常常喝牛奶有什么坏处
有哪些有名的医生	有哪些著名的医生
男人身高多少最好	男人身高多少比较好
小孩子很胖	小孩子太胖
检测网络摄像头的软件	检查网络摄像头的软件
咳嗽很厉害怎么办	咳嗽太厉害怎么办
三十分钟后提醒我吃药	半个小时后提醒我吃药
笑容的形容词	笑脸的形容词
从此的此怎么组此	由此的此怎么组此
james身高	詹姆身高
眼睛一直肿	眼睛都肿
长相特别清纯的女生	长相很清纯的女生
我为什么这么暴躁	我为什么这么急躁
新冠肺炎多久能检查出来	新冠肺炎多久能检测出来
怎样投球最准	怎样投球才准
中国平安成立于哪一年	平安保险成立于哪一年
头孢和阿奇霉素能一起吃吗	头孢和阿奇霉素能同时吃吗
任丘有多大	任丘市有多大
电脑图标太小	电脑图标很小
吴奇隆马雅舒有孩子吗	吴奇隆马舒雅有孩子吗
南京有名的巷子	南京著名的巷子
江城属于哪个市	江城县属于哪个市
三个月宝宝老吃衣服	三个月宝宝老是吃衣服
怎么检查电池寿命	怎么检测电池寿命
日本著名主持人	日本有名主持人
灵芝孢子粉和三七粉能一起吃吗	灵芝孢子粉和三七粉能同时吃吗
广州怎么去阿尔山	广州怎么去阿尔山市
怎么训练宝宝抬头	怎么练习宝宝抬头
设置闹钟八点	设置闹钟八点钟
十一个月女宝身高体重	十一月女宝身高体重
衡阳火车站到衡东	衡阳火车站到衡东县
长宁游泳馆开放时间	长宁区游泳馆开放时间
叫的成语有哪些	喊的成语有哪些
如何进一步发挥党员作用	如何更好地发挥党员作用
小新pro十三怎么检测屏幕坏点	小新pro十三怎么检查屏幕坏点
形容声音开心的成语	形容声音高兴的成语
经期前疲劳	经期前疲惫
诗经著名的诗篇	诗经有名的诗篇
送数学老师什么礼物比较好	送数学老师什么礼物最好
月经迟迟不来的原因	月经总是不来的原因
有点肠胃炎	轻微肠胃炎
拼多多怎么买最省钱	拼多多怎么买更省钱
心跳很快怎么回事	心跳特别快怎么回事
苹果时间校准	ios时间校准
深圳最近天气怎么样	深圳今日天气怎么样
打瘦腿针大概多少钱	打瘦腿针大约多少钱
中国五十六个民族分别是哪些	中国五十六个民族都是哪些
正月十五的习俗急啊	一月十五的习俗急啊
月经经常推迟不来什么原因	月经常常推迟不来什么原因
社区居委会的功能	居民委员会的功能
舒服反义词语	舒适反义词语
描写夜幕的诗词	描写晚上的诗词
孕早期为什么饿的特别快	孕早期为什么饿的很快
湿热体质吃什么药最好	湿热体质吃什么药比较好
大同的同义词	大同的近义词
可以设置人物形象的游戏	可以设定人物形象的游戏
梦见和熟人一起睡觉	梦见和熟人在一起睡觉
怎么检查车上的gps	怎么检测车上的gps
十个月宝宝发烧怎么办	十一月宝宝发烧怎么办
怎么洗澡更干净	怎么洗澡最干净
猫咪为什么老叫	猫咪为什么一直叫
什么动物最聪明	什么动物很聪明
缺钙非常严重怎么办	缺钙太严重怎么办
多高兴啊补充句子	多开心啊补充句子
南昌信访局地址	南昌县信访局地址
设置语音提示	设置语音提醒
国美历史股价表	国美电器历史股价表
你不用睡觉吗	你不睡觉吗
怎么让大姨妈快点结束	怎么让大姨妈马上结束
看月思乡的诗句	望月思乡的诗句
天蝎座是几月	天蝎座是几月份
最近两个月月经量特别少	最近两个月月经量很少
合肥区gdp	合肥gdp
手机最低音量还是太大	手机最低音量还是很大
总头疼是因为什么	老是头疼是因为什么
七个多月能做引产吗	七个半月能做引产吗
入店转化率低	进店转化率低
儿子太淘气怎么办	儿子太调皮怎么办
修为的近义词	修为的同义词
设置一个下午两点的闹钟	设置一个下午两点钟的闹钟
骨质疏松太严重怎么办	骨质疏松很严重怎么办
重庆有哪些市	重庆省有哪些市
息屏时间调至三十分钟	息屏时间调至半个小时
拍照怎么发朋友圈	照相怎么发朋友圈
你今天好不好	你现在好不好
猪肝怎样做才好吃	猪肝怎样做更好吃
重庆皮肤科哪个医院比较好	重庆皮肤科哪个医院最好
京东售后太慢	京东售后很慢
最近发生了什么事	今天发生了什么事
苦瓜怎么做降火	苦瓜怎么做败火
什么东西人们都不喜欢吃	什么东西人们最不喜欢吃
青海旅行必备物品清单	青海旅游必备物品清单
脑梗塞吃什么药最好	脑梗塞吃什么药更好
促使近义词	促使同义词
糯米糍如何存放	糯米糍如何保存
吃苦瓜减肥吗	吃苦瓜减脂吗
男孩特别依赖妈妈怎么办	男孩太依赖妈妈怎么办
七月能摘口罩吗	七月份能摘口罩吗
拍照功能	照相功能
宽带用什么最好	宽带用什么比较好
做梦经常梦到同一个人	做梦常常梦到同一个人
男生每个月都有几天心情不好	男生每个月也有几天心情不好
怎样让女朋友兴奋	怎样让女朋友高兴
什么锅具最好	什么锅具比较好
巨蟹座是几月	巨蟹座是几月份
为什么打游戏总是四百六十	为什么打游戏经常四百六十
脸上很油怎么办	脸上太油怎么办
中信证券业绩	中信业绩
江阴距离上海有多远	江阴市距离上海有多远
脸上长了一个特别大的包	脸上长了一个很大的包
nike怎么验证真伪	耐克怎么验证真伪
陕师大属于九百八十五还是二百一十一	陕西师大属于九百八十五还是二百一十一
经常吃避孕药有什么危害	常常吃避孕药有什么危害
检查皮肤的app	检测皮肤的app
比较长的笑话	很长的笑话
肚子总饿是怎么回事	肚子很饿是怎么回事
凤凰卫视天气预报主持人王艺	凤凰台天气预报主持人王艺
直播屋里特别暗怎么办	直播屋里太暗怎么办
茶陵是哪个市	茶陵县是哪个市
最近总失眠怎么办	最近很失眠怎么办
什么地方最好玩	什么地方才好玩
什么星座比较挑剔	什么星座最挑剔
九峰山免费吗	九峰山景区免费吗
进户门摆放什么植物好	入户门摆放什么植物好
著名的现代诗诗人	有名的现代诗诗人
减脂早上喝什么牛奶	减肥早上喝什么牛奶
小孩子脚特别臭怎么办	小孩子脚很臭怎么办
女朋友特别挑食怎么办	女朋友很挑食怎么办
集美有什么好玩的	集美村有什么好玩的
谁也无法预测下一秒会发生什么	谁都无法预测下一秒会发生什么
玉露用什么土种比较好	玉露用什么土种最好
今天室外温度	当前室外温度
海南看什么	海南岛看什么
经常胃疼怎么办	常常胃疼怎么办
巨蟹座明天运势	巨蟹座明日运势
淮安到如皋多远	淮安区到如皋多远
尺度比较大的游戏	尺度最大的游戏
鲁迅的老婆叫什么	鲁迅先生的老婆叫什么
东岳是哪个朝代	东岳国是哪个朝代
奇妙的近义词奇特	奇妙的近义词奇异
房屋赠送要交多少税	房屋赠予要交多少税
金针菇怎样再生长	金针菇怎样再次生长
昆山二手市场在哪	昆山市二手市场在哪
什么水果含叶酸最高	什么水果含叶酸比较高
淮安在哪里	淮安区在哪里
怎么洗澡更干净	怎么洗澡才干净
春季的景物描	春天的景物描
鸡蛋怎样吃最有营养	鸡蛋怎样吃才有营养
剥好的大蒜怎么保存	剥好的大蒜怎么储藏
你的名字好好听	你的名字非常好听
六个多月能吃猕猴桃吗	六个半月能吃猕猴桃吗
设定闹钟六点	设置闹钟六点
你会一直对我好吗	你会永远对我好吗
八月一号是不是建军节	八月一日是不是建军节
成都到八宿多少公里	成都到八宿县多少公里
功用的近义词	功用的同义词
轻微烫伤怎么办	有点烫伤怎么办
津南区双港邮编	津南区双港镇邮编
哪个网贷额度最高	哪个网贷额度比较高
三七粉什么时候吃最好	三七粉什么时候吃更好
什么奇异的植物	什么奇特的植物
谁建造了长城	谁建造了万里长城
苹果设置没有了怎么办	iphone设置没有了怎么办
瓦房店有三甲医院吗	瓦房店市有三甲医院吗
为什么嘴巴总起泡	为什么嘴巴老是起泡
炒菜都放什么调料	做菜都放什么调料
珠海唐家湾属于什么区	珠海唐家湾镇属于什么区
形容风景美丽的成语	形容风景漂亮的成语
收废品怎么喊	收废品怎么叫
什么车型开着比较舒服	什么车型开着最舒服
九个月宝宝拉肚子怎么办	九月宝宝拉肚子怎么办
朝阳南磨房书记	朝阳南磨房乡书记
形容人比较酷的句子	形容人很酷的句子
宣化城上城售楼处电话	宣化城上城售楼部电话
怎么变得更瘦	怎么变得很瘦
胎儿羊水偏少怎么办	胎儿羊水太少怎么办
雁门关景区在哪里	雁门关在哪里
福田区停车场收费标准	福田停车场收费标准
昆明去泸西	昆明去泸西县
耐克的标怎么画	nike的标怎么画
长沙有名的律师	长沙县有名的律师
核酸检查能不能吃饭	核酸检测能不能吃饭
惠安有动车站吗	惠安县有动车站吗
哈姆莱特在丹麦宫廷的感受	哈姆雷特在丹麦宫廷的感受
宣布谈恋爱的	公布谈恋爱的
河南博物院开馆了吗	河南博物馆开馆了吗
尿路感染老复发	尿路感染老是复发
今天忙不忙	最近忙不忙
井水不犯河水同义词	井水不犯河水近义词
内蒙古很长的地名	内蒙古最长的地名
现在该干嘛	目前该干嘛
杭州妇科医院哪家比较好	杭州妇科医院哪家最好
鸡蛋怎么存放在冰箱	鸡蛋怎么保存在冰箱
豺狼虎豹同义词	豺狼虎豹近义词
学习有好处	读书有好处
增城公租房申请条件	增城区公租房申请条件
曲沃邮政编码	曲沃县邮政编码
如何保存干蒜	如何存放干蒜
酒吧销售发的	酒吧营销发的
南山有多少人口	南山镇有多少人口
万力轮胎和佳通哪个好	万力轮胎和佳通轮胎哪个好
如何证明自来水中有细菌	如何证实自来水中有细菌
苹果如何调亮度	iphone如何调亮度
学习安排计划	读书安排计划
哪一个快递最便宜	哪一个快递更便宜
白菜怎么做才好吃	白菜怎么做更好吃
降血压的药一般什么时候吃最好	降血压的药一般什么时候吃比较好
设置两点的闹铃	设置两点钟的闹铃
同学们说得很高兴扩句	同学们说得很开心扩句
两个多月宝宝睡觉摇头怎么回事	两个半月宝宝睡觉摇头怎么回事
为什么受伤的总是我	为什么受伤的老是我
怎么烧螃蟹才好吃	怎么烧螃蟹最好吃
关闭明天早上六点的闹钟	关闭明天早上六点钟的闹钟
长三角的气候特征	长三角地区的气候特征
菲律宾最有名的景点	菲律宾最著名的景点
长沙有名的律师	长沙著名的律师
女生说你还小怎么回复	女生说你太小怎么回复
可以用很热的水泡脚吗	可以用太热的水泡脚吗
清冷孤傲的近义词	清冷孤傲的同义词
tiffany项链真假	蒂芙尼项链真假
台湾有哪些名胜古迹	台湾岛有哪些名胜古迹
苹果无法发现此人	iphone无法发现此人
九月九日忆山东兄弟是哪个节日的	九月九忆山东兄弟是哪个节日的
梦见蛇入裤腿	梦见蛇进裤腿
新华国税电话	新华国税局电话
碧桂园集团法人代表	碧桂园法人代表
上海信访局地址	上海信访办地址
我的手机快没电了	我的手机马上没电了
延吉到内蒙古	延吉到内蒙
腿上汗毛太长怎么办	腿上汗毛很长怎么办
什么果汁可以减肥	什么果汁可以减脂
额头较短适合什么刘海	额头太短适合什么刘海
平安老板是哪里人	平安集团老板是哪里人
沈阳专业不孕不育医院选择	沈阳正规不孕不育医院选择
青岛有哪些有名的建筑	青岛有哪些著名的建筑
交强险大概多少钱一年	交强险大约多少钱一年
华峰氨纶股价	华峰集团股价
西游记里面最有名的三个故事	西游记里面最著名的三个故事
小孩睡觉老哭	小孩睡觉老是哭
宝洁公司待遇	宝洁待遇
最近比较潮的歌	最近最潮的歌
怀孕会老想尿尿吗	怀孕会老是想尿尿吗
形容人非常感动的成语	形容人很感动的成语
子宫偏大怎么办	子宫太大怎么办
陆丰碣石面积	陆丰碣石镇面积
湿气较重有什么表现	湿气很重有什么表现
月经迟迟不来怎么办	月经总是不来怎么办
苹果独特功能	iphone独特功能
减肥晚上可以吃鸡蛋吗	减脂晚上可以吃鸡蛋吗
民政局星期六上班吗	县民政局星期六上班吗
武汉有什么特殊的地方	武汉有什么特别的地方
怎么检查低血糖	怎么检测低血糖
世界上到底有多少种语言	世界上一共有多少种语言
北京西站到顺义地铁	北京西站到顺义区地铁
上海哪个医院眼科比较好	上海哪个医院眼科最好
开心的心字	高兴的心字
人的最佳睡眠方向	人的最佳睡觉方向
板栗怎么做才好吃	板栗怎么做最好吃
虾不能和什么一起吃	虾不能和什么同时吃
形容非常疼的比喻句	形容很疼的比喻句
昆明白颠如何治疗信任复美m	昆明白颠如何治疗信赖复美m
设置一个明天早上六点的闹钟	设置一个明天早上六点钟的闹钟
梦见自己老流鼻涕	梦见自己老是流鼻涕
两个多月宝宝拉奶瓣	两个半月宝宝拉奶瓣
三灶有什么好玩的	三灶镇有什么好玩的
为什么突然间会特别想一个人	为什么有时候会特别想一个人
北京电力电话	北京电力局电话
舒适同义词	舒服同义词
毛孔特别粗大怎么办	毛孔较粗大怎么办
我们一句话也没有说	我们一句话都没有说
泰国信奉的宗教	泰国信仰的宗教
八十九乘七十八等有些	八十九乘七十八等稍微
入乡随俗的近义词	入乡随俗的同义词
白毫银针茶饼怎么存放	白毫银针茶饼怎么保存
肚子老饿是怎么回事	肚子总是饿是怎么回事
北京到莒南火车票	北京到莒南县火车票
比较虐的电视剧	较虐的电视剧
武汉治白癜风最好的医院	武汉治白癜风更好的医院
老淌鼻血怎么办	老是淌鼻血怎么办
苹果十一怎么安卡	iphone十一怎么安卡
扬州钟点工多少钱一小时	扬州小时工多少钱一小时
大连有名的桥	大连著名的桥
什么牌子的卫生巾最好	什么牌子的卫生巾更好
鲁迅先生关于魏晋风度的演讲	鲁迅关于魏晋风度的演讲
骨密度检查多少钱	骨密度检测多少钱
形容光影优美的句子	形容光影柔美的句子
太谷离平遥古城有多远	太谷县离平遥古城有多远
世界有名的学校	世界著名的学校
减肥能吃茶叶蛋吗	减脂能吃茶叶蛋吗
游泳游多久可以减肥	游泳游多久可以减脂
距离十二月三十一号还有多少天	距离十二月三十一日还有多少天
喝哪种茶可以减肥	喝哪种茶可以减脂
湖北有名人物	湖北著名人物
杨幂为什么叫沈腾二舅	杨幂为什么喊沈腾二舅
贵阳到锦屏多少公里	贵阳到锦屏县多少公里
玫瑰花可以和菊花一起泡水喝吗	玫瑰花可以和菊花同时泡水喝吗
比较软的石头	较软的石头
脚为什么总臭	脚为什么很臭
八月份去哪旅游最好	八月去哪旅游最好
集美有几所中学	集美区有几所中学
艰难困苦的近义词	艰难困苦的同义词
桐乡到常州	桐乡市到常州
你天天吃什么	你每天吃什么
中药和牛奶可以一起喝吗	中药和牛奶可以同时喝吗
为什么吃完饭特别想抽烟	为什么吃完饭就想抽烟
特别的歌词	非常的歌词
晚上总睡不好	晚上都睡不好
祝福销售业绩好的词语	祝贺销售业绩好的词语
ff十四怎么拍照	ff十四怎么照相
表示果断的字	表示坚决的字
为什么我手机充电很慢	为什么我手机充电太慢
今天是秋天还是冬天	现在是秋天还是冬天
一百三十斤肚子特别大	一百三十斤肚子很大
什么游戏最好玩	什么游戏都好玩
黄金那种最好	黄金那种比较好
十月二十八号是星期几	十月二十八日是星期几
呼吸比较困难怎么回事	呼吸很困难怎么回事
牙齿快磨平了怎么办	牙齿都磨平了怎么办
路桥电力营业厅电话	路桥电力公司营业厅电话
治疗白癜风大概多少钱	治疗白癜风大约多少钱
毕节华为售后在哪里	毕节市华为售后在哪里
window十突然特别卡	window十突然非常卡
怎样装修房子才好看	怎样装修房子最好看
香蕉存放时间	香蕉保存时间
比较新颖的生日礼物	比较新奇的生日礼物
正月十五喝什么好	一月十五喝什么好
如何保存干海参	如何存放干海参
意大利最著名的景点	意大利最有名的景点
小龙虾买回家怎么保存	小龙虾买回家怎么存放
关机还关不了	关机都关不了
今年九月适合结婚的日子	今年九月份适合结婚的日子
昌吉汽配城在哪里	昌吉市汽配城在哪里
辛集市周边集市时间表	辛集周边集市时间表
中兴通讯怎么样	中兴通信怎么样
初中历史重要战役	初中历史重要战争
徐州医学院好吗	徐州医科大学好吗
泗洪到蚌埠多少公里	泗洪县到蚌埠多少公里
苹果怎么录音	mac怎么录音
二十年十一月份哪天结婚好	二十年十一月哪天结婚好
去过朝阳区回河北需要隔离吗	去过朝阳回河北需要隔离吗
最近比较火的儿歌	最近很火的儿歌
最好的速溶咖啡	比较好的速溶咖啡
查看未来几天的天气	查看这几天的天气
山西考公告什么时候出	山西省考公告什么时候出
今天风有多大	现在风有多大
最近几天有雪吗	这几天有雪吗
南昌著名的景点	南昌有名的景点
山西面积排名	山西市面积排名
什么菜降火效果最好	什么菜败火效果最好
眼睁睁的同义词	眼睁睁的近义词
苹果屏幕变得特别大	苹果屏幕变得很大
睡近义词	睡同义词
王源今年几岁	王源现在几岁
刚怀孕可以吃烧烤吗	才怀孕可以吃烧烤吗
中位线判断定理	中位线判定定理
万科集团好进吗	万科好进吗
转交的近义词	转交的同义词
女人都喜欢听什么话	女人最喜欢听什么话
苹果录歌软件	ios录歌软件
民政局有哪些部门	县民政局有哪些部门
舒适的什么填词语	舒服的什么填词语
形容黄花美丽的诗句	形容黄花优美的诗句
梦见好大的鲤鱼	梦见非常大的鲤鱼
冷水江市属于哪个省哪个市	冷水江属于哪个省哪个市
怎样在百度里下载小说	怎样在百度公司里下载小说
枸杞怎么吃最好	枸杞怎么吃更好
华夏航空安全吗	华夏安全吗
你是不是很笨	你是不是特别笨
常常咳嗽有痰	时常咳嗽有痰
关于重阳节日的古诗	关于重阳节的古诗
怎么才能让男朋友更爱我	怎么才能让男朋友很爱我
世界上最美丽的鹦鹉	世界上最漂亮的鹦鹉
苹果如何使用安装包	ios如何使用安装包
怎么减肥最快	怎么减肥更快
现在是早上还是中午	现在是早晨还是中午
尖子的近义词	尖子的同义词
苹果怎么添加本地音乐	iphone怎么添加本地音乐
青大校长什么级别	青岛大学校长什么级别
苹果怎么查订单	mac怎么查订单
什么游戏最好玩	什么游戏才好玩
团结合作近义词	团结合作同义词
尧都古镇最近开门吗	尧都古镇今天开门吗
太康到郑州多少公里	太康到郑州区多少公里
皮肤真菌检查怎么做	皮肤真菌检测怎么做
中国有哪些著名的桥	中国有哪些有名的桥
什么单机游戏最好玩	什么单机游戏很好玩
小米的创立时间	小米公司的创立时间
九十三年正月二十六是阳历多少	九十三年一月二十六是阳历多少
杭州垫鼻子哪家好都去艺兴	杭州垫鼻子哪家好都往艺兴
六个月婴儿喊爸爸妈妈	六个月婴儿叫爸爸妈妈
特别五笔怎么打字	非常五笔怎么打字
什么摩托车最好	什么摩托车更好
刚刚在干嘛	刚才在干嘛
数量近义词	数量同义词
西瓜和梨可以一起吃吗	西瓜和梨可以同时吃吗
神华集团董事长是谁	中国神华董事长是谁
菠菜和虾能一起吃吗	菠菜和虾能同时吃吗
赤壁市gdp	赤壁gdp
西藏有名的旅游景点	西藏著名的旅游景点
日本豆腐保存方法	日本豆腐储藏方法
西北师范大学具体地址	西北师范大学详细地址
三月两日什么星座	三月二什么星座
峨眉山有什么好吃的	峨眉山景区有什么好吃的
后台打开网易云	后台打开网易云音乐
衡阳有哪些学院	衡阳有哪些大学
葡萄酒保存多久	葡萄酒存放多久
你有哪些优点	你有哪些长处
今天几度	现在几度
黄果树瀑布路线图	黄果树瀑布景区路线图
怀孕会老想尿尿吗	怀孕会一直想尿尿吗
设置早上六点的闹钟	设置早上六点钟的闹钟
a七十二导航键设定	a七十二导航键设置
怎么检测不孕不育	怎么检查不孕不育
为什么经常放屁	为什么常常放屁
不打开网易云	不打开网易云音乐
凋谢的近义词	凋谢的同义词
为什么总放屁	为什么都放屁
美的集团电话	美的电话
未来几天会不会下雨	这几天会不会下雨
射手座今天运势	射手座今日运势
合阳有多少个乡镇	合阳县有多少个乡镇
南票区多少人口	南票多少人口
夜间是指什么时间段	晚上是指什么时间段
蚕豆病检查多少钱	蚕豆病检测多少钱
中国的专业银行有哪些	中国的正规银行有哪些
