评价诸葛亮	评价诸葛瞻
一个软件能否运行在两个不同厂家的cpu上	一个软件能否运行在两个不同厂家的cpu上
孕期长斑怎么办	孕期张斑怎么办
酵素的作用与功效	酵素的作用与功效
被虫子咬了起水泡	被虫子咬了起水疱
排卵期一般几天	排卵期一半几天
睡觉磨牙是什么原因	谁觉磨牙是什么原因
李华是什么朝代	成华是什么朝代
附近有什么好吃的	附近由什么好吃的
你是谁的主人	你是谁的主人
江门皮肤医院是正规医院吗	江门皮肤医院是正规医院吗
甲状腺功能亢进症严重	甲状腺功能亢进症严重
孕妇可以喝乌鸡汤吗早期	孕妇可以喝乌鸡汤吗早期
吸烟有哪些危害	吸烟有那些危害
大便变细是肠癌	大便变细是肠癌
如何设置充电声音	如何设置充电声音
怎么转换数值格式	怎么转换数字格式
周文王活了多少岁	周武王活了多少岁
尼泊尔是那个国家	尼泊尔是哪个国家
孕妇可以吃甘蔗	孕妇可以吃甘蔗
跑完步能喝水吗	跑完不能喝水吗
杨乐乐哪里人	胡乐乐哪里人
你有姐姐吗	你有姐姐吗
羊奶好还是牛奶好	养奶好还是牛奶好
被蟑螂咬了怎么办	背蟑螂咬了怎么办
输卵管堵塞还能排卵	输卵管堵塞还能排卵
沪是哪里的简称	沪是那里的简称
心肌缺血的症状	心肌缺血得症状
建行app怎么查公积金	建行app怎么查公积金
负数是整数吗	负数是正数吗
脚后跟磨出水泡怎么处理好的快	脚后根磨出水泡怎么处理好的快
老是放屁是怎么回事	老是放屁是怎麼回事
高血压能吃苦瓜	高血压能吃苦瓜
k一屏幕价格	k一屏幕价格
孕妇为什么会孕吐	孕妇为什么回孕吐
吃什么水果会发胖	吃什么水果会发胖
暗度陈仓的上一句	暗渡陈仓的上一句
新生儿脑缺氧	新生儿恼缺氧
怀孕初期可以吃火锅	怀孕初期可以吃火锅
扁平疣的治疗方法	扁平尤的治疗方法
沈阳外来人口需要隔离	沈阳外来人口需要隔离
宝宝发烧可以吃虾	宝宝发烧可以吃虾
羊汤的做法	羊汤的作法
腰骶部酸痛怎么回事	腰底部酸痛怎么回事
我在马路边捡到一分钱	我在吗路边捡到一分钱
黄疸型肝炎的症状	黄疸行肝炎的症状
学生复印件是什么意思	学生复印件是什么意思
橱柜柜体用什么材料	厨柜柜体用什么材料
三的倍数的特征是它的什么的和是什么的倍数	三的倍数的特征是它的什么的和是什么的倍数
猫能吃橘子么	猫能吃桔子么
甲硝唑副作用大	甲硝唑副作用大
许葵是什么	许凯是什么
一安培等多少库仑	一安培等多少库伦
活血化瘀中成药有哪些	活血化瘀中成药有那些
六乘十五	六乘十五
吃什么增强免疫力	吃什么增强勉疫力
用什么方式可以定位别人的手机	用什么方式可以定位别人的手机
头发老掉怎么办	头发老掉怎么办
脸上长斑怎么处理	脸上长班怎么处理
什么是阳光	什么是日光
新型冠状病毒属哪类	新型冠状病毒是哪类
从小不发烧是好事还是坏事	从小不发烧是好事还是坏事
老烂腿怎么治	老烂腿怎麼治
嘴巴周围长痘	嘴吧周围长痘
孟浩然是哪里人	郭浩然是哪里人
健身能长高吗	建身能长高吗
gay里面狗是什么意思	gay里面狗是什么意思
小孩长湿疹怎么办	小孩涨湿疹怎么办
验孕棒两条杠但是有来月经的感觉	验孕棒两条杠但是有来月经的感觉
卢俊杰是谁	谢俊杰是谁
肝硬化可以治愈	肝硬化可以治愈
转氨酶高的原因	转安酶高的原因
三个月宝宝流清鼻涕怎么办	三个月宝宝流青鼻涕怎么办
m四百一十六怎么折	m四百一十六怎么折
你喜欢吃什么	你喜欢吃什么
什么是窦性心动过速	什么事窦性心动过速
晚上吃水果减肥	晚上吃水果减肥
慢性胃炎能根治	慢性胃炎能根治
嗓子发炎吃什么药	桑子发炎吃什么药
新生儿一天喝多少水	新生儿一天和多少水
发烧可以开空调	发烧可以开空调
怎样让水晶泥变硬一些	怎样让水晶泥变硬一些
杭州到赣州有多少公里	杭州到赣州有多少公里
岳振华最高什么职务	岳振弘最高什么职务
故宫周一为什么要闭馆	故宫周一为什么要闭馆
pubg可以家庭共享吗	pubg可以家庭共享吗
abb的颜色	abb的颜色
肠胃炎可以吃香蕉	肠胃炎可以吃香蕉
陈楚生是哪里的	陈席生是哪里的
朱茵结婚了	朱茵结婚了
根号五百七十一	根号五百七十一
新生儿鼻子不通气怎么办	新生二鼻子不通气怎么办
洛阳晚上哪里好玩	洛阳晚上那里好玩
标志英语单词	标识英语单词
三年级所有古诗	三年级所有古诗
驾驶证扣分要本人去	驾驶证扣分要本人去
孕妇可以吃鸭爪	孕妇可以吃鸭爪
熬夜喝什么好	敖夜喝什么好
脚底疼怎么回事	脚底疼怎么会事
李连杰的国籍是什么	李卜杰的国籍是什么
拔罐出水泡是怎么回事	拔罐出水疱是怎么回事
被蚂蚁咬了怎么办	被蚂蚁咬了怎么半
北方四月应季水果	北方四月应季水果
王子怡是谁	汪子怡是谁
麻椒和什么不能一起吃	辣椒和什么不能一起吃
脚上起水泡怎么办	脚上气水泡怎么办
三点二十二千米等多少米	三点二十二千米等多少米
怎么样能找到一个人的位置	怎么样能找到一个人的位置
重庆都有哪些好玩的地方	重庆都有那些好玩的地方
新生儿鸟氨酸高复查通过率大吗	新生儿鸟氨酸高复查通过率大吗
什么东西补肾	什么东西布肾
赵匡胤家庭背景	赵胤胤家庭背景
孕妇能吃可乐鸡翅	孕妇能吃可乐鸡翅
张一山结婚了吗	张一龙结婚了吗
快走能减肥	快走能减肥
怀孕能吃茭白	怀孕能吃茭白
脚磨起泡了怎么办	脚磨气泡了怎么办
这是什么型号的	这是什么性号的
有什么游戏好玩的	有什么游戏好玩的
网络主播是不是真的	网络主播是不是真的
脚麻木是怎么回事	脚麻模是怎么回事
怀孕初期会发热	怀孕初期会发热
孕妇可以吃银耳吗	孕妇可以吃银耳妈
眼睛里面一眨眼就疼	眼睛里面一眨眼就疼
你认识王源吗	你认识王源吗
五万兆流量等多少g	五万兆流量等多少g
荨麻疹能吃鸡肉吗	荨麻诊能吃鸡肉吗
月经前白带会多	月经前白带会多
月经期可以减肥	月经期可以减肥
聚维酮碘是碘伏	聚维酮碘是碘伏
怎样删掉电脑c盘中的文件	怎样删掉电脑c盘中的文件
脸形胖的适合什么发型	脸型胖的适合什么发型
喝蜂蜜水能减肥吗	喝蜂密水能减肥吗
坐月子吃什么好	坐月子吃什麼好
一繁体字是什么样的	一繁体字是什么样的
怎么样看孩子有没有发育	怎么样看孩子有没有发育
朱茵结婚了吗	朱婷结婚了吗
荨麻疹能吹空调吗	寻麻疹能吹空调吗
小孩子可以喝蜂蜜吗	小孩子可以和蜂蜜吗
月经一个月来两次正常	月经一个月来两次正常
湿疣怎么治疗	湿尤怎么治疗
喉咙痛喝什么好	喉咙痛和什么好
款待的词语	款待的词语
怎样申请低保	怎样伸请低保
苹果八充满电需要多长时间	苹果八充满电需要多长时间
忘记隐私密码	忘记隐私密码
阿胶糕的功效与作用	阿胶糕得功效与作用
孕妇可以用皮炎平	孕妇可以用皮炎平
盆腔炎的症状是什么	盆腔炎得症状是什么
怀孕初期可以吃橘子吗	怀孕初期可以吃桔子吗
最强nba教练属性加成有用吗	最强nba教练属性加成有用吗
汽油机抽水机怎么排空气	汽油机抽水机怎么排空气
小腿肚抽筋怎么回事	小腿杜抽筋怎么回事
怎样才能长胖	怎杨才能长胖
杜甫是什么时候出生的	杜牧是什么时候出生的
月经期间怎么减肥	月经其间怎么减肥
临沂到丽水物流	临沂到丽水物流
八月二十七日是什么星座	八月二十七日是什么星坐
精索静脉曲张的症状	精缩静脉曲张的症状
华为手表有测血压功能吗	华为手表有测血压功能吗
每次提升成就等级时会获得什么额外奖励	每次提升成就等级时会获得什么额外奖励
在哪可以看夫人你的马甲掉了	在哪可以看夫人你的马甲掉了
你是谁呢	你是谁呢
打耳洞疼吗	打儿洞疼吗
南宁知名律师事务所	南宁著名律师事务所
贫血会死人	贫血会死人
孔融是个什么样的人	雷融是个什么样的人
怀孕可以泡温泉吗	怀孕可以跑温泉吗
脚趾头痒是怎么回事	脚只头痒是怎么回事
黄明昊今年多少岁	杨明昊今年多少岁
我国与发达国家在gdp上的差距说明了什么	我国与发达国家在gdp上的差距说明了什么
怀孕可以吃白木耳	怀孕可以吃白木耳
电视无法接收遥控器信号是什么原因	电视无法接收遥控器信号是什么原因
高血压有什么症状	高血压又什么症状
撤退性出血算月经	撤退性出血算月经
和平精英玛莎拉蒂可以隐藏吗	和平精英玛莎拉蒂可以隐藏吗
蒙脱石混悬液可以和奶一起吃会怎样	蒙脱石混悬液可以和奶一起吃会怎样
公积金可以取吗	公基金可以取吗
王加景念什么	王加容念什么
氯化钾注射液可以口服吗	氯化钾注射夜可以口服吗
湖北警官职业技术学校分数线	湖北警官职业技术学校分数线
茄子会回奶	茄子会回奶
成都公办二本院校	成都公办二本院校
八十八除四	八十八除四
杨颖和黄晓明什么关系	杨颖和黄晓何什么关系
眼睛胀疼怎么办	眼睛帐疼怎么办
手机号码注销了微信怎么登陆	手机号码注销了微信怎么登录
结肠炎什么症状	结肠炎什么证状
开水烫伤会留疤吗	开水烫伤回留疤吗
西安交大什么时候开学	西安交大什么时候开学
西瓜和桃子能一起吃吗	西瓜合桃子能一起吃吗
有痰咳不出怎么办	有谈咳不出怎么办
吃海鲜荨麻疹	吃海鲜寻麻疹
心脏上有黑斑怎么回事	心脏上有黑斑怎么回事
怎样除口臭	怎样处口臭
或许我们之间太知己知彼是什么歌	或许我们之间太知己知彼是什么歌
绝地求生如何连续标点	绝地求生如何连续标点
喝了红酒可以吃榴莲	喝了红酒可以吃榴莲
你会法语吗	你会法语吗
怀孕了可以验光配眼镜吗	怀孕了可以验光配眼镜吗
尿酸高可以吃海带	尿酸高可以吃海带
海棠分布在什么区域	海棠分布在什么区域
科目二如何在考场买圈	科目二如何在考场买圈
中暑的症状	种暑的症状
交大mpa学费	交大mba学费
长水痘打针能好的快吗	长水痘打针能好得快吗
慢半拍的情敌是什么意思	慢半拍的情敌是什么意思
空腹吃水果好	空腹吃水果好
蒸生蚝多长时间	整生蚝多长时间
你知道我的星座是什么吗	你知道我的星座是什么吗
张倩琳事件到底怎么样了	张倩琳事件到底怎么样了
你卖多少钱	你卖多少钱
每天早上喝蜂蜜水好吗	每天早上和蜂蜜水好吗
十点三厘米等多少分米	十点三厘米等多少分米
子宫肌瘤能吃鸡肉吗	子宫几瘤能吃鸡肉吗
蒋英文怎么写	羿英文怎么写
甲亢可以吃海带	甲亢可以吃海带
喝绞股蓝头晕还能喝吗	喝绞股蓝头晕还能喝吗
欠条会过期	欠条会过期
猫一年生几胎	猫一年生几台
iphone如何清除缓存数据	iphone如何清除缓存数据
来大姨妈吃什么水果	来大姨妈吃什麼水果
四川快乐十二开奖结果四川福彩快乐十二开奖结果	四川快乐十二开奖结果四川福彩快乐十二开奖结果
坐月子能不能吃燕窝	做月子能不能吃燕窝
发烧挂哪个科	发烧挂那个科
背上长痘痘的原因	背上张痘痘的原因
今天天气如何	今天天气如何
下梦见自己的车坏了	下梦见自己的车坏了
历史上有薛葵这个人吗	历史上有薛葵这个人吗
你认识伊兰莎吗	你认识伊莱莎吗
我是不是单身狗	我是不是单身狗
你有几个孩子	你有几个孩子
刘德华父亲是谁	霍德华父亲是谁
大乐透六加二多少钱一注本金	大乐透六加二多少钱一注本金
射进去一次会怀孕	射进去一次会怀孕
钟南山的英语怎么读	钟南山的英语怎么读
婴儿流黄鼻涕	婴儿留黄鼻涕
包皮手术有哪几种	包皮手术有那几种
心脏病的症状	心藏病的症状
来月经可以喝咖啡吗	来月经可以何咖啡吗
肚子疼休克了是什么病	肚子疼休克了是什么病
许海峰获得我国第一枚金牌是哪个项目	冷海峰获得我国第一枚金牌是哪个项目
血糖高能吃橙子	血糖高能吃橙子
我的名字叫做用韩语怎么说	我的名字叫做用韩语怎么说
翻山越岭什么生肖	翻山越领什么生肖
沪是哪里的车牌	沪是那里的车牌
三十五平方分米等多少立方米	三十五平方分米等多少立方米
沈阳锦麟河院怎么样	沈阳锦麟河院怎么样
韩语姐姐怎么说	汉语姐姐怎么说
招行只打印工资流水	招行只打印工资流水
磺酸的用途和注意事项	磺酸的用途和注意事项
k五的价格	k五的价格
你的爸爸妈妈是谁	你的爸爸妈妈是谁
会不会学猫叫	会不会学猫叫
几何体是什么	几和体是什么
喜帖街的歌词	喜贴街的歌词
肚子涨是什么原因	肚子涨是什么愿因
诺基亚现在属于富士康	诺基亚现在属于富士康
皮皮虾的制作方法视频	皮皮虾的制作方法视频
四川在哪个地震带	四川在那个地震带
肾结石可以吃红薯	肾结石可以吃红薯
孕妇可以吃鸡胗	孕妇可以吃鸡胗
十四乘五	十四乘五
孕五月尿频	孕五月尿频
早上喝蜂蜜水有什么好处	早上和蜂蜜水有什么好处
被猫抓了要打针吗	被猫爪了要打针吗
朱开山是哪个地方的人	朱开福是哪个地方的人
你什么时候能做到	你什么时候能做到
慢性胃炎可以吃益生菌	慢性胃炎可以吃益生菌
榴莲的营养价值	留莲的营养价值
八六版西游记白骨精的扮演者杨春霞	八六版西游记白骨精的扮演者杨春霞
退出王者游戏	退出王者游戏
中耳炎吃什么药	种耳炎吃什么药
长春在哪里补办身份证	长春在哪里补办身份证
通过丝绸之路传入中国的农作物或手工业品	通过丝绸之路传入中国的农作物或手工业品
关于王熙凤的诗词	关于贾熙凤的诗词
家长代表感谢家长志愿者的话语	家长代表感谢家长志愿者的话语
怀孕可以吃螺丝粉吗	怀孕可以吃罗丝粉吗
唑疮怎么治	唑创怎么治
拉肚子能吃苹果	拉肚子能吃苹果
明天冷不冷	明天冷不冷
哺乳期可以喝蒲公英颗粒	哺乳期可以喝蒲公英颗粒
拉肚子能喝咖啡吗	拉肚子能和咖啡吗
晚上不吃饭可以	晚上不吃饭可以
湖南二十年四月自考时间	湖南二十年四月自考时间
牛奶和香蕉可以同时吃吗	牛奶和香焦可以同时吃吗
人参的功效	人参得功效
小孩长湿疹怎么办	小孩张湿疹怎么办
月经提前半个月正常	月经提前半个月正常
什么冰箱好	什么冰箱号
喝酒喝的是一种心情	喝酒喝的是一种心情
在干什么	在干什么
怎么去水肿	怎么取水肿
环保手抄报内容	环保手抄包内容
屁股大用英文怎么说	屁股大用英文怎么说
经期能喝菊花茶吗	经期能和菊花茶吗
朱德是那里人	朱徳是那里人
身高一百八十的标准体重是多少	身高一百八十的标准体重是多少
沙漠的资源如何利用	沙漠的资源如何利用
结肠炎有那些症状	结长炎有那些症状
分段函数不定积分的c如何确定	分段函数不定积分的c如何确定
请假条的格式	请加条的格式
手机卡怎么办oppo	手机卡怎么办oppo
海底两万里中里指什么	海底两万里中里指什么
偏头痛是什么原因	片头痛是什么原因
神经性耳聋可以治愈	神经性耳聋可以治愈
快递费那么贵一些商家怎么赚钱	快递费那么贵一些商家怎么赚钱
我国汛期最长的河流	我过汛期最长的河流
强直性脊柱炎的症状	强直行脊柱炎的症状
水痘疫苗有必要打么	水痘疫苗有必要打么
绿豆汤怎么煮	绿豆汤怎么住
孕妇可以吃泡面吗	孕妇可以吃泡面妈
怎么注册微信公众号	怎么注册威信公众号
下雨天可以艾灸	下雨天可以艾灸
牛仔裤怎么洗不褪色	牛仔裤怎么冼不褪色
结节是肿瘤吗	结节事肿瘤吗
三十乘一百八十	三十乘一百八十
卖水果赚钱	卖水果赚钱
淋巴瘤有什么症状	淋巴瘤有什么证状
三加二减五	三加二减五
眼睛有红血丝怎么办	眼精有红血丝怎么办
蛋白质高的食物有哪些	蛋白质高的实物有哪些
戴避孕套会怀孕吗	带避孕套会怀孕吗
小儿急性喉炎吃什么药	小二急性喉炎吃什么药
近月少女的礼仪汉化补丁怎么用	近月少女的礼仪汉化补丁怎么用
哺乳期可以吃巧克力吗	补乳期可以吃巧克力吗
痛经能喝红糖水吗	痛经能和红糖水吗
苏州在浙江	苏州在浙江
食管癌遗传吗	食管癌移传吗
人流后可以吃益母草	人流后可以吃益母草
刘德华最新电影	霍德华最新电影
牛肉丸浮起来就熟了吗	牛肉丸浮起来就熟了吗
华夏本来生活白金卡年费	华夏本来生活白金卡年费
沈阳三好街农行电话	沈阳三好街农行电话
电脑开机多次才能进入系统	电脑开机多次才能进入系统
杨千里演员	杨千嬅演员
武汉艳阳天酒店待遇怎么样	武汉艳阳天酒店待遇怎么样
梅婷的老公是谁	马婷的老公是谁
彦锋的意思	俊锋的意思
卫星锅分辨率	卫星锅分辩率
我失恋了你能安慰我吗	我失恋了你能安慰我吗
正常人一天碳水和蛋白质摄入量	正常人一天碳水和蛋白质摄入量
怀孕可以吃冰淇淋	怀孕可以吃冰淇淋
腺肌症能怀孕	腺肌症能怀孕
类风湿关节炎吃什么药	类凤湿关节炎吃什么药
沐阳的英文	宇阳的英文
孩子感冒流鼻涕怎么办	孩子感冒留鼻涕怎么办
小布打开旁白	小布打开旁白
孕妇可以吃海带丝	孕妇可以吃海带丝
做完骨扫描多久可以接触孩子	做完骨扫描多久可以接触孩子
吕丽萍的老公是谁	赵丽萍的老公是谁
近年好看的电影	今年好看的电影
喝豆浆会胖吗	呵豆浆会胖吗
大蛇丸死了	大蛇丸死了
广东七十岁以上老人补贴	广东七十岁以上老人补贴
脸上长斑怎么办	连上长斑怎么办
经期可以吃感冒药	经期可以吃感冒药
怀孕初期有什么反应	怀孕初期有什么反映
小龙虾的做法和绝密配方	小龙虾的做法和绝密配方
老年人喉咙喘气有声音猫叫	老年人喉咙喘气有声音猫叫
经常熬夜的人吃什么好	经长熬夜的人吃什么好
吃什么补肾虚	吃什么不肾虚
月经前几天白带会增多	月经前几天白带会增多
包皮红肿怎么回事	包皮红重怎么回事
怎么通过随心贴登陆别人账号	怎么通过随心贴登录别人账号
怀孕可以吃提子	怀孕可以吃提子
为什么结婚要门当户对	为什么结婚要门当户对
五十二乘四	五十二乘四
手机上定位怎么关不了	手机上定位怎么关不了
连环画英文单词怎么写	连环画英文单词怎么写
鼻子下面有点痛	鼻子下面有点疼
你是男的	你是男的
骨折可以吃生蚝	骨折可以吃生蚝
妊娠糖尿病可以吃红薯	妊娠糖尿病可以吃红薯
足跟滑囊炎怎么治疗	足根滑囊炎怎么治疗
火影忍者哪一集是忍界大战	火影忍者哪一集是忍界大战
不锈钢锅可以熬中药吗	不绣钢锅可以熬中药吗
白浅的儿子	白凡的儿子
是人工服务吗	是人工服务吗
处女膜没破会怀孕	处女膜没破会怀孕
绿园防疫站电话	绿园防疫站电话
哺乳期可以喝绿豆汤	哺乳期可以喝绿豆汤
身份证丢了能坐飞机	身份证丢了能坐飞机
晨曦名字的含义是什么	晨旭名字的含义是什么
刘晓燕哪里人	刘小燕哪里人
一百八十除四	一百八十除四
姜和白醋能去斑吗	姜和白醋能祛斑吗
怎样治疗白癜风	怎样治疗白电风
农行信用卡怎么提前还款	农行信用卡怎么提前还款
鼻息肉的症状	鼻息肉得症状
血糖高可以吃玉米	血糖高可以吃玉米
灰原哀喜欢柯南吗	灰原哀喜欢柯召吗
来姨妈可以吃芒果	来姨妈可以吃芒果
嘿你是谁	嘿你是谁
被蜜蜂蛰了有后遗症吗	被蜜蜂蜇了有后遗症吗
孕妇餐后一小时血糖正常值	孕妇餐后一小时血糖正常值
月经期能吃芒果吗	月经期能吃忙果吗
怀孕能吃消炎药	怀孕能吃消炎药
洗牙的好处	洗呀的好处
怎么跟异地跟老公聊色话题	怎么跟异地跟老公聊色话题
子宫肌瘤可以吃燕窝	子宫肌瘤可以吃燕窝
席慕容关于人生的诗有哪些	席真容关于人生的诗有哪些
上海到台儿庄多少公里	上海到台儿庄多少公里
炉石传说哪些牌可以分解	炉石传说那些牌可以分解
咸鱼上怎么交易安全	闲鱼上怎么交易安全
五分加五分	五分加五分
表格怎么把sheet一起打印	表格怎么把sheet一起打印
肺里有结节	肺里有结结
家用血压计哪种好	家用血压计那种好
学校户口属于什么性质	学校户口属于什么性质
脑动脉硬化怎么治疗	闹动脉硬化怎么治疗
荨麻疹的治疗方法	寻麻疹的治疗方法
做完人流腰疼怎么回事	坐完人流腰疼怎么回事
补中益气丸的功效	补中益气丸的工效
小孩上吐下泻	小孩上吐下泄
abigail是什么意思	abigail是什么意思
过敏性皮炎能吃牛肉	过敏性皮炎能吃牛肉
怀孕会犯困	怀孕会犯困
十二乘五十五	十二乘五十五
糖尿病可以吃面食	糖尿病可以吃面食
什么浏览器好用	什么流览器好用
减肥可以吃西瓜	减肥可以吃西瓜
如何找回微信密码	如何找会微信密码
柯基可以吃橘子	柯基可以吃橘子
喜欢一个人是什么感觉	喜欢一个人是什么感觉
甲状腺结节是怎么回事	甲状腺结结是怎么回事
西南交大校长级别	西南交大校长级别
柳下惠是谁	杨下惠是谁
体检前可以喝水	体检前可以喝水
小情歌吉他谱	小情歌吉它谱
华为freebuds悦享版和荣耀flypods哪个好	华为freebuds悦享版和荣耀flypods哪个好
怎么治疗腰肌劳损	怎么治疗腰肌老损
怀孕多久有反应	怀孕多久又反应
刚怀孕会尿频	刚怀孕会尿频
如何关掉自动更新	如何关掉自动更新
咳嗽怎样好得快	咳嗽怎样好的快
泡脚能减肥	泡脚能减肥
牡蛎的营养价值及功效	母蛎的营养价值及功效
什么软件充话费最便宜	什么软件冲话费最便宜
助理工程师有什么用	助力工程师有什么用
清华比较好的专业	清华比较好的专业
是谁我是谁	是谁我是谁
怎么还原魔方	怎么还原摩方
孕妇感冒可以喝姜汤	孕妇感冒可以喝姜汤
孕妇可以喝苏打水吗	孕妇可以喝苏达水吗
单钢轮与双钢轮区别	单钢轮与双钢轮区别
星海音乐学院好	星海音乐学院好
藕尖的作法	藕尖的做法
怎么去除地板上的乳胶漆	怎么祛除地板上的乳胶漆
孩子脸上有白斑是怎么回事	孩子脸上有白班是怎么回事
口腔溃疡吃什么药	口强溃疡吃什么药
杨俊杰这个名字怎么样	李俊杰这个名字怎么样
谁发明了电话	谁发名了电话
肺上有结节	肺上又结节
五官破相会带来什么	五官破相会带来什么
关节积液怎么治疗	关节积夜怎么治疗
长沙二十年城市总体规划	长沙二十年城市总体规划
桔片多少钱一盒	桔片多少钱一盒
三点一四乘八的平方	三点一四乘八的平方
不符合更年期雌激素变化作用的规律是	不符合更年期雌激素变化作用的规律是
有什么好玩的东西	有什么好玩的东西
黄明昊今年多少岁	陆明昊今年多少岁
雀斑能去掉	雀斑能去掉
lastdance木西吉他谱	lastdance木西吉他谱
神经官能症吃什么药	神经官能证吃什么药
二十四除四等多少	二十四除四等多少
a五十七如何快速充电	a五十七如何快速充电
大便不成形是怎么回事	大便不成行是怎么回事
银耳汤的功效与作用	银儿汤的功效与作用
怎么置换	怎么置换
甲状腺切除的后遗症	甲状腺切除的后疑症
妊娠糖尿病可以吃橘子	妊娠糖尿病可以吃橘子
你智商多少	你智商多少
涮羊肉怎么样	涮羊肉怎么样
社保自助经办平台使用时间	社保自助经办平台使用时间
阜新离锦州多远	阜新离锦州多远
手机定位怎么定啊	手机定位怎么定啊
益母草的功效与作用	一母草的功效与作用
驼背怎么矫正	驮背怎么矫正
坐月子洗头可以用吹风机	坐月子洗头可以用吹风机
眼睛结膜炎怎么办	眼镜结膜炎怎么办
常州大金空调售后维修电话四oo一九百六十七一八千八百一十八	常州大金空调售后维修电话四oo一九百六十七一八千八百一十八
日本经济什么时候开始腾飞	日本经济什么时候开始腾飞
一型糖尿病遗传	一型糖尿病遗传
颈椎病的治疗	颈椎病得治疗
咸丰庚午年是哪一年	咸丰庚午年是哪一年
来月经肚子特别疼怎么办啊	来月经肚子特别疼怎么办啊
月经期可以艾灸吗	月精期可以艾灸吗
湿疹怎么办	湿诊怎么办
脱发挂什么科	脱发挂什么课
身上有红点是怎么回事	身上有红点是怎么会事
骨质疏松的症状	骨质疏松的症壮
包皮手术多少钱	抱皮手术多少钱
副乳怎么消除才正确	附乳怎么消除才正确
脑动脉硬化	脑动脉硬花
做唐筛要空腹	做唐筛要空腹
牙齿痛的睡不着怎么办	牙齿痛得睡不着怎么办
北京社保断交多久还可以续上	北京社保断交多久还可以续上
坐月子可以做面膜	坐月子可以做面膜
小脑萎缩的症状	小闹萎缩的症状
电脑如何打开ie浏览器	电脑如何打开ie浏览器
河南八年级什么时候开学	河南八年级什么时候开学
七百五十除十五	七百五十除十五
头发干枯毛躁怎么办	头发干枯毛燥怎么办
月经期可以吃叶酸	月经期可以吃叶酸
阿胶膏的副作用	阿胶糕的副作用
年底结平应交增值税会计分录	年底结平应交增值税会计分录
怎么卸假睫毛	怎么卸甲睫毛
血常规能看出艾滋病	血常规能看出艾滋病
怎么在淘宝上开网店	怎么在陶宝上开网店
蓝色配什么颜色好看	蓝色陪什么颜色好看
孕妇能吃黄桃	孕妇能吃黄桃
荨麻疹吃什么药	寻麻疹吃什么药
优酷会员首三月六元是什么意思	优酷会员首三月六元是什么意思
痛风能吃饺子	痛风能吃饺子
你怎么管	你怎么管
一除十五分之二	一除十五分之二
糜烂型脚气	糜烂形脚气
湖南的景区有哪些	湖南的景区有哪些
小布你喜欢谁	小布你喜欢谁
怎样消除黑眼圈	怎样消出黑眼圈
经期可以喝益母草	经期可以喝益母草
来月经可以吃火龙果	来月经可以吃火龙果
孩子能吃蜂蜜	孩子能吃蜂蜜
扑克牌的花色	扑克排的花色
故障灯用解码器解码后还亮	故障灯用解码器解码后还亮
范冰冰整容了吗	贾冰冰整容了吗
猪脚扣肉的制作过程	猪脚扣肉的制作过程
西葫芦成份	西葫芦成分
社保局周末上班	社保局周末上班
眼线怎么画	眼线怎么话
满五唯一能省多少钱	满五唯一能省多少钱
黄果兰能插活吗	黄葛兰能插活吗
减肥能吃馒头	减肥能吃馒头
牙齿牙根发黑怎么回事	牙齿压根发黑怎么回事
好玩的网页游戏	好玩的网页有戏
孕妇能用炉甘石洗剂	孕妇能用炉甘石洗剂
慢性浅表性胃炎伴糜烂	慢性浅表性胃炎半糜烂
二千零一十九款日产骊威什么时候能国产	二千零一十九款日产骊威什么时候能国产
温州有哪些区	温州有那些区
花都君悦酒店在哪里	花都君悦酒店在哪里
参麦注射液的作用	参麦注射夜的作用
来例假腰疼是怎么回事	来历假腰疼是怎么回事
孕妇可以拔罐	孕妇可以拔罐
来月经可以运动吗	来月经可以动动吗
人有多少颗牙齿	人有多少克牙齿
公司降本增效的方法	公司降本增效的方法
强力枇杷露小孩能喝	强力枇杷露小孩能喝
口腔溃疡吃什么好	口腔溃疡吃什药好
怎样向对方发送我的位置	怎样向对方发送我的位置
电信移动联通哪个好	电信移动联通那个好
发芽的姜能吃	发芽的姜能吃
前列腺增生有什么症状	前列腺增生有什么症壮
爱心怎么折	爱心怎么哲
取环后的注意事项	去环后的注意事项
宝宝拉肚子怎么办	宝宝啦肚子怎么办
输卵管通而不畅怎么办	输卵管通儿不畅怎么办
肾结石能吃鸡蛋	肾结石能吃鸡蛋
怎么样形容一个女人不持家	怎么样形容一个女人不持家
手脱皮怎么回事	手拖皮怎么回事
长期吃安眠药	常期吃安眠药
糖尿病可以吃玉米吗	塘尿病可以吃玉米吗
颈部淋巴结肿大	颈部琳巴结肿大
墨熙名字的含义	墨墨名字的含义
尿道炎吃什么药	尿道炎吃什麼药
什么都可以	什么都可以
burn的过去式和过去分词是什么啊	burn的过去式和过去分词是什么啊
腰肌劳损怎么办	腰肌劳损怎么半
孕妇可以戴隐形眼镜吗	孕妇可以带隐形眼镜吗
菠萝蜜上火吗	菠萝密上火吗
白矾的功效与作用	百矾的功效与作用
分泌性中耳炎怎么治疗	分密性中耳炎怎么治疗
眼睛变形怎么恢复	眼睛变型怎么恢复
酸梅汤能和牛奶一起吃吗	酸梅汤能和牛奶一起吃吗
仓鼠吃大米	仓鼠吃大米
毒品的危害	毒品的为害
霍尔元件能够测量哪些物理参数	霍尔原件能够测量哪些物理参数
女生来姨妈可以吃薯片	女生来姨妈可以吃薯片
甲状腺结节的危害	甲状腺结节的威害
卖家具好吗	卖家居好吗
玫瑰糠疹怎么治疗	玫瑰康疹怎么治疗
额头和下巴长痘是什么原因	额头和下巴长豆是什么原因
左玉是哪部电视剧	李玉是哪部电视剧
怎么才能长高	怎么才能涨高
北京新世界酒店属于什么集团	北京新世界酒店属于什么集团
勾线笔画到塑料桌子上怎么办	勾线笔画到塑料桌子上怎么办
毛囊炎是皮肤病	毛囊炎是皮肤病
银渐层能长到多少斤	银渐层能长到多少斤
皮肤癌有哪些症状	皮肤癌有那些症状
生命密码九百四十四组密码解析	生命密码九百四十四组密码解析
武大郎那里人	武大郎哪里人
秋葵的功效与作用	秋葵的功效与做用
微信怎么查聊天记录	微信怎么查聊天纪录
子宫肌瘤影响怀孕	子宫肌瘤影响怀孕
西安六月份热吗	西安六月份热吗
如何学好历史	如何学号历史
菊花的功效与作用	菊花得功效与作用
经常带口罩会长黄褐斑吗	经常带口罩会长黄褐斑吗
于震演过的电视剧	成震演过的电视剧
杨俊杰这个名字怎么样	唐俊杰这个名字怎么样
浙江到西安高铁需要多长时间	浙江到西安高铁需要多长时间
尿道感染吃什么消炎药	尿到感染吃什么消炎药
胃炎有什么症状	胃炎有什么证状
咳嗽有白痰	咳嗽又白痰
香菜怎样保存时间长不腐烂	香菜怎样保存时间长不腐烂
新都到双流机场t两	新都到双流机场t两
今天属什么生肖	今天数什么生肖
三点一四乘八	三点一四乘八
纪念碑谷第九关怎么过	记念碑谷第九关怎么过
我是不是要睡觉了	我是不是要睡觉了
我要怎么做	我要怎么做
洋芋粑粑的做法	洋芋粑粑的作法
广陵世家二手房价	广陵世家二手房价
性病的症状有哪些	性病的症状有那些
做梦梦见鬼	做梦梦见贵
李丽珍的电影	李慧珍的电影
脸上长疙瘩怎么办	脸上涨疙瘩怎么办
福州哪家装修公司好	福州那家装修公司好
流清鼻涕是什么感冒	刘清鼻涕是什么感冒
肠虫清怎么吃	长虫清怎么吃
喝柠檬水有什么好处	和柠檬水有什么好处
查艾滋病挂什么科	查爱滋病挂什么科
月经后第几天是排卵期	月经后弟几天是排卵期
李亚鹏的学校	洪亚鹏的学校
子宫肌瘤可以顺产	子宫肌瘤可以顺产
导致九十八年长江洪水泛滥的主要原因是什么	导致九十八年长江洪水泛滥的主要原因是什么
尿酸多少算痛风	尿酸多少算通风
洋葱和葱的功效区别	洋葱和葱的功效区别
宝宝几个月翻身	宝宝几个月反身
白带增多是月经前兆	白带增多是月经前兆
中药有副作用	中药有副作用
明天什么天气	明天什么天气
在阳光下屏幕太暗	在阳光下屏幕泰安
丙型肝炎的症状	丙性肝炎的症状
张卫健多高	张雪健多高
气缸垫有哪些类型	汽缸垫有哪些类型
脂肪肝有什么症状	脂肪肝有什么证状
剖腹产盆底肌训练什么时候开始	剖腹产盆底肌训练什么时候开始
滴虫性阴道炎治疗	滴虫性阴到炎治疗
深圳知名律师事务所	深圳知名律师事务所
c三十怎么登录	c三十怎么登陆
肚子大怎么减肥	肚子打怎么减肥
怀孕能吃甲鱼	怀孕能吃甲鱼
粽子怎么做的	棕子怎么做的
脑血管堵塞能治好	脑血管堵塞能治好
大乐透六种口诀	大乐透六种口决
起泡胶粘在裤子上怎么弄	起泡胶粘在裤子上怎么弄
李鸿章是谁	李鸿明是谁
月经推迟多久能测出怀孕	月经推迟多久能侧出怀孕
苹果十一pages文稿闪退	苹果十一pages文稿闪退
慢性萎缩性胃炎症状	慢性萎缩性胃炎证状
那个人是谁	那个人是谁
一元二次函数求根公式一元二次方程怎么解	一元二次函数求根公式一元二次方程怎么解
王者梦魇的属性	王者梦魇的属性
猫咪眼睫毛可以剪吗	猫咪眼睫毛可以剪吗
狄志杰演的电视剧	安志杰演的电视剧
汽车故障码南京依维柯p00八十七	汽车故障码南京依维柯p00八十七
眼霜的作用	眼霜的做用
葫芦的功效与作用	葫芦的工效与作用
甲硝唑栓的作用与用途	甲硝坐栓的作用与用途
胀气的食物有哪些	帐气的食物有哪些
小孩能刮痧	小孩能刮痧
做梦梦到猪仔	做梦梦到猪崽
来月经可以运动	来月经可以运动
哺乳期可以喝酸奶吗	哺乳期可以和酸奶吗
华为什么手机实用	华为什么手机适用
图片水印怎么去掉	图片水印怎么去掉
我是不是马云	我是不是马云
植物神经紊乱可以自愈	植物神经紊乱可以自愈
国产皮鞋品牌排行	国产皮鞋品牌排行
慢性浅表性胃炎的症状	慢性浅表性胃炎的政状
生理期能喝茶吗	生理期能和茶吗
打呼噜是怎么回事	打呼噜事怎么回事
怎么取消淘宝待付款	怎么取消淘宝带付款
怀孕能吃牛肉吗	怀孕能吃牛肉妈
一百八十加一百八十	一百八十加一百八十
坐月子可以吃藕粉	坐月子可以吃藕粉
你会吹牛逼	你会吹牛逼
百香果的功效	百香果得功效
乌鸡白凤丸的功效与作用	乌鸡白凤丸的工效与作用
有朋友	有朋友
血压低吃什么药好	血压地吃什么药好
怀孕可以吃芋头	怀孕可以吃芋头
湖洲到徐州高铁时刻表	湖州到徐州高铁时刻表
建行app改手机号	建行app改手机号
汗疱疹怎样根治	汗泡疹怎样根治
脑梗塞的症状有哪些	脑梗塞的症状有那些
经期能艾灸吗	经期能爱灸吗
你充电了吗	你充电了吗
我现在在什么位置	我现在在什么位置
零点一五化成分数	零点一五化成分数
月经期可以吃逍遥丸	月经期可以吃逍遥丸
鸡蛋能和菠萝一起吃吗	鸡蛋能和波萝一起吃吗
洛阳什么地方好玩	洛阳什么地方好玩
兰州汽车东站投诉电话	兰州汽车东站投诉电话
月经期可以敷面膜吗	月经期可以肤面膜吗
电脑看不了百度文库	电脑看不了百度文库
签订建设工程合同应遵循的原则	签订建设工程合同应遵循的原则
羊奶粉好还是牛奶粉好	养奶粉好还是牛奶粉好
孕妇可以打狂犬疫苗吗	孕妇可以大狂犬疫苗吗
怎么治口臭	怎么知口臭
流鼻涕打喷嚏是什么感冒	流鼻涕打喷涕是什么感冒
熬夜会导致月经推迟	熬夜会导致月经推迟
怎么查别人的通话记录	怎么茶别人的通话记录
surface的笔电池是什么型号	surface的笔电池是什么型号
打喷嚏流鼻涕吃什么药	打喷嚏留鼻涕吃什么药
老板扣押工资怎么办	老板扣压工资怎么办
单机游戏推荐	单击游戏推荐
孕妇能吃橙子	孕妇能吃橙子
浙江理工大学专业对选科的要求	浙江理工大学专业对选科的要求
开封阶梯电价收费标准	开封阶梯电价收费标准
珠海是哪个省的	珠海是哪个省的
三角函数四十度的正切值等多少	三角函数四十度的正切值等多少
朱一龙芈月转什么角色	薛一龙芈月转什么角色
广西有那些好的大专	广西有那些好的大专
移动好还是联通好	移动号还是联通好
脸上长斑是什么原因	脸上长斑是什么原因
直升飞机的样子作用和特点	直升飞机的样子作用和特点
皮肤瘙痒吃什么药	皮夫瘙痒吃什么药
陕西和四川有多远	山西和四川有多远
两对半是什么	两队半是什么
静安建交委地址	静安建交委地址
来月经可以喝豆浆吗	来月经可以和豆浆吗
二十年安徽公务员职位	二十年安徽公务员职位
荨麻疹不能吃什么	寻麻疹不能吃什么
大便时出血是怎么回事	大便是出血是怎么回事
借酒消愁的伤感句子	借酒消愁的伤感句子
扁桃体能切除	扁桃体能切除
尿频尿急是怎么回事	尿濒尿急是怎么回事
kn九十五的牌子	kn九十五的牌子
白馒头是酸性还是碱性	白馒头是酸性还是碱性
化疗和靶向药物治疗效果哪个好	化疗和靶向药物治疗效果哪个好
隐形矫正牙齿多少钱	隐性矫正牙齿多少钱
二十年重庆限购政策	二十年重庆限购政策
萨达姆是哪国的	撒达姆是哪国的
我的名字叫什么	我的名字叫什么
怎么绑鱼钩子线	怎么邦鱼钩子线
肺结核有什么症状	肺结核有什么症壮
孕妇可以吃乌梅	孕妇可以吃乌梅
数控车床子程序怎么编程	数控车床子程序怎么编程
蟑螂会咬人	蟑螂会咬人
乳腺增生吃什么药	乳线增生吃什么药
王慧演的电视剧	王智演的电视剧
男主姓唐女主姓温的小说	男主姓周女主姓温的小说
aabb式成语	aabb是成语
我爸叫什么	我爸叫什么
灰黄霉素的副作用	灰黄梅素的副作用
什么花的花语是阳光	什么花的花语是阳光
vivo手机来电拒接怎么取消	vivo手机来电拒绝怎么取消
乙肝携带者传染	乙肝携带者传染
丹拿二百三十二加功放跟不加功放	丹拿二百三十二加功放跟不加功放
重庆现有人口多少人	重庆现有人口多少人
上海建工集团属于什么性质	上海建工集团属于什么性质
唐筛多久可以拿结果	糖筛多久可以拿结果
经过一个角的顶点引这个角所在平面的斜线	经过一个角的顶点引这个角所在平面的斜线
蓝牙音箱什么牌子最好	蓝牙音响什么牌子最好
双侧卵巢多囊	双测卵巢多囊
身份证到期怎么坐飞机	身份证到期怎么做飞机
什么的波纹	什么得波纹
佛堂里能不能放活人的照片	佛堂里能不能放活人的照片
车架号是什么	车加号是什么
你是什么人	你是什么人
小儿扁桃体发炎吃什么药	小二扁桃体发炎吃什么药
男性性病怎么治	男性姓病怎么治
打电话给万总	打电话给陆总
包装设计的抄袭和借鉴界定	包装设计的抄袭和借鉴界定
北京属于哪个省	北京属于那个省
三维彩超什么时候做最好	三围彩超什么时候做最好
如何治疗抑郁症	如何治疗抑郁证
王浩源名字寓意	王浩宇名字寓意
膝盖能拔罐	膝盖能拔罐
无痛人流要多少钱	无通人流要多少钱
食言了是什么意思	失言了是什么意思
可以和我玩游戏	可以和我玩游戏
水痘症状图片	水逗症状图片
腿抽筋怎么办	腿抽筋怎么半
痛风可以吃芋艿	痛风可以吃芋艿
婚姻法有破坏家庭罪吗	婚姻法有破坏家庭罪吗
黄金瞳五感尽失结果	黄金瞳五感尽失结果
外阴瘙痒用什么药	外阴瘙痒用什么要
六十缸用多大的过滤桶	六十缸用多大的过滤桶
排卵期胸会胀痛	排卵期胸会胀痛
胃癌的早期症状是什么	胃癌的早起症状是什么
什么运动可以瘦肚子	什么运动可以收肚子
泡疹的症状	泡诊的症状
甲状腺结节	甲妆腺结节
郑州是属于哪个省	郑州是属于那个省
小鸟叼生日	小鸟刁生日
怀孕可以吃乳酸菌素片	怀孕可以吃乳酸菌素片
小孩几个月长牙	小孩几个月长呀
经常抽万宝路的爆珠会怎么样	经常抽万宝路的爆珠会怎么样
浙大学号	浙大学号
石家庄是几线城市	石家庄是几线成市
新生儿黄疸值多少正常	新生儿黄疸直多少正常
湿疹与痱子的区别	湿诊与痱子的区别
甲状腺球蛋白抗体高怎么办	甲状腺秋蛋白抗体高怎么办
便秘会导致痔疮	便秘会导致痔疮
应届大学毕业生找工作时应当最看重什么才能在工作中找到持久的动力	应届大学毕业生找工作时应当最看重什么才能在工作中找到持久的动力
小孩皮肤有红斑	小孩皮肤有红斑
胃疼还打嗝是怎么回事	胃疼还打隔是怎么回事
宝宝吃什么奶粉好	宝宝吃什麼奶粉好
什么是光子嫩肤	什么事光子嫩肤
沉香的功效与作用	沉香得功效与作用
六十岁能不能办银行卡	六十岁能不能办银行卡
人为什么要活着	人为什么要活着
林妙可和王可昕谁好看	林妙可和浦可昕谁好看
吉林花卉养殖基地	吉林花卉养殖基地
孕妇血糖高可以吃橙子	孕妇血糖高可以吃橙子
张婉婷拼音	张婷婷拼音
如何查询车辆违章	如何查讯车辆违章
剑灵副本里怎么开龙脉	剑灵副本里怎么开龙脉
苹果手机打开热点电脑连不上网怎么办	苹果手机打开热点电脑连不上网怎么办
孕妇可以吃土豆	孕妇可以吃土豆
大人最喜欢什么东西	大人最喜欢什么东西
胸闷胸痛怎么办	胸闷熊痛怎么办
生津止渴的食物蜂蜜	生津止渴的食物蜂蜜
咳嗽有黄痰吃什么药	咳嗽有黄谈吃什么药
高血压吃什么药	高学压吃什么药
睡觉老做梦是什么原因	睡觉老作梦是什么原因
三百除五十	三百除五十
肺结节是什么	肺接节是什么
怎么启动	怎么启动
打狂犬疫苗注意事项	大狂犬疫苗注意事项
桃花是什么颜色	桃花事什么颜色
nfc怎么开启	nfc怎么开启
川大基础医学怎么样	川大基础医学怎么样
李保田演过的全部电影	李保邱演过的全部电影
为什么每天早上肚子都不舒服	为什么每天早上肚子都不舒服
上吐下泻怎么回事	上吐下泄怎么回事
可以带发修行的寺庙	可以带发修行的寺庙
打嗝怎么治	打嗝怎么制
女孩第一次会怀孕	女孩第一次会怀孕
柠檬能减肥	柠檬能减肥
流产后可以喝红糖水吗	流产后可以和红糖水吗
对月贴怎么写	对月帖怎么写
吃完饭可以吃水果	吃完饭可以吃水果
生姜蜂蜜水能减肥吗	生姜蜂密水能减肥吗
怎么知道枸杞有没有被硫磺熏过	怎么知道枸杞有没有被硫磺熏过
怀孕肚子胀怎么回事	怀孕肚子涨怎么回事
天津哪儿卖电动缝纫机	天津哪儿卖电动缝纫机
你在思考什么	你在思考什么
招行信用卡怎么样	招行信用卡怎么养
蒋芳是哪里人	秦芳是哪里人
涿州翡翠华府最新房价	涿州翡翠华府最新房价
孕妇可以喝金银花茶吗	孕妇可以喝紧银花茶吗
经常放屁好不好	经长放屁好不好
耳朵里面有耳结怎么办	耳朵里面有耳节怎么办
靠近厨房的地板油烟怎么处理	靠近厨房的地板油烟怎么处理
尿量多黄是什么原因引起的	尿量多黄是什么原因引起的
贴膏药过敏怎么办	贴糕药过敏怎么办
二十年建行大额存单利率	二十年建行大额存单利率
达克宁治脚气吗	达客宁治脚气吗
你有性命吗	你有生命吗
空腹喝牛奶好吗	空服喝牛奶好吗
六十五乘十五的竖式	六十五乘十五的竖式
加味逍遥丸搭配什么药比较好	加味逍遥丸搭配什么药比较好
尿道感染是怎么引起的	尿道感染是怎么引起得
如何去除牙结石	如何去除牙洁石
慢性肾炎会遗传	慢性肾炎会遗传
三缸缺火是什么原因	三缸缺火是什么原因
排卵期肚子会痛	排卵期肚子会痛
发芽大蒜能吃	发芽大蒜能吃
你有没有哥哥	你有没有哥哥
王雅萱是谁	王雅慧是谁
你会说日语吗	你会说日语吗
怎样联系记者	怎样联系记着
赵洋名字能打多少分	刘洋名字能打多少分
小三阳能治好吗	小三阳能只好吗
肝硬化腹水严重应给予什么饮食	肝硬化腹水严重应给予什么饮食
慢性胃炎能治好	慢性胃炎能治好
腿酸是怎么回事	腿酸是怎么会事
尿毒症有什么症状	尿毒证有什么症状
新生儿打嗝怎么办	新生儿大嗝怎么办
尖锐湿疣如何治疗	尖锐湿尤如何治疗
喝奶茶失眠怎么办	和奶茶失眠怎么办
内分泌失调怎么检查	内分泌时调怎么检查
a五支不支持闪充	a五支不支持闪充
邓康熙字典多少画	宗康熙字典多少画
去看电影用英语怎么说	去看电影用英语怎么说
二十年没有车船税吗	二十年没有车船税吗
眼睛下面骨头疼	眼镜下面骨头疼
五十四除三	五十四除三
精索静脉曲张	精索静脉曲掌
什么的翅膀	什么的翅胖
太阳穴长痘痘是怎么回事	太阳血长痘痘是怎么回事
小勇用英语怎么说	小敏用英语怎么说
一边乳房痛	一遍乳房痛
鱼缸里睡莲的种植方法	鱼缸里睡莲的种植方法
如何培养孩子的自信	如何陪养孩子的自信
得了破伤风能治好吗	的了破伤风能治好吗
静脉曲张有哪些危害	静脉曲张有那些危害
二百乘二百	二百乘二百
回首掏出处	回手掏出处
经常打喷嚏是什么原因	经常打噴嚏是什么原因
肝癌可以治愈	肝癌可以治愈
我和春天有个约会上的王家声是谁饰演的	我和春天有个约会上的宁家声是谁饰演的
空腹可以吃葡萄	空腹可以吃葡萄
烂脚丫怎么治	烂觉丫怎么治
谢霆锋蔡卓妍主演电影	路霆锋蔡卓妍主演电影
脚掌脱皮是什么原因	脚长脱皮是什么原因
清理内存	清理内存
膝盖响怎么回事	希盖响怎么回事
设置语音唤醒	设置语音唤醒
静脉曲张吃什么药	静迈曲张吃什么药
before读什	before读什
肾结石痛	肾结石痛
麦芽精的功效与作用	卖芽精的功效与作用
减肥期间可以吃核桃吗	减肥期间可一吃核桃吗
电饼铛什么牌子的好	电饼挡什么牌子的好
中考四百分能上高中	中考四百分能上高中
李嘉诚和李嘉欣什么关系啊	李嘉诚和井嘉欣什么关系啊
哪里有免费电影	那里有免费电影
海曙可仁大药房电话	海曙可仁大药房电话
位于吴江区的	位于吴江区的
胃食管反流吃什么药	胃食馆反流吃什么药
怀孕能用化妆品	怀孕能用化妆品
孕妇能吃芥末	孕妇能吃芥末
唐嫣哪里人	唐嫣那里人
你叫我什么	你叫我什么
武汉文一云水湾附近的规划	武汉文一云水湾附近的规划
朋友送自己假口红怎么办	朋友送自己假口红怎么办
结石不能吃什么	节石不能吃什么
一直拉稀怎么回事	一只拉稀怎么回事
女生为主角的电视剧	女性为主角的电视剧
脱发怎么办	脱发怎么班
三月一是什么星座	三月一是什么星座
次氯酸钠与盐酸反应生成什么	次氯酸钠与盐酸反应生成什么
孕妇能用皮炎平	孕妇能用皮炎平
经营杠杆系数等一说明	经营杠杆系数等一说明
你怎么这么笨	你怎么这么笨
二零	二零
人流可以直接上环	人流可以直接上环
肺水肿严重	肺水肿严重
用香皂洗脸好	用香皂洗脸好
肝脾不和的症状	肝脾不合的症状
眼睛的英文是什么	眼镜的英文是什么
做玉米烙没有淀粉可以用糯米粉代替吗	做玉米烙没有淀粉可以用糯米粉代替吗
难以想象的意思	难以想像的意思
艾滋病的症状	艾滋病的政状
活血化瘀的食物有哪些	活血化瘀的食物有那些
女孩几岁开始乳房发育	女孩几岁开是乳房发育
李菁菁老公	秋菁菁老公
朝阳界限	朝阳界限
艾灸后多久可以洗澡	艾灸厚多久可以洗澡
赵本山有上春晚吗	赵本督有上春晚吗
心率快的原因	心律快的原因
感冒咳嗽可以吃蛋糕	感冒咳嗽可以吃蛋糕
网上怎么定汽车票	网上怎么顶汽车票
三十五乘三	三十五乘三
痛风能吃芋头	痛风能吃芋头
孩子吃羊奶大便干燥怎么办	孩子吃羊奶大便干燥怎么办
世界上最小的国家是哪个国家	世界上最小的国家是那个国家
范冰冰整容了吗	单冰冰整容了吗
坐月子可以吃红枣	坐月子可以吃红枣
头孢是抗生素吗	头孢事抗生素吗
手机怎么连上音响	手机怎么连上音箱
一千本金如何跟计划投	一千本金如何跟计划投
蓝色配什么颜色好看	蓝色佩什么颜色好看
一万公积金能贷款多少	一万公积金能代款多少
怀孕初期会头晕	怀孕初期会头晕
吕丽萍的老公是谁	董丽萍的老公是谁
书籍是人类进步的阶梯是谁说的	书记是人类进步的阶梯是谁说的
湖南大学那些专业比较好	湖南大学哪些专业比较好
尖锐湿疣怎么得的	尖锐湿疣怎么得得
喉咙痒咳嗽怎么办	候咙痒咳嗽怎么办
滑石粉能吃	滑石粉能吃
内分泌失调是什么症状	内分泌失调是什么证状
左旋肉碱减肥有用	左旋肉碱减肥有用
三十乘五	三十乘五
十除零点四	四除零点四
ace两刷新率	ace两刷新率
来月经吃什么菜好	来月经吃什么才好
碳水化合物食物有哪些	碳水化合物食物有那些
南京属于哪里	南京属于那里
我国的四大发明是什么	我国的四大发名是什么
王健林哪里人	王福林哪里人
世上最小的国家	史上最小的国家
湿气重吃什么药	湿汽重吃什么药
梦见吃橘子	梦见吃桔子
什么门永远关不上呢	什么门永远关不上呢
胰腺是什么	遗腺是什么
莲耦怎么做才好吃	莲藕怎么做才好吃
麦哲伦做出的贡献	麦哲伦作出的贡献
血管性头痛吃什么药	血官性头痛吃什么药
正弦余弦函数最大值最小值	正弦余弦函数最大值最小值
哺乳期能喝大麦茶吗	哺乳期能和大麦茶吗
张家晨名字打分	张家华名字打分
能帮我打王者吗	能帮我打王者吗
支付宝如何解绑手机号	支付宝如何解邦手机号
胃炎可以喝红糖水吗	胃炎可以和红糖水吗
燃气初装费	燃气出装费
脾虚吃什么	脾虚吃什药
世界上最帅的男人是谁呀	世界上最帅的男人是谁呀
最早的地理学著作是什么记录了我国古代地理历史民族神话生物水利等诸多方面内	最早的地理学著作是什么记录了我国古代地理历史民族神话生物水利等诸多方面内
来月经能吃葡萄	来月经能吃葡萄
尖锐湿疣症状	尖锐湿尤症状
近义词的四字成语	近义词的四字成语
晚上咳的厉害是怎么回事	晚上咳得厉害是怎么回事
今天适合运动吗	今天适合运动吗
三七粉上火	三七粉上火
心肌缺血的症状	心肌缺血的证状
打完hpv九价可以吃辣吗	打完hpv九价可以吃辣吗
a加b的六次方	a加b的六次方
哺乳期可以吃薏米	哺乳期可以吃薏米
缩阴产品有用	缩阴产品有用
胰腺炎的症状是什么	胰腺炎的证状是什么
扁桃体发炎吃什么药	变桃体发炎吃什么药
药典规定制备注射用水的方法是	药典规定制备注射用水的方法是
吉林被称为什么药材之乡	吉林被称为什么药材之乡
五月十日是什么星座	五月四日是什么星座
月经推迟二十天正常吗	月经退迟二十天正常吗
你的工作是什么	你的工作是什么
最近老放屁怎么回事	最近老放屁怎么会事
德牧怕冷	德牧怕冷
七十八乘六	七十八乘六
屈原的千古名句是什么激励一代	屈原的千古名句是什么激励一代
哺乳期可以吃甘草片	哺乳期可以吃甘草片
慢性咽炎的症状	慢性咽炎的证状
做完人流可以敷面膜	做完人流可以敷面膜
你这啥意思	你这啥意思
可以找公司代缴社保吗	可以找公司代交社保吗
小腹坠痛外阴瘙痒	小腹坠疼外阴瘙痒
迷你世界蘑菇怎么繁殖	迷你世界磨菇怎么繁殖
小儿积食会发烧	小儿积食会发烧
小说主角叶枫	小说主角林枫
减肥期间不能吃什么	减肥其间不能吃什么
指甲上有竖纹是怎么回事	指甲上有竖文是怎么回事
鹤城小学排名	鹤城小学排名
宝宝拉肚子能吃酸奶	宝宝拉肚子能吃酸奶
大便带血是怎么回事	大变带血是怎么回事
左脑缺血灶的最好治疗方法	左脑缺血灶的最好治疗方法
感冒能喝啤酒	感冒能喝啤酒
企业帐户怎么开通	企业账户怎么开通
中暑会拉肚子吗	中暑会啦肚子吗
哺乳期可以喝板蓝根	哺乳期可以喝板蓝根
富爸爸穷爸爸作者破产	富爸爸穷爸爸作者破产
尿道疼痛是什么原因	尿道疼痛是甚么原因
修正带坏了怎么修	修整带坏了怎么修
今天阴历几号	今天阴里几号
李鸿章的外交政策	荣鸿章的外交政策
哺乳期可以吃绿豆汤	哺乳期可以吃绿豆汤
名牌裤子有哪些	明牌裤子有哪些
老烂腿怎么治	老兰腿怎么治
做月子可以吃螃蟹	做月子可以吃螃蟹
虚幻缥缈的意思	虚幻飘渺的意思
太阳穴长痘怎么回事	太阳学长痘怎么回事
例假期间可以艾灸	例假期间可以艾灸
大姨妈可以喝大麦茶	大姨妈可以喝大麦茶
华罗庚是什么样的人	华莘庚是什么样的人
拔智齿脸会变小	拔智齿脸会变小
宫腔积液吃什么药	宫腔积夜吃什么药
带状疱疹会自愈吗	带状泡疹会自愈吗
拉肚子可以喂母乳	拉肚子可以喂母乳
中能瑞通科技有限公司怎么样	中能瑞通科技有限公司怎么样
眼睛流泪怎么治	眼睛流泪怎么制
月经干净后几天是安全期	月经干经后几天是安全期
牙齿有裂纹怎么办	牙齿又裂纹怎么办
小狗拉稀带血	小狗拉西带血
鲁班发明了什么	鲁康发明了什么
黑枸杞有什么作用	黑狗杞有什么作用
手机听不到声音	手机听不到声音
刺激性物质存在于洋葱细胞的什么中	刺激性物质存在于洋葱细胞的什么中
大拇指腱鞘炎的治疗	大姆指腱鞘炎的治疗
怎样去除老年斑	怎样去除老年版
怎么买电影票	怎么卖电影票
尿酸高有什么危害	尿酸高又什么危害
什么是癔症	什么事癔症
如何祛草莓印	如何去草莓印
满城尽带黄金甲在哪儿拍的	满城尽带黄金甲在哪儿拍的
春回大地风光好下联	春回大地风光好下联
涨肚子怎么办	胀肚子怎么办
腰间盘突出能练瑜伽	腰间盘突出能练瑜伽
拉肚子会头晕	拉肚子会头晕
颈椎痛怎么缓解	劲椎痛怎么缓解
胃病能治好	胃病能治好
近视眼贴有用	近视眼贴有用
感冒鼻塞吃什么好得快	感冒鼻塞吃什么好的快
艾滋病多久可以查出来	爱滋病多久可以查出来
坐骨神经痛吃什么药	坐骨神精痛吃什么药
万国上海维修地址	万国上海维修地址
白蛋白的作用是什么	白蛋白的做用是什么
辛姥姥是个怎么样的人	文姥姥是个怎么样的人
david会变身成哪种动物	david会变身成哪种动物
百家姓有姓未的吗	百家姓有姓唯的吗
哺乳期能吃奥美拉唑	哺乳期能吃奥美拉唑
梦见自己生孩子	梦见自几生孩子
什么是神经性尿频	什么是神精性尿频
孕妇可以吃草莓	孕妇可以吃草莓
肾积水怎么办	肾几水怎么办
有一只公鸡用什么成语来形容	有一只公鸡用什么成语来形容
梅毒检查有一项是阳性	梅毒检查有一项是阳性
怎样教宝宝说话	怎样交宝宝说话
小孩出水痘怎么办	小孩出水逗怎么办
蓝牙耳机没有充电头怎么充电	蓝牙耳机没有充电头怎么充电
心脏供血不足吃什么药	心赃供血不足吃什么药
月经来可以汗蒸	月经来可以汗蒸
r十七pro后盖价格	r十七pro后盖价格
拉屎拉不出来怎么办	拉屎拉不出来怎么半
打开计算机	打开计算机
你是美女还是帅哥	你是美女还是帅哥
我普通话不标准	我普通话不标准
北京海军大院地址	北京海军大院地址
榴莲吃了上火	榴莲吃了上火
哺乳期可以吃田螺	哺乳期可以吃田螺
宁波储能中学好不好	宁波储能中学好不好
你喜欢玩什么游戏	你喜欢玩什么游戏
跑步能减肥吗	跑不能减肥吗
脖子后面长痘	脖子后面张痘
灰指甲传染	灰指甲传染
扁桃体发炎能吃杨梅	扁桃体发炎能吃杨梅
艾滋病的症状有哪些	爱滋病的症状有哪些
你这是什么歌	你这是什么歌
现在该干嘛	现在该干嘛
率土之滨三赛季九级地难度表	率土之滨三赛季九级地难度表
黄明多少岁	范明多少岁
孕妇可以吃紫薯	孕妇可以吃紫薯
汗蒸完多久可以洗澡	汉蒸完多久可以洗澡
一百八十乘二十五	一百八十乘二十五
黑咖啡可以减肥	黑咖啡可以减肥
有胃病能喝酸奶	有胃病能喝酸奶
小动物怎么过冬歌曲	小动物怎么过冬歌曲
现在做什么小吃赚钱	现在坐什么小吃赚钱
厦大到鼓浪屿	厦大到鼓浪屿
两m的网速	两m的网速
背诵有什么好处	背诵有什么好处
华为十点八寸的平板多少厘米	华为十点八寸的平板多少厘米
痛风能吃虾皮	痛风能吃虾皮
还有多少天	还有多少天
硅胶奶瓶好	硅胶奶瓶好
脖子疼怎么缓解	脖子痒怎么缓解
剖腹产坐月子注意事项	剖腹产做月子注意事项
怎么去螨虫	怎么去满虫
十堰最好玩的地方	十堰最好玩的地方
中国的一号病人是谁	中国的一号病人是谁
十五乘四十二	十五乘四十二
周星星是男生还是女生	冷星星是男生还是女生
灰指甲传染吗	灰之甲传染吗
安乐片是安眠药吗	安了片是安眠药吗
怀孕可以喝豆腐脑	怀孕可以喝豆腐脑
人为什么会梦游	认为什么会梦游
脚趾头痒是怎么回事	脚指头痒是怎么回事
用日语说	用日语说
小说三要素及其作用	小说三要素及其作用
神经性头痛怎么治疗	神经性头通怎么治疗
两月二十七日是什么星座	两月二十七日是什么星坐
菱形块怎么切	菱形快怎么切
大便黑是怎么回事	大便黒是怎么回事
山西应急厅厅长	陕西应急厅厅长
盐城盛产盐吗	盐城生产盐吗
双色球什么时候开奖	双色球什么时候开讲
开塞露怎么用	开赛露怎么用
嘴唇像枪舌头像剑形容争辩激烈	嘴唇像枪舌头像剑形容争辩激烈
蒸汽机谁发明的	蒸器机谁发明的
我嫁给你好不好	我嫁给你好不好
如何戴假发	如何带假发
西宁西川南路在哪个区	西宁西川南路在哪个区
世界又变得大了起来是什么歌	世界又变的大了起来是什么歌
半年工作总结结束语	半年工作总结结束语
lol登陆不进去	lol登录不进去
支付宝账户可以注销	支付宝账户可以注销
龙珠传奇皇上当乞丐是哪一集	龙珠传奇皇上当乞丐是哪一集
k七支持红外线吗	k七支持红外线吗
宁波医保卡使用范围	宁波医保卡使用范围
属龙女五月生好不好	属龙女五月生好不好
尿道炎吃什么药	尿到炎吃什么药
一点五除二	一点五除二
湿疹可以吃苦瓜	湿疹可以吃苦瓜
项目资本金比例规定	项目资本金比例规定
大同道路运输管理处电话	大同道路运输管理处电话
慢性胃炎怎么调理	慢行胃炎怎么调理
一毫巴等多少帕斯卡	一毫巴等多少帕斯卡
大乐透什么时候开奖	大乐头什么时候开奖
阿长与山海经滴主要内容是什么	阿长与山海经的主要内容是什么
梭子蟹孕妇能吃	梭子蟹孕妇能吃
你是机器人吗	你是机器人吗
你的新房在哪里	你的新房在哪里
北京的区号	背京的区号
降血糖食物	降雪糖食物
湿热体质怎么调理	湿热体制怎么调理
橘子是什么季节的水果	桔子是什么季节的水果
租房都有哪些网站	租房都有那些网站
消费者权益保护宣传标语	消费者权益保护宣传标语
怎么种白萝卜	怎么种白罗卜
半边头痛是怎么回事	办边头痛是怎么回事
评价一下肖战	评价一下肖战
回来吧大叔结局	回来把大叔结局
大连大学排名	大连大学排名
江苏副主任医师考试时间	江苏副主任医师考试时间
华润万家属于国企吗	华润万家属于国企吗
膝盖痛怎么回事	膝盖痛怎么会事
三点双眼皮是永久的	三点双眼皮是永久的
家长不要对着孩子数一百二十三	家长不要对着孩子数一百二十三
骨裂和骨折的区别	股裂和骨折的区别
简单又漂亮的小熊怎么画	简单又漂亮的小熊怎么画
如何注销微信号	如何注销微信好
姬存希精华水和修复精华的区别	姬存希精华水和修复精华的区别
感冒对体检有影响	感冒对体检有影响
支付宝怎么赚钱给别人	支付宝怎么传钱给别人
胖的男人夏天怎么穿合适	胖的男人夏天怎么穿合适
河南有几个地市	河南有几个地市
脚气水泡怎么治疗	脚气水疱怎么治疗
你怎么还不睡	你怎么还不睡
dc家居是品牌吗	dc家具是品牌吗
四肢麻木是什么病	四只麻木是什么病
押韵的八字口号	押韵的八字口号
女性更年期年龄	女姓更年期年龄
糖尿病人能吃南瓜吗	唐尿病人能吃南瓜吗
飞行棋游戏规则图解	飞行棋游戏规则图解
周星星是男生还是女生	韦星星是男生还是女生
喝酒影响月经	喝酒影响月经
西瓜工会排名	西瓜公会排名
慢性胃炎可以喝蜂蜜	慢性胃炎可以喝蜂蜜
口臭怎么办	口臭怎么半
上海公章网上备案流程	上海公章网上备案流程
宋庆龄哪里人	宋美龄哪里人
多根网线同时接一个猫	多根网线同时接一个猫
斐林试剂能鉴定淀粉吗	斐林试剂能鉴定淀粉吗
天津安全员证在哪里报考	天津安全员证在哪里报考
来月经能吃辣	来月经能吃辣
脚后跟疼是什么原因	脚后跟疼是什么愿因
经常胃胀是什么原因	经常胃帐是什么原因
来例假能喝中药	来历假能喝中药
梦到自己被狗咬	梦到自己备狗咬
赵薇女儿叫什么	戚薇女儿叫什么
怎样关闭豪华黄钻自动续费	怎样关闭豪华黄钻自动续费
于震演过的电视剧	陈震演过的电视剧
新生儿能喝葡萄糖	新生儿能喝葡萄糖
无痛人流怎么样恢复快	无痛人流怎么样恢复快
人流手术后能吃小龙虾吗	人流手术后能吃小龙虾吗
牛黄上清片的功效与作用	牛黄上青片的功效与作用
悲恸近义词	悲痛近义词
五十除十	五十除十
一百九十二点一百六十八点三点一登录不了	一百九十二点一百六十八点三点一登陆不了
早上空腹可以吃苹果吗	早上空复可以吃苹果吗
失眠怎么办	失眠怎麼办
小葱素馅饺子怎么做	小葱素馅饺子怎么做
白蜂蜡和小烛树蜡的区别	白蜂蜡和小烛树蜡的区别
宝宝十个月发烧手脚冰凉怎么回事	宝宝十个月发烧手脚冰凉怎么回事
什么不什么手成语有哪些	什么不什么手成语有哪些
血小板高是白血病	血小板高是白血病
徐州到宿州火车票	徐州到宿州火车票
希戈艺术学校学费多少	希戈艺术学校学费多少
孕妇可以吃辣椒	孕妇可以吃辣椒
狐臭遗传	狐臭遗传
氯化钠是不是生理盐水	录化钠是不是生理盐水
你会打嗝吗	你会打嗝吗
怀孕初期可以吃大蒜	怀孕初期可以吃大蒜
绿豆解药吗	绿豆接药吗
药品怎么读	药品怎么卖
蟑螂会咬人吗	蟑螂回咬人吗
拉肚子可以喝茶吗	啦肚子可以喝茶吗
远志的功效与作用	远制的功效与作用
倒瓜子脸适合什么发型	到瓜子脸适合什么发型
脚痒脱皮怎么办	脚氧脱皮怎么办
孕妇可以吃香菇	孕妇可以吃香菇
晚上做恶梦是什么原因	晚上坐恶梦是什么原因
黑枸杞功效与作用	黑苟杞功效与作用
支气管哮喘	支气官哮喘
一活到老学到老老不服老画亦精字亦精两处处飞花飞处处	一活到老学到老老不服老画亦精字亦精两处处飞花飞处处
为什么坐车脚会肿	为什么座车脚会肿
心脏主要由什么细胞构成	心脏主要有什么细胞构成
可乐鸡翅怎么做	可乐鸡翅怎么做
星座解释用的什么定律	星座解释用的什么定律
狗狗能吃棒冰	狗狗能吃棒冰
蜂蜜对胃好	蜂蜜对胃好
月经期可以运动	月经期可以运动
小儿脾胃虚弱怎么调理	小二脾胃虚弱怎么调理
婴儿眼睛红	婴儿眼镜红
糖尿病人能喝玉米粥	糖尿病人能喝玉米粥
脂肪肝可以买健康险吗	脂肪肝可以买健康险吗
激光能去雀斑	激光能去雀斑
药物代谢动力学的名词解释	药物代谢动力学的名词解释
吉普指南者轮胎品牌	吉普指南者轮胎品牌
肚子胀胀的怎么回事	肚子涨涨的怎么回事
南阳有几个县区	南阳有几个县区
怀孕初期会腰疼吗	怀孕初期回腰疼吗
手掌上出现红色血斑点	手掌上出现红色血斑点
荣耀v二十换非原装屏可以吗	荣耀v二十换非原装屏可以吗
太原南中环属于哪个区	太原南中环属于哪个区
高蛋白食物有哪些	高蛋百食物有哪些
四十八乘三	四十八乘三
孔子老师是谁	木子老师是谁
如何用黏土自制起泡胶	如何用粘土自制起泡胶
每天大便三次正常	每天大便三次正常
oppowatch如何录音	oppowatch如何录音
你的创造人是谁	你的创造人是谁
引产有多痛	引产有多疼
双麦降噪的	双麦降噪的
零除零等几	零除零等几
眼睛混浊是什么原因	眼睛浑浊是什么原因
怎么预防膝盖滑膜炎	怎么预防膝盖滑膜炎
怎么去除狐臭	怎麼去除狐臭
止痛药的副作用	止痛药得副作用
朱开山是哪个地方的人	朱开须是哪个地方的人
来月经能吃阿胶	来月经能吃阿胶
流清鼻涕吃什么药	留清鼻涕吃什么药
李子吃多了会胖	李子吃多了会胖
哺乳期能拔智齿	哺乳期能拔智齿
孕妇能吃冰淇淋	孕妇能吃冰淇淋
给娃喂奶可以吃香菜木耳吗	给娃喂奶可以吃香菜木耳吗
怎样快速瘦脸	怎样快速受脸
月经来了可以吃榴莲	月经来了可以吃榴莲
为什么老是拉肚子	为什么老是啦肚子
喝牛奶腹泻	和牛奶腹泻
和乙肝患者共用碗筷会传染吗	和乙肝患者公用碗筷会传染吗
张开凤结婚了吗	张玉凤结婚了吗
不亦乐乎中的通假字	不亦说乎中的通假字
会不会有雨	会不会有雨
经期能吃羊肉	经期能吃羊肉
孕妇能吃石榴	孕妇能吃石榴
舌头有裂纹是怎么回事	舌头有列纹是怎么回事
你是中国人吗	你是中国人吗
哺乳期可以喝可乐雪碧	哺乳期可以喝可乐雪碧
十七乘十七	十七乘十七
叫什么名字	叫什么名字
月经期间可以洗澡吗	月经其间可以洗澡吗
元曲四大家之首是谁	元曲四大家之手是谁
我国的陆上邻国中面积最大的是什么人口最多的是什么	我国的陆上邻国中面积最大的是什么人口最多的是什么
霍金得的是什么病	霍金的的是什么病
来月经能喝茶	来月经能喝茶
新生婴儿睡觉时抽搐	新生婴儿睡觉时抽搐
小脚趾骨折	小脚指骨折
佳木斯是哪个省的	佳木斯是那个省的
宝宝一直流鼻涕怎么办	宝宝一直留鼻涕怎么办
肝功能挂什么科	肝工能挂什么科
豆芽发芽了还能吃	豆芽发芽了还能吃
四十七乘十五	四十七乘十五
痛风能吃生蚝吗	通风能吃生蚝吗
三十六加三十六	三十六加三十六
咽炎会咳嗽吗	咽炎会咳嗽妈
有什么好看的电影	有什么好看的电影
胆囊炎能吃鸭蛋	胆囊炎能吃鸭蛋
七十除二	七十除二
明天的天气怎么样	明天的天气怎么样
从国内寄快递到伦敦多少钱	从国内寄快递到伦敦多少钱
英语日常用语	英语日常用于
人工客服在哪里	人工客服在哪里
农行pos刷卡限额	农行pos刷卡限额
你喜欢杨紫吗	你喜欢杨紫吗
凡尔赛体系形成的过程	凡尔赛体系形成的过程
男孩子起什么名字好听	男孩子启什么名字好听
正确佩戴口罩的方式	正确配戴口罩的方式
杨宇轩名字怎么样	张宇轩名字怎么样
生理期可以拔牙	生理期可以拔牙
脸上肉多适合做什么紧致项目	脸上肉多适合做什么紧致项目
今天天气怎么样啊	今天天气怎么样啊
乌市八路公交车路线图	乌市八路公交车路线图
打嗝怎么治	大嗝怎么治
红斑狼疮会痒	红斑狼疮会痒
猫妈妈为什么不管小猫	猫妈妈为什么不管小猫
华为无线路由如何恢复出厂设置	华为无线路由如何恢复出厂设置
痛风能吃南瓜	痛风能吃南瓜
甲状腺手术后多久恢复	甲状腺手术后多久回复
吃红糖会发胖吗	吃红唐会发胖吗
毕业论文署名怎么写	毕业论文署名怎么写
平安车险和人保车险哪个好	平安车险和人保车险那个好
适合老年人玩的手机单机游戏	适合老年人玩的手机单机游戏
博美能吃橘子吗	博美能吃桔子吗
孕妇可以吃黄花菜	孕妇可以吃黄花菜
支气管炎吃什么药好	直气管炎吃什么药好
自制凉皮为啥会炸口	自制凉皮为啥会炸口
六月黄道吉日	六月黄道吉日
你会说方言吗	你会说方言吗
招行如何定期转活期	招行如何定期转活期
荣耀日历怎么设置生日提醒	荣耀日历怎么设置生日提醒
糖醋里脊怎么做	糖错里脊怎么做
脑部核磁共振多少钱	脑步核磁共振多少钱
针灸的原理是什么	针灸得原理是什么
红薯长芽了还能吃吗	红署长芽了还能吃吗
古天乐的所有代言品牌	卢天乐的所有代言品牌
种植牙的费用	种植牙得费用
张晨这个名字怎么样	叶晨这个名字怎么样
明天多少度啊	明天多少度啊
什么时候放暑假	什么时侯放暑假
胃不好能喝红茶吗	胃不好能和红茶吗
感冒会拉肚子吗	感冒回拉肚子吗
胃糜烂有哪些症状	胃糜烂有那些症状
梅尼埃病是什么病	梅尼挨病是什么病
输尿管上段结石	输尿管上端结石
月经第一天恶心头晕乏力	月经第一天恶心头晕乏力
高考历史第一次世界大战时间	高考历史第一次世界大战时间
希腊属于哪个州	希腊属于那个州
经期能喝玫瑰花茶	经期能喝玫瑰花茶
充电器坏了怎么办	充电器坏了怎么办
预防近视要减少什么的摄入	预防近视要减少什么的摄入
现在移动办什么卡比较好	现在移动办什么卡比较好
孕妇能喝什么茶	孕妇能喝什麼茶
下划线昵称	下滑线昵称
阅读心电图的基本流程	阅读心电图的基本流程
胃不好可以吃桃胶	胃不好可以吃桃胶
不来月经垫卫生巾的坏处	不来月经垫卫生巾的坏处
孕妇能吃阿莫西林胶囊吗	孕妇能吃啊莫西林胶囊吗
含植物的成语	喊植物的成语
无锡高校有哪些	无锡高校有哪些
今天天气怎么样	今天天气怎么样
月经期间可以打消炎针吗	月经其间可以打消炎针吗
孕妇能吃茶叶蛋	孕妇能吃茶叶蛋
作信封的方法	做信封的方法
崩坏三开放世界等级	崩坏三开放世界等级
打了利凡诺要注意什么	打了利凡诺要注意什么
皮肤黄怎么变白	皮服黄怎么变白
水痘和疱疹的区别	水逗和疱疹的区别
雌激素是什么	雌激素事什么
手机划不动屏幕怎么办oppo	手机划不动屏幕怎么办oppo
平仓线一百三十是什么意思	平仓线一百三十是什么意思
还没回来	还没回来
西华师大有几个学院	西华师大有几个学院
喝完酒打哈欠睡不着怎么回事	喝完酒打哈欠睡不着怎么回事
请你写一句倡俭朴的宣传语	请你写一句倡俭朴的宣传语
陈德容在绝代双骄中演的谁	陈德苏在绝代双骄中演的谁
在proteus软件中晶振的名称是什么	在proteus软件中晶振的名称是什么
电动牙刷要用牙膏	电动牙刷要用牙膏
艾灸可以去湿气	艾灸可以去湿气
感冒可以吃榴莲	感冒可以吃榴莲
面膜过敏怎么办	面莫过敏怎么办
抖音里一个飞机折合人民币多少钱	抖音里一个飞机折合人民币多少钱
怀孕能吃鳝鱼	怀孕能吃鳝鱼
怎么去除黑眼圈	怎么去出黑眼圈
排卵期有几天	排卵期又几天
火柴人战争作者是谁	火柴人战争作者是谁
中山防疫政策	中山防疫政策
一百一十平房子喷漆大概需要多少	一百一十平房子喷漆大概需要多少
为什么会得霉菌性阴炎	为什么会的霉菌性阴炎
月经来了能洗头	月经来了能洗头
精神分列症可以痊愈吗	精神分裂症可以痊愈吗
一百八十乘五十	一百八十乘五十
梁下部有支座负筋吗	梁下部有支座负筋吗
怎么减小肚子	怎么剪小肚子
日元兑人民币汇率今日	日元对人民币汇率今日
宫颈糜烂有哪些症状	宫颈糜烂有那些症状
产妇能吃茄子	产妇能吃茄子
脚趾麻木是怎么回事	脚趾麻目是怎么回事
小孩流鼻涕打喷嚏怎么办	小孩留鼻涕打喷嚏怎么办
橘子的升糖指数	桔子的升糖指数
拉肚子可以吃蛋	拉肚子可以吃蛋
打开相册	打开相册
拉肚子可以打预防针吗	啦肚子可以打预防针吗
第一次一定会流血吗	第一次一定回流血吗
刘松年法什么意思	刘松乔法什么意思
大便出血怎么办	大便初血怎么办
洪学敏身高	洪学智身高
学习英语的软件	学习英语得软件
金色的阳光穿过树林改为比喻句	金色的阳光穿过树林改为比喻句
消防拴漏水	消防栓漏水
凌志nx三百报价	凌志rx三百报价
怀孕能喝咖啡吗	怀孕能和咖啡吗
注册公司需要u盾	注册公司需要u盾
戴牙套怎么刷牙	带牙套怎么刷牙
如何渡过奥德赛岁月	如何度过奥德赛岁月
找梁静茹情歌的歌词要完整版的	找昌静茹情歌的歌词要完整版的
孕妇可以喝茉莉绿茶	孕妇可以喝茉莉绿茶
新冠状病毒的症状头痛	新冠状病毒的症状头痛
福建海鲜米线的做法大全	福建海鲜米线的做法大全
大便频繁是怎么回事	大便频烦是怎么回事
为什么老露尿	为什么老漏尿
白癜风能吃竹笋	白癜风能吃竹笋
郑爽张翰结婚了	郑爽张翰结婚了
九十四年十月初八是什么命	九十四年十月初八是什么命
运城有那些县	运城有那些县
扁桃体发炎怎么办	扁桃体发炎怎么半
哮喘病的症状	哮喘病的证状
乌龟喜欢干沙子还是湿沙子	乌龟喜欢干沙子还是湿沙子
为什么抖音播放量是零	为什么抖音播放量是零
乳胶枕头有味道	乳胶枕头有味道
手机通讯录如何备份	手机通迅录如何备份
双相情感障碍有哪些临床表现	双向情感障碍有哪些临床表现
修丽可的护肤品怎么样	修丽可的护肤品怎么样
成吉思汗三技能怎么用	成吉思汗三技能怎么用
姨妈快没了但是又来了	姨妈快没了但是又来了
苹果手机如何把图片放到电脑上	苹果手机如何把图片放到电脑上
冼衣机多少瓦	洗衣机多少瓦
如何取得上海户籍	如何取得上海户籍
为什么生完孩子身体变宽了	为什么生完孩子身体变宽了
喝可乐有什么危害	和可乐有什么危害
甲状腺的症状有哪些	甲状腺的症状有那些
李小龙到底是怎么死的啊	古小龙到底是怎么死的啊
重庆渝南自来水客服电话	重庆渝南自来水客服电话
又人工服务吗	由人工服务吗
四米高的房子可以做阁楼吗	四米高的房子可以做阁楼吗
请问需要什么帮助	请问需要什么帮助
中华小子小龙被吸取青春是哪一集	中华小子小龙被吸取青春是哪一集
冰淇淋厂冬天做什么	冰淇淋厂冬天做什么
心里难受怎么办	心理难受怎么办
阑尾炎手术后吃什么好	兰尾炎手术后吃什么好
我爱你你爱我吗	我爱你你爱我吗
lol冲击之刃炫彩怎么得	lol冲击之刃炫彩怎么得
你可以唱一首歌吗	你可以唱一首歌吗
天津离静海区有多远	天津离静海区有多远
脑供血不足怎么办	脑供血不足怎么半
张卫健多高	张东健多高
腿疼是什么原因	腿疼是什么愿因
节育环什么时候取合适	节育环什么时候去合适
上古卷轴五拉罗夫在哪	上古卷轴五拉罗夫在哪
吃蜂蜜有什么好处	吃风蜜有什么好处
小腿肿是什么原因	小腿肿是什麼原因
怎么叠爱心	怎么碟爱心
x平方减x减一等零	x平方减x减一等零
武清杨村防疫站电话	武清杨村防疫站电话
怀孕初期腹痛正常	怀孕初期腹痛正常
乳腺肿块吃什么药	乳线肿块吃什么药
询盘三天内回复旺旺几小时内回复的算及时回复率	询盘三天内回复旺旺几小时内回复的算及时回复率
六十乘十五	六十乘十五
经常洗手液洗手手背上小疙瘩有点痒	经常洗手液洗手手背上小疙瘩有点痒
我现在在什么地方	我现在在什么地方
咳嗽可以吃牛排	咳嗽可以吃牛排
活血化瘀的药有哪些	活血化瘀的要有哪些
融创乐园里面有吃饭的地方吗	融创乐园里面有吃饭的地方吗
香港用地紧张其原因是人口怎么样和地形怎么样	香港用地紧张其原因是人口怎么样和地形怎么样
荨麻疹的有效治疗方法	寻麻疹的有效治疗方法
你会解梦吗	你会解梦吗
钟汉良结婚了啊	荀汉良结婚了啊
cad如何调线型	cad如何调线形
最难写的汉字	最难写的汉子
十月革命后以为代表的先进分子	十月革命后以为代表的先进分子
根骨二次手术后多久能走路	根骨二次手术后多久能走路
多利妈是什么药	多力妈是什么药
你叫什么	你叫什么
零点零一除零点一	零点零一除零点一
崔子是什么意思	柴子是什么意思
苦瓜的功效有哪些	苦瓜的功效有那些
还本销售缴纳增值税吗	还本销售缴纳增值税吗
宋庆龄的父亲	宋美龄的父亲
猫能吃鸡皮	猫能吃鸡皮
蚕豆病发病怎么治疗	蚕豆病发病怎么治疗
坐月子可以敷面膜吗	坐月子可以肤面膜吗
表示两者之间的介词	表示两者之间的介词
女性尿道口长好多肉芽	女性尿道口长好多肉牙
水浒传作者	谁浒传作者
快来月经体温会升高	快来月经体温会升高
陕西的挂壁公路在哪里	陕西的挂壁公路在哪里
荨麻疹可以吃红薯	荨麻疹可以吃红薯
前夫抚养费不给强制执行不了	前夫抚养费不给强制执行不了
护士未来职业生涯规划	护士未来职业生涯规划
医社保是什么意思	医社保是什么意思
净水器那个牌子好	净水气那个牌子好
吃土豆会发胖	吃土豆会发胖
国泰君安与银河比较	国泰君安与银河比较
艾滋病有治愈的	艾滋病有治愈的
深海鱼油的功效与作用	深海鱼尤的功效与作用
安眠药药店能买到	安眠药药店能买到
如何恢复视力	如何会复视力
王祖蓝扮演胖子那个是什么节目	王祖黄扮演胖子那个是什么节目
宝宝缺钙的表现	宝宝确钙的表现
支原体感染会传染	支原体感染会传染
嘉澍的拼音	刘澍的拼音
为什么热可以缓解疼痛	为什么热可以缓解疼痛
猫把爪子张开什么意思	猫把爪子张开什么意思
三角形的周长公式	三角形的周常公式
西葫芦怎么做好吃	西胡芦怎么做好吃
人为什么要睡觉	人为什么要谁觉
林冲是哪里人	林彬是哪里人
怀孕能吃大蒜	怀孕能吃大蒜
寿光摩托车驾驶证办理	寿光摩托车驾驶证办理
贾乃亮演唱追光者	鲍乃亮演唱追光者
验孕棒怎么看	验晕棒怎么看
肝不好的症状有哪些	干不好的症状有哪些
六味地黄丸哪个牌子好	六位地黄丸哪个牌子好
为什么会长智齿	为什么会章智齿
工行预授信额度怎么查	工行预授信额度怎么查
馒头怎么做	馒头怎麼做
心脏早搏如何治疗	心脏早博如何治疗
感冒能打疫苗	感冒能打疫苗
脚扭伤肿了怎么办	脚纽伤肿了怎么办
梦幻西游敏捷动物套哪个最好	梦幻西游敏捷动物套哪个最好
小米八换个内屏要多少钱	小米八换个内屏要多少钱
宝宝吃什么素菜好	宝宝吃什么蔬菜好
你长什么样	您长什么样
小叶增生可以喝豆浆	小叶增生可以喝豆浆
打嗝是什么原因引起的	大嗝是什么原因引起的
杨幂和刘恺威真的复合了吗	杨幂和刘凯威真的复合了吗
照片改背景颜色	照片该背景颜色
焊接后产生角变形的原因是	焊接后产生角变形的原因是
王俊凯的身高	王俊凯的身高
梦见已婚亲人再次结婚	梦见已婚亲人再次结婚
白癜风会传染吗	白殿风会传染吗
红霉素软膏含有激素	红霉素软膏含有激素
怎么炼劈叉	怎么练劈叉
儿童流鼻血是什么原因	儿童留鼻血是什么原因
一茶匙是多少毫升	一茶匙是多少毫升
痘坑痘印怎么修复	都坑痘印怎么修复
三个字的游戏名字情侣	三个字的游戏名字情侣
十到三十之间的合数	十到三十之间的和数
我跟你是什么关系	我跟你是什么关系
关于非洲的高分电影	关于非洲的高分电影
孕妇能做心电图	孕妇能做心电图
你是谁呀	你是谁呀
赛龙舟有哪些准备活动阳光计划	赛龙舟有哪些准备活动阳光计划
快乐男声李炜现在在干嘛	快乐男声李炜现在在干嘛
脑梗能吃海参	脑梗能吃海参
太阳穴长痘痘是怎么回事	太阳穴张痘痘是怎么回事
最近有什么好电影	最近又什么好电影
无线路由器怎么设置	无线露由器怎么设置
降尿酸的药有哪些	降尿酸的要有哪些
右肋骨下方疼痛是什么原因	有肋骨下方疼痛是什么原因
这个手机是oppoa几	这个手机是oppoa几
双肺纹理增多紊乱	双肺文理增多紊乱
电脑开不了机	点脑开不了机
怀孕多久有孕吐反应	怀孕多久有孕吐反映
大概在六七千年前在陶器上就能发现一些符号	大概在六七千年前在陶器上就能发现一些符号
洛克王国新手任务奖励宠物蛋是什么	洛克王国新手任务奖励宠物蛋是什么
吃中药可以吃芒果	吃中药可以吃芒果
背上长痘痘	辈上长痘痘
后背疼挂什么科	后备疼挂什么科
雅美居装修公司电话	雅美居装修公司电话
孕妇可以喝酸奶	孕妇可以喝酸奶
june两nd怎么读	june两nd怎么读
额头上长小疙瘩	额头上张小疙瘩
拉肚子可以吃火龙果	拉肚子可以吃火龙果
哺乳期可以吃李子吗	哺乳期可以吃李子妈
左下腹痛是什么原因	昨下腹痛是什么原因
喝头孢能喝酒吗	和头孢能喝酒吗
上海的特产	上海的特产
正弘国际小学好上吗	正弘国际小学好上吗
手脱皮是怎么回事	收脱皮是怎么回事
屏幕固定显示的概念	屏幕固定显示的概念
常州是属于哪个省	常州是属于那个省
ofree右耳升级失败	ofree右耳升级失败
小孩感冒流鼻涕吃什么药	小孩感冒留鼻涕吃什么药
甲状腺结节有什么症状	甲装腺结节有什么症状
你几年级毕业	你几年级毕业
李保田演过的全部电影	李保沙演过的全部电影
白酒加公牛是什么意思	白酒加公牛是什么意思
降尿酸的药有哪些	降尿酸的药有那些
三点一四乘六十四	三点一四乘六十四
胆固醇高能吃鸡蛋	胆固醇高能吃鸡蛋
王羲之是哪个朝代的人	王献之是哪个朝代的人
眼睛有红血丝怎么回事	眼精有红血丝怎么回事
狗狗能吃橘子	狗狗能吃橘子
为什么没有网	为什么没有网
来大姨妈能喝酒吗	来大姨吗能喝酒吗
中国哪个男明星最帅	中国那个男明星最帅
不是不是	不是不是
如何有效祛除蟑螂	如何有效去除蟑螂
如何去皱纹	如何去皱问
一般拔牙之后要痛几小时	一般拔牙之后要痛几小时
什么蔬菜的根好吃	什么蔬菜的跟好吃
微信怎么删除好友	微信怎么珊除好友
身份证照片能贷款	身份证照片能贷款
刘晓燕哪里人	刘晓佴哪里人
指南针是哪个国家发明的	指南针是那个国家发明的
治咳嗽的水果	治咳嗽得水果
oppo最新款	oppo最新款
喝啤酒上火吗	和啤酒上火吗
什么食物含锌	什么实物含锌
月经突然提前六天怎么回事	月经突然提前六天怎么回事
肚子大怎么减	肚子打怎么减
李菁菁老公	卫菁菁老公
你会些什么	你会些什么
慢性肝病传染	慢性肝病传染
中石化优惠时间	中石化优惠时间
宋祖儿今年几岁	容祖儿今年几岁
对于卫律和李陵的劝降苏武的回答在措辞和态度上有什么不同	对于卫律和李陵的劝降苏武的回答在措辞和态度上有什么不同
骨髓移植活得最长的人	骨髓移植活的最长的人
农行招聘咨询电话	农行招聘咨询电话
明代有哪些诗人及作品	明代有哪些诗人及作品
八乘九	八乘九
小腹胀痛是怎么回事	小腹长痛是怎么回事
慢性胃炎能吃苹果	慢性胃炎能吃苹果
怀孕痔疮肉球怎么办	怀孕痔疮肉球怎么办
怀孕多久可以查出男女	怀孕多久可以差出男女
国标凹凸面法兰标准	国标凹凸面法兰标准
喝蜂蜜水减肥吗	和蜂蜜水减肥吗
降血糖食物	降血糖事物
听得到我说话	听得到我说话
支付宝里的小程序怎么做	支付宝里的小程序怎么做
广州服装批发市场的工资大概多少	广州服装批发市场的工资大概多少
喉咙滤泡增生怎么办	喉咙虑泡增生怎么办
大拇指甲有竖纹是怎么回事	大姆指甲有竖纹是怎么回事
偏头痛是什么原因	翩头痛是什么原因
韩庚的女朋友是谁	邱庚的女朋友是谁
如何加快手机充电	如何加快手机充电
最小公倍数怎么求	最小公倍数怎么球
面包里面可以包什么馅	面包里面可以包什么馅
嗖一圈安全吗选择导师安娜	嗖一圈安全吗选择导师安娜
中国古代的文房四宝是什么	中国古代的文防四宝是什么
吃完避孕药多久可以吃东西	吃玩避孕药多久可以吃东西
怀孕初期可以吃火鸡面	怀孕初期可以吃火鸡面
厦门哪个医院做胆结石手术比较好	厦门哪个医院做胆结石手术比较好
华为手机反差色怎么调回来	华为手机反差色怎么调回来
人参归脾丸和归脾丸有什么区别	人参鬼脾丸和归脾丸有什么区别
再生障碍性贫血能治愈吗	在生障碍性贫血能治愈吗
左下腹痛是怎么回事	左下复痛是怎么回事
唾液可以传播艾滋病吗	唾液可以传播爱滋病吗
什么是超声心动图	什么是超生心动图
阑尾炎在哪个位置	兰尾炎在哪个位置
坐骨结节滑囊炎的症状	坐股结节滑囊炎的症状
甲状腺病传染吗	甲壮腺病传染吗
盆腔积液是怎么引起的	喷腔积液是怎么引起的
我可以帮你改名字吗	我可以帮你改名字吗
今天的天气怎么样	今天的天气怎么样
孕妇可以吃红薯粉	孕妇可以吃红薯粉
血糖偏高怎么办	血唐偏高怎么办
摄像头二百万和一千零八十p哪个好	摄像头二百万和一千零八十p哪个好
手被辣椒辣了怎么办	手被辣椒辣了怎么半
腿部肌肉疼痛怎么办	腿部机肉疼痛怎么办
上火能吃橙子	上火能吃橙子
保护环境的标语	报护环境的标语
西瓜皮可以生吃	西瓜皮可以生吃
月经期间可以喝中药	月经期间可以喝中药
梦见自己的亲姨妈死了	梦见自己的亲姨妈死了
农村医保可以补交	农村医保可以补交
导函数大于等零说明什么	导函数大于等零说明什么
otg连接的功能	otg连接的功能
你有什么技能	你有什么技能
小孩腿抽筋	小孩退抽筋
高血糖吃什么水果	高雪糖吃什么水果
九乘九	九乘九
你喜不喜欢旅游	你喜不喜欢旅游
有关法医和解剖的电视剧	有关法医和解剖的电视剧
脚底长鸡眼	脚底张鸡眼
江苏治疗肿瘤的医院排名	江苏治疗肿瘤的医院排名
葡萄糖分解成丙酮酸是什么反应	葡萄糖分解成丙酮酸是什么反应
分开用英语短语怎么说part	分开用英语短语怎么说part
月经期能喝柠檬水吗	月经期能喝宁檬水吗
孕妇可以吃白萝卜	孕妇可以吃白萝卜
静脉曲张早期症状	静脉曲张早起症状
来月经可以吃乌鸡白凤丸	来月经可以吃乌鸡白凤丸
怀孕初期能吃榴莲	怀孕初期能吃榴莲
生理期可以吃菠萝吗	生理期可以吃波萝吗
哺乳期可以喝酵素	哺乳期可以喝酵素
血糖高吃什么水果	学糖高吃什么水果
脸上毛孔大怎么办	脸上毛空大怎么办
dj一般说什	dj一般说什
怀孕能吃鲍鱼	怀孕能吃鲍鱼
三万七千一百三十二身份证是哪里的	三万七千一百三十二身份证是哪里的
孕妇喝什么牛奶好	孕妇和什么牛奶好
香蕉和酸奶可以一起吃吗	香焦和酸奶可以一起吃吗
南京哪家医院治疗白癜风效果最好	南京哪家医院治疗白癜风效果最好
感冒能吃葡萄	感冒能吃葡萄
高蛋白食物有哪些	高蛋白食物有那些
你的偶像是谁	你的偶像是谁
得了肾炎怎么办	的了肾炎怎么办
怎么把胸变大	怎么把熊变大
二十年应用心理学考研国家线	二十年应用心理学考研国家线
明日之后建筑怎么回收	明日之后建筑怎么回收
工行免费电话	工行免费电话
无痛人流真的不痛	无痛人流真的不痛
便秘会便血	便秘会便血
三点五十六化成分数	三点五十六化成分数
臀部疼痛是什么原因	屯部疼痛是什么原因
上海闯红灯一次保费上浮吗	上海闯红灯一次保费上浮吗
神经衰弱有哪些症状	神经衰弱有那些症状
肾囊肿是什么	肾馕肿是什么
石狮到万载的长途汽车	石狮到万载的长途汽车
南开学院是几本	南开学院是几本
伤口化脓怎么处理	伤口化浓怎么处理
心情烦躁不安怎么办	心情烦燥不安怎么办
牧马人英文名英文单词	牧马人英文名英文单词
眼睛红血丝怎么回事	眼镜红血丝怎么回事
怎么加好友不让他知道我是谁	怎么加好友不让他知道我是谁
康乃馨送花一般送几朵	康乃馨送花一般送几朵
广电是不是国企	广电是不是国企
经期能喝茶吗	经期能喝茶马
人性有哪些弱点可以被利用	人性有哪些弱点可以被利用
人流后可以喝红糖水	人流后可以喝红糖水
心脏病的早期症状有哪些	心脏病的早期症状有那些
农行最大股东是谁	农行最大股东是谁
龟头炎的症状	龟头炎的证状
chin是什么意思中文翻译	chin是什么意思中文翻译
怀孕能喝茶水吗	怀孕能和茶水吗
郑州到烟台快递多少钱	郑州到烟台快递多少钱
怀孕多久孕吐	怀孕多久晕吐
蓝牙耳机怎么唤醒小布	蓝牙耳机怎么唤醒小布
张晓勇是谁	陈晓勇是谁
怎么登录腾讯会员	怎么登入腾讯会员
孕妇可以拔罐吗	孕妇可以拔罐妈
尿酸高能吃生蚝	尿酸高能吃生蚝
安徽中考变化	安徽中考变化
有关徐福的电影	有关徐郎的电影
孕妇吃什么补血	孕妇吃什么不血
泡脚可以去湿气	泡脚可以去湿气
狗狗拉稀出血怎么办	狗狗拉稀出血怎么办
南州是什么地方	南洲是什么地方
如何锻炼腰腹力量	如何锻练腰腹力量
你的声音可以大一点吗	你的声音可以大一点吗
怎么知道自己是什么原因引起的肥胖	怎么知道自己是什么原因引起的肥胖
美国流感是什么时间	美国流感是什么时间
十三画属木的繁体字	十三画属木的繁体字
肾结石可以吃橘子	肾结石可以吃橘子
输卵管积水可以怀孕	输卵管积水可以怀孕
液晶王tv九百九十设置不了	液晶王tv九百九十设置不了
蔓越莓的功效与作用	蔓越莓得功效与作用
林俊杰的女友到底是谁	庞俊杰的女友到底是谁
慢性胃炎可以吃苹果吗	漫性胃炎可以吃苹果吗
九百除三	九百除三
鱼刺卡在喉咙怎么办	鱼刺恰在喉咙怎么办
肺部结节严重吗	肺布结节严重吗
唐国强广告词	唐国佴广告词
瘦颧骨手术多少钱张笑天	瘦颧骨手术多少钱张笑天
感冒能吃芒果	感冒能吃芒果
视频转换动图的软件	视频转换动图的软件
吃苦瓜减肥	吃苦瓜减肥
设置充电提示音	设置充电提示音
刚怀孕小肚子会疼	刚怀孕小肚子会疼
经常腹泻是什么原因	经常复泻是什么原因
在哪里学宠物美容	在那里学宠物美容
右边腰疼是什么原因	右边要疼是什么原因
怎么不唱歌了	怎么不唱歌了
常德有哪些厂招工	常德有哪些厂招工
咳嗽可以吃冰淇淋	咳嗽可以吃冰淇淋
梦见抓到甲鱼又放生是什么意思	梦见抓到甲鱼又放生是什么意思
微信图片打印机怎么打印	微信图片打印机怎么打印
喝什么降血糖	喝什么将血糖
塔吊六级风停止作业哪个规范	塔吊六级风停止作业哪个规范
雷锋祭日是哪天	桓锋祭日是哪天
胃疼喝蜂蜜水有用吗	胃疼和蜂蜜水有用吗
芒果吃多了会上火吗	茫果吃多了会上火吗
黄浦是富人区	黄浦是富人区
福建宣传语	福建宣传语
甲状腺结节	甲状腺结洁
来月经喝姜糖水好吗	来月经喝姜汤水好吗
吃鸡铂金一上面是什么段位	吃鸡铂金一上面是什么段位
小三阳会传染吗	小三阳会转染吗
四十二除六	四十二除六
例假期间可以按摩	例假期间可以按摩
月经期可以泡脚	月经期可以泡脚
哺乳期吃什么好	捕乳期吃什么好
产妇可以吃橙子	产妇可以吃橙子
大连三十六中和四十八中哪个好	大连三十六中和四十八中哪个好
计量经济学的应用包括哪几方面	计量经济学的应用包括哪几方面
长春搬家公司哪家好	长春搬家公司那家好
语法分为哪两个部分	语法分为哪两个部分
太原康复机构天使比较好	太原康复机构天使比较好
李牧是哪里人	李铁是哪里人
早春呈水部张十八员外属于律诗还是绝句	早春呈水部张十八员外属于律诗还是绝句
坐月子可以吃车厘子	坐月子可以吃车厘子
身上长红痣是怎么回事	身上张红痣是怎么回事
刘禹锡字是什么什么朝代的组名诗人	刘洪锡字是什么什么朝代的组名诗人
妊娠纹是什么	妊深纹是什么
你是男是女	你是男是女
郑成功是怎么收复宝岛台湾的	鲍成功是怎么收复宝岛台湾的
哪些人不适合吃蜂蜜	那些人不适合吃蜂蜜
过敏性鼻炎可以根治	过敏性鼻炎可以根治
喉咙有痰怎么办	喉咙有痰怎么半
怀孕可以吃橙子	怀孕可以吃橙子
你是哪个学校毕业的	你是哪个学校毕业的
脚浮肿怎么办	脚俘肿怎么办
世卫组织的作用	世卫组织的作用
空腹可以吃香蕉	空腹可以吃香蕉
怎么注册微信账号	怎么注册微信帐号
天麻的功效与作用	天麻的功效与做用
五年级十一班用英语怎么说	五年级十一班用英语怎么说
肺上有个瘤子怎么治	肺上有个瘤子怎么治
考瓷牙多少钱一颗	烤瓷牙多少钱一颗
胰腺炎可以吃雪糕	胰腺炎可以吃雪糕
杨幂的老公叫什么名字	杨佩的老公叫什么名字
敷完面膜需要洗脸	敷完面膜需要洗脸
甲状腺结节有什么症状	甲状腺结接有什么症状
三七是田七	三七是田七
打嗝放屁是怎么回事	大嗝放屁是怎么回事
怎么下载手机银行	怎么下栽手机银行
脂肪肝可以当兵	脂肪肝可以当兵
哺乳期能贴膏药吗	哺乳期能帖膏药吗
维生素b是什么	卫生素b是什么
皮肤过敏痒怎么办	皮服过敏痒怎么办
盐酸普萘洛尔片的作用	盐酸普奈洛尔片的作用
血液粘稠吃什么药	血液沾稠吃什么药
来月经可以吃叶酸	来月经可以吃叶酸
陈情令的粉丝名是什么	陈情令的粉丝名是什么
给周周打电话	给周建打电话
慢性胃炎怎么调理	漫性胃炎怎么调理
三角形的面积	三角形的面积
一个男人爱你的表现	一个男人爱你得表现
牙齿疼怎么办	芽齿疼怎么办
怎么查询个人档案	怎么查寻个人档案
有矮脚基因的长脚猫	有矮脚基因的长脚猫
你认识小威吗	你认识小威吗
哺乳期感冒可以喂奶	哺乳期感冒可以喂奶
脖子涨痛是怎么回事	脖子胀痛是怎么回事
胃病会传染吗	胃病会传染吗
我生日是多少	我生日是多少
小三挑事还如何处理	小三挑事还如何处理
王健林哪里人	王建林哪里人
我明天几点上班	我明天几点上班
你叫什么名字来着	你叫什么名字来着
你叫什么呀	你叫什么呀
大便解不出来怎么办	大便接不出来怎么办
网商贷怎么没有额度了	网商贷怎么没有额度了
心率不齐的危害是什么	心律不齐的危害是什么
小孩长痱子怎么办	小孩涨痱子怎么办
怀孕后一个月吃什么好	怀孕后一个月吃什么好
皮肤过敏能用牙膏擦吗	皮肤过敏能用牙膏擦吗
建行定期利息	建行定期利息
什么是腔梗	什么是呛梗
零除零	零除零
ace两是否支持反向无线充电	ace两是否支持反向无线充电
面瘫怎样按摩	面滩怎样按摩
长水豆能洗澡吗	长水逗能洗澡吗
身上长水泡是怎么回事	身上张水泡是怎么回事
糟糕的近义词是什	糟糕的近义词是什
红薯长芽了还能吃	红薯长芽了还能吃
孕早期尿黄	孕早起尿黄
乙肝有哪些症状	艺肝有哪些症状
龙岩开学时间二千零二十	龙岩开学时间二千零二十
节日前面的the要不要大写	节日前面的the要不要大写
心理医生哪里有	心理医生那里有
厦门地理位置	厦门地里位置
胸闷气短是怎么回事	凶闷气短是怎么回事
血压一百四十正常	血压一百四十正常
深基坑和浅基坑的区别	深基坑和浅基坑的区别
该怎么办	该怎么办
如何注册微信号	如和注册微信号
圣骑士技能	圣骑士技能
孕妇能吃阿奇霉素片	孕妇能吃阿奇霉素片
奥美拉唑是饭前吃还是饭后吃	奥美拉唑是饭钱吃还是饭后吃
我的手机号码是多少	我的手机号码是多少
怀孕流褐色血	怀孕留褐色血
写保护的u盘	写保护的u盘
你的爸爸是谁	你的爸爸是谁
红塔山香烟哪里有买的	红塔山香烟哪里有卖的
抗过敏药吃了会过敏吗	抗过敏药吃了会过敏吗
李华是什么朝代	李党是什么朝代
打开输入法	打开输入法
李敏镐头发是什么颜色	房敏镐头发是什么颜色
你妈叫什么名字	你妈叫什么名字
伏曦是哪里人	夏曦是哪里人
支付宝二维码发微信里怎么扫码	支付宝二维码发微信里怎么扫码
高铁股票有哪些	高铁股票有那些
芒果可以空腹吃	芒果可以空腹吃
鼻窦炎的症状有哪些	鼻窦炎得症状有哪些
郭明义被称为是什么的优秀传承者	郭袁义被称为是什么的优秀传承者
公民参与政治生活的基本要求是什么	公民参与政治生活的基本要求是什么
婴儿退烧药有哪些	婴儿退烧药有那些
孕妇可以吃生蚝吗	孕妇可以吃生蚝妈
怎么不合适	怎么不合适
王洋的丈夫是谁	龙洋的丈夫是谁
大便不成形的原因	大变不成形的原因
脚长水泡怎么办	脚涨水泡怎么办
我不是这个意思	我不是这个意思
乙肝小三阳传染	乙肝小三阳传染
怀孕初期吃什么好	坏孕初期吃什么好
电热水器哪个牌子好	店热水器哪个牌子好
眼睛下面长脂肪粒	眼睛下面涨脂肪粒
月经过后几天可以取环	月经过后几天可以去环
病毒性感冒怎么好的快	病毒性感冒怎么好得快
支付宝通讯物流怎么关	支付宝通讯物流怎么关
肝不好吃什么	肝不好吃什药
女生要怎么动	女性要怎么动
催月经来的方法	崔月经来的方法
花斑癣会传染吗	花班癣会传染吗
乙肝小三阳会传染吗	乙干小三阳会传染吗
怀孕胸会变大	怀孕胸会变大
孕妇可以吃烤地瓜	孕妇可以吃烤地瓜
男生头发怎么长的快	男生头发怎么长得快
浅滋暗长的意思	潜滋暗长的意思
龙舟的身体是什么颜色的	龙舟的身体是什么颜色的
恶心想吐是怎么回事	饿心想吐是怎么回事
蚕豆病可以吃荷兰豆	蚕豆病可以吃荷兰豆
古人背景怎么画	古人背影怎么画
九百一十除十四	九百一十除十四
痛风能吃甲鱼	痛风能吃甲鱼
焦虑症的症状	焦虑症的症壮
哺乳期可以吃马齿苋	哺乳期可以吃马齿苋
被狗咬了怎么办	备狗咬了怎么办
连接wifi的软件	连接wifi的软件
哪里批发服装最便宜	那里批发服装最便宜
苹果手机怎么设置来电铃声	平果手机怎么设置来电铃声
嗓子有痰怎么办	嗓子又痰怎么办
已有社保异地还可以交吗	已有社保异地还可以交吗
乔楚生最后怎么样了	乔计生最后怎么样了
你喜欢我哪里啊	你喜欢我哪里啊
来例假可以拔牙吗	来历假可以拔牙吗
新剑魔台词	老剑魔台词
吃避孕药还会怀孕吗	吃避孕要还会怀孕吗
涪陵旅游景点	涪陵旅游景点
明日之后料理包会不会掉落	明日之后料理包会不会掉落
逍遥在人间叹尘世妄言绝千恋什么意思	逍遥在人间叹尘世妄言绝千恋什么意思
阴虚火旺吃什么药	阴虚火望吃什么药
g七十三可以用半径补偿吗	g七十三可以用半径补偿吗
根据词语的不同意思造句	跟据词语的不同意思造句
青霉素和头孢那个好	青霉素和头孢哪个好
剖腹产第三天吃什么好	剖腹产第三天吃什么好
打开小游戏	打开小游戏
精油可以去痘印	精油可以去痘印
乳腺增生严重吗	乳腺曾生严重吗
放了三个月的烟还能抽吗	放了三个月的烟还能抽吗
心率不齐怎么办	心律不齐怎么办
外面有什	外面有什
零点一r五乘零点八	零点一r五乘零点八
青岛是哪个省的省会	青岛是哪个省的省会
三围是哪三围	三位是哪三围
经期可以拔牙	经期可以拔牙
儿童可以喝蜂蜜水	儿童可以喝蜂蜜水
荣威rx五有一键升窗功能吗	荣威rx五有一键升窗功能吗
吸奶器可以开奶	吸奶器可以开奶
肠胃炎可以喝蜂蜜水	肠胃炎可以喝蜂蜜水
小涵兼职账号如何解封	小涵兼职账号如何解封
乳房疼痛有哪些情况	乳房疼痛有哪些情况
做完双眼皮注意事项	做玩双眼皮注意事项
有什么好看又有点污的漫画	有什么好看又有点污的漫画
痛风可以吃薯片吗	通风可以吃薯片吗
吃中药能喝牛奶	吃中药能喝牛奶
杜甫资料简介	孔甫资料简介
荨麻疹是什么症状	荨麻诊是什么症状
圆锥体积的公式是什么	圆锥体积的公式是什么
你知道什么事	你知道什么事
什么时候开学	神么时候开学
世界上真的有龙	世界上真的有龙
做血管造影要多少钱	作血管造影要多少钱
黄体酮和地屈孕酮片的区别	黄体酮和地区孕酮片的区别
静脉曲张怎么治	静迈曲张怎么治
空腹可以喝柠檬蜂蜜水吗	空复可以喝柠檬蜂蜜水吗
什么的枫叶	什么得枫叶
怀孕初期白带多是怎么回事	怀孕出期白带多是怎么回事
郑爽张翰结婚了吗	郑爽萧翰结婚了吗
盆腔炎吃什么药	盆腔严吃什么药
艾灸盒怎么用	艾久盒怎么用
怀孕了还会来月经吗	怀孕了还回来月经吗
如何去除法令纹	如何去除法另纹
怀孕初期症状	怀孕初七症状
我今天长得帅吗	我今天长得帅吗
手机进水了	手机进水了
房子防水物业保修多长时间	房子防水物业保修多长时间
甲亢会传染吗	甲亢会转染吗
红霉素眼膏可以涂嘴唇吗	红梅素眼膏可以涂嘴唇吗
榴莲的果子可以吃吗	榴莲的果子可以吃吗
腰椎间盘突出正确睡姿	腰椎间盘突出正确睡资
老是拉肚子是怎么回事	老是垃肚子是怎么回事
我的世界怎么防蜘蛛	我的世界怎么放蜘蛛
月经期间可以喝首乌吗	月经期间可以喝首乌吗
爸爸妈妈是谁	爸爸妈妈是谁
姜子牙多大年龄得子	姜子牙多大年龄得子
仓鼠可以吃水果	仓鼠可以吃水果
王健林哪里人	王健林那里人
咱们聪明	咱们聪明
哪个网站买书便宜	哪个网站卖书便宜
肝脏的功能	肝脏得功能
结扎手术多少钱	接扎手术多少钱
券养的意思	劵养的意思
哺乳期可以吃党参	哺乳期可以吃党参
眼霜的作用	眼霜得作用
例假肚子疼	历假肚子疼
九年的二手车能卖多少	九年的二手车能卖多少
一万除一万	一万除一万
糖尿病患者可以喝豆浆吗	糖尿病患者可以和豆浆吗
爱普生进纸传感器在哪	爱普生进纸传感器在哪
打车会传染冠状病毒吗	打车会传染冠状病毒吗
指甲出现竖纹是什么原因	指甲出现竖文是什么原因
十和十五用短除法计算	四和十五用短除法计算
唐嫣哪里人	唐岩哪里人
葡萄的功效	葡萄的公效
吃橘子上火吗	吃桔子上火吗
眼皮肿了怎么办	眼皮肿了怎么半
狗可以吃冰棒	狗可以吃冰棒
刘亚的拼音	刘娅的拼音
肾衰竭能治好	肾衰竭能治好
减肥期间能吃茼蒿吗	减肥期间能吃茼蒿吗
马克思主义哲学考研排名	马克思主义哲学考研排名
林志玲和言承旭为什么分手	林志玲和赏承旭为什么分手
邳州属于哪个市	邳州属于哪个市
小孩心肌酶高怎么办	小孩心机酶高怎么办
西湖邮政编码	西湖邮政编码
做什么生意最赚钱	作什么生意最赚钱
怀孕可以吃苹果	怀孕可以吃苹果
经期前体温会升高	经期前体温会升高
枣仁安神胶囊的功效与作用	枣仁安神胶囊的功效与作用
韩国化妆品有哪些品牌	韩国化妆品有那些品牌
涤纶面料裤子夏天穿会不会热	涤纶面料裤子夏天穿会不会热
两个乘数的末尾共有两个零积的末尾至少有两个零	两个乘数的末尾共有两个零积的末尾至少有两个零
一平方等多少吨	一平方等多少吨
张晨这个名字怎么样	于晨这个名字怎么样
没有户口本怎么迁户口	没有户口本怎么签户口
揉腹部的正确方法	揉腹补的正确方法
黑芝麻的功效与作用	嘿芝麻的功效与作用
血压过低是什么原因	血压过第是什么原因
肚子咕噜咕噜响	肚子咕噜咕噜想
excel工作表sheet排序	excel工作表sheet排序
正常人心率	正常人心律
小孩能吃冰淇淋	小孩能吃冰淇淋
系统性红斑狼疮	系统性红斑琅疮
南开文学院复试名单	南开文学院复试名单
皮肤病血毒丸的药理解析	皮肤病血毒丸的药理解析
小孩几岁换牙	小骇几岁换牙
为什么老被别人拉黑	为什么老被别人拉黑
经常打嗝是什么病	经常打隔是什么病
怎么锻炼背部肌肉	怎么锻练背部肌肉
你认识伊丽莎吗	你认识伊兰莎吗
一岁宝宝拉肚子吃什么药	一岁宝宝垃肚子吃什么药
枸杞泡水喝有什么好处	苟杞泡水喝有什么好处
插头正确接线方式图解	插头正确接线方式图解
检查尿常规多少钱	检查尿长规多少钱
武则天原籍是哪里	常则天原籍是哪里
三月是什么节气	三月是什么节气
国内航班要护照	国内航班要护照
云南哪里可以捡到玉石	云南哪里可以捡到宝石
怎么在微信上卖东西	怎么在微信上买东西
绵阳哪里好玩	绵阳哪里好玩
一岁宝宝可以吃榴莲	一岁宝宝可以吃榴莲
怎么挽回生意上的老客户	怎么挽回生意上的老客户
肠梗阻怎么治疗	肠耿阻怎么治疗
紧张血压会高	紧张血压会高
cad制图倒圆角怎么画	cad制图倒圆角怎么画
哺乳期能吃鸽子	哺乳期能吃鸽子
三十九乘三	三十九乘三
成都建行周末上班	成都建行周末上班
怀孕拉肚子怎么办	怀孕垃肚子怎么办
吴桥杂技大世界门票	吴桥杂技大世界门票
怎么煎鱼不粘锅	怎么剑鱼不粘锅
感冒喉咙痛吃什么药好	感冒吼咙痛吃什么药好
蜗牛是昆虫吗	蜗牛事昆虫吗
强直脊柱炎吃什么水果好	强直脊柱炎吃什么水果好
北京女性平均身高	北京女性平均身高
大便不成形是什么原因	打便不成形是什么原因
沈跃沈是哪里人	沈跃跃是哪里人
肚脐眼痛是怎么回事	肚齐眼痛是怎么回事
四个月泰迪吃什么牌子狗粮	四个月泰迪吃什么牌子狗粮
小学如何做好学困生转化工作	小学如何做好学困生转化工作
心率不齐怎么办	心率不气怎么办
oppo手环回复微信消息	oppo手环回复微信消息
打电话给李斯	打电话给李璐
补气血的药有哪些	补气血的药有那些
怀孕可以吃豆芽	怀孕可以吃豆芽
什么食物含叶酸	什么食物喊叶酸
你的希望是什么	你的希望是什么
六十四乘九	六十四乘九
工程院和科学院的区别	工程院和科学院的区别
怎么测怀孕	怎么册怀孕
容易怀孕	容易怀孕
直角的符号读作什么	直角的符号读作什么
跟地下城与勇士类似的手游	跟地下城与勇士类似的手游
经期能吃菠萝蜜吗	经期能吃菠萝密吗
两周岁宝宝耳温多少正常	两周岁宝宝耳温多少正常
嘴角痒脱皮发黑是怎么回事	嘴角痒脱皮发黑是怎么回事
破腹产后腹胀怎么办	剖腹产后腹胀怎么办
真分数和假分数	真分数和贾分数
湛江有什么好玩的	湛江有什么好玩的
三十六乘九	三十六乘九
周杰伦钢琴曲	路杰伦钢琴曲
哺乳期能吃松花蛋	哺乳期能吃松花蛋
日文怎么说	日文怎么说
肠胃不好怎么调理	肠胃不好怎么调里
胃里反酸水	胃里范酸水
你父母在哪儿	你父母在哪儿
迪达斯的标志	迪达斯的标志
如何退出登录	如何退出登录
面对面建群怎么拉人进来	面对面建群怎么拉人进来
怎样会导致不孕	怎样会导至不孕
一型糖尿病和二型糖尿病的区别	一性糖尿病和二型糖尿病的区别
胃不好能喝茶叶吗	胃不好能和茶叶吗
一千加一千	一千加一千
月子可以吃桃子吗	月子可以吃桃子妈
输卵管积液是怎么回事	输卵管积液是怎么会事
九价疫苗影响怀孕吗	九价疫苗影响怀孕吗
打耳洞疼吗	大耳洞疼吗
电蚊香对孕妇有影响吗	电文香对孕妇有影响吗
血小板低是怎么回事	血小版低是怎么回事
大拇指指甲凹凸不平是怎么回事	大母指指甲凹凸不平是怎么回事
孕妇可以喝可乐	孕妇可以喝可乐
做四维彩超的最佳时间	做四围彩超的最佳时间
花呗是不是自动还款	花呗是不是自动还款
阜阳办理健康证的地方在哪里	阜阳办理健康证的地方在哪里
身上长猴子是什么原因	身上张猴子是什么原因
肾结石可以吃豆制品	肾结石可以吃豆制品
朦拼音带组词	蒙拼音带组词
成长守护平台怎么转人工	成长守护平台怎么转人工
手被油烫了怎么办	手背油烫了怎么办
会计人员应根据什么及有关资料编制记账凭证	会计人员应根据什么及有关资料编制记账凭证
下奶的食物有哪些	下奶的实物有哪些
我应该叫你什么	我应该叫你什么
陈字偏旁是什么	陈字边旁是什么
诸葛亮的儿子是谁	诸葛瞻的儿子是谁
帮我找找	帮我找找
艾滋病的传播途径有哪些	艾滋病得传播途径有哪些
下腹痛怎么回事	下复痛怎么回事
喝水可以治疗感冒吗	喝水可以治疗感冒吗
巫师三怎么离开水井	巫师三怎么离开水井
喉咙痛流鼻涕吃什么药	喉咙痛留鼻涕吃什么药
心血管堵塞	心学管堵塞
你喜欢我吗	你喜欢我吗
内痔有什么症状	内痔有什么证状
微信转账多久到账	微信转帐多久到账
血糖高能喝蜂蜜水吗	雪糖高能喝蜂蜜水吗
打饱嗝是什么原因	打饱隔是什么原因
东莞苹果官方售后维修点	东莞苹果官方售后维修点
经期可以吃芒果吗	经起可以吃芒果吗
甲状腺结节怎么治	甲状腺结节怎么制
方便面会胖吗	方便面回胖吗
郑州哪里买衣服性价比高	郑州哪里买衣服性价比高
苹果云端在哪里登录	苹果云端在哪里登陆
工行社会招聘条件	工行社会招聘条件
孝感哪个厂工资高	孝感那个厂工资高
怎么找对象	怎么找对象
南方人属于什么人种	南方人属于什么人种
抑郁症怎么治疗	意郁症怎么治疗
耳朵嗡嗡响怎么办	耳朵嗡嗡想怎么办
母乳期可以喝红酒	母乳期可以喝红酒
脸长的女生适合什么发型	脸长得女生适合什么发型
白癜风会遗传吗	白店风会遗传吗
手麻是怎么回事	手麻是怎么会事
艾滋病唾液传染	艾滋病唾液传染
做个没心没肺的人多好	做个没心没肺的人多好
交感神经型颈椎病症状	交感神经型颈椎病证状
白癜风能根治	白癜风能根治
怀孕能用花露水	怀孕能用花露水
专业人员的培训费计入什么费用	专业人员的培训费计入什么费用
积分在哪里兑换	积分在哪里兑换
我是你的头号粉丝用英语怎么说	我是你的头号粉丝用英语怎么说
保安族有多少人	保安组有多少人
刘涛和李小冉合作的电视剧	刘涛和李小冉合作的电视剧
孕妇能吃橘子吗	孕妇能吃桔子吗
苹果手机怎么设置来电铃声	苹果手机怎么设置来点铃声
丰胸的食物和水果	丰胸得食物和水果
男人对你说无语我该怎么回	男人对你说无语我该怎么回
电子烟对身体有害吗	电子烟队身体有害吗
人的正常体温	人的正尝体温
肚子胀是什么原因	肚子帐是什么原因
幸运飞艇微信群那里有天香威三百三十九万一千八百四十一	幸运飞艇微信群那里有天香威三百三十九万一千八百四十一
女主角叫苏橙的小说	女主角叫苏沫的小说
新生儿打嗝怎么办	心生儿打嗝怎么办
形容亲密写出与手有关的成语	形容亲密写出与手有关的成语
包皮过长手术要多少钱	保皮过长手术要多少钱
希腊属于哪个州	希腊属于哪个洲
运动可以减肥	运动可以减肥
你会唱少年吗	你会唱少年吗
打完瘦脸针可以喝酒吗	大完瘦脸针可以喝酒吗
庞太师是什么职位	华太师是什么职位
蓝莓酱要熬多长时间	蓝莓酱要熬多长时间
农行忘记卡号怎么办	农行忘记卡号怎么办
长春看妇科病的医院	长春看妇科病的医院
巴楚到达喀什要隔离吗	巴楚到达喀什要隔离吗
减肥药有哪些危害	减肥药有那些危害
三尖瓣轻度返流是什么意思	三尖瓣轻度反流是什么意思
在家干嘛呢	在家干嘛呢
具有泻而不藏的特点的是	具有泻而不藏的特点的是
摩托车可以上高速公路	摩托车可以上高速公路
是啥意思	是啥意思
张韶涵的音域有多宽	张米涵的音域有多宽
怎么减肚子上的赘肉	怎么见肚子上的赘肉
吃雪糕的声音	吃雪糕的声音
猜我现在在干嘛	猜我现在在干嘛
天花是水痘	天花是水痘
什么是心脏早搏	什么是心脏早博
白癜风能治愈吗	白店风能治愈吗
老是放臭屁是怎么回事	老是防臭屁是怎么回事
仰卧起坐能减肚子	仰卧起坐能减肚子
离职和自离有什么后果	离职和自离有什么后果
手上起小水泡是怎么回事	手上起小水疱是怎么回事
怀孕能吃冷面	怀孕能吃冷面
胸口闷怎么回事	胸口闷怎么会事
司马迁名言	司马衷名言
男生怎么样可以把自己的声音变好听	男生怎么样可以把自己的声音变好听
天津台球厅营业了吗	天津台球厅营业了吗
来月经时腰疼	来月经是腰疼
中国最穷的县	中国最穷得县
ccdi深圳分公司怎么样	ccdi深圳分公司怎么样
带状疱疹看什么科	带状疱诊看什么科
支付宝如何充值	支付宝如何冲值
白化病是遗传病	白化病是遗传病
颗粒剂首选的黏合剂是	颗粒剂首选的粘合剂是
糖尿病早期症状	糖尿病早期症壮
拔罐起水泡是什么原因	拔罐七水泡是什么原因
心急吃不了热豆腐	心极吃不了热豆腐
检查乙肝需要空腹	检查乙肝需要空腹
适合酸性水养的观赏鱼	适合酸性水养的观赏鱼
不完全履行合同定金怎么算	不完全履行合同定金怎么算
福建到台湾有多少公里	福建到台湾有多少公里
心率正常范围	心律正常范围
卡超级加倍什么意思	卡超级加倍什么意思
四百二十除六	四百二十除六
经期可以喝红酒吗	经期可以何红酒吗
你什么都知道吗	你什么都知道吗
开封东风小康四s店电话	开封东风小康四s店电话
四氧化三铁与盐酸反应	四氧化三铁于盐酸反应
什么是康复治疗	什么是康复制疗
研究生期间算工龄	研究生期间算工龄
k五如何长截图	k五如何长截图
胆汁反流性胃炎的症状	胆汁返流性胃炎的症状
磨砂玻璃开灯外面能看到里面吗	磨砂玻璃开灯外面能看到里面吗
上环后注意事项	上环后主意事项
脂肪肝是什么症状	脂肪肝是什么证状
精索静脉曲张的症状	精锁静脉曲张的症状
坐骨神经痛看什么科	座骨神经痛看什么科
子宫切除有什么影响	自宫切除有什么影响
肾结石可以吃豆芽	肾结石可以吃豆芽
html超链接格式	html超链接格式
一岁宝宝呕吐	一岁宝宝欧吐
怀孕能吃香蕉	怀孕能吃香蕉
甲减是什么病	胛减是什么病
人机怎么不加信誉积分	人机怎么不加信誉积分
二十除几等十	二十除几等四
学生什么时候放假	学生什么时侯放假
肾阴虚吃什么药	身阴虚吃什么药
妇炎洁孕妇可以洗	妇炎洁孕妇可以洗
脚跟痛是什么原因	脚根痛是什么原因
智能手机怎么用	知能手机怎么用
绝经前的症状	绝经前的证状
玻尿酸多少钱一只	玻尿酸多少钱一直
哺乳期可以吃茄子吗	哺乳起可以吃茄子吗
李牧是哪里人	李瑶是哪里人
肩膀种花为什么会有疤	肩膀种花为什么会有疤
张雨涵的英语怎么写	张韶涵的英语怎么写
新生儿拉奶瓣怎么回事	新生儿垃奶瓣怎么回事
我能帮你什么	我能帮你什么
三点一四乘四	三点一四乘四
全国居民幸福指数排行	全国居民幸福指数排行
快递能寄液体	快递能寄液体
阿迪达斯的标志	阿迪达斯得标志
电子厂学徒工资多少	电子厂学徒工资多少
吃了不消化怎么办	吃了不消话怎么办
vr体验馆怎么样	vr体验馆怎么样
支气管炎会引起发烧	支气管炎会引起发烧
u盘直接放iso文件能安装系统吗	u盘直接放iso文件能安装系统吗
小孩长痱子怎么办	小孩张痱子怎么办
怀孕多久有反应	怀孕多九有反应
跳绳能减肥吗	调绳能减肥吗
肺有结节怎么回事	肺有节节怎么回事
二百五十乘六十	二百五十乘六十
下巴上长痘痘是什么原因	下吧上长痘痘是什么原因
牛奶可以和鸡蛋一起吃	牛奶可以和鸡蛋一起吃
张晨这个名字怎么样	张诺这个名字怎么样
固定构架的临时拉线应满足哪些	固定构架的临时拉线应满足哪些
尖锐湿疣是性病吗	尖锐湿疣事性病吗
阿苯达唑片吃了拉虫吗	阿苯达唑片吃了拉虫嘛
王琳凯几岁	牛琳凯几岁
眼睛有血丝是怎么回事	眼睛有血丝是怎麼回事
乙肝会传染	乙肝会传染
晒伤了怎么办	晒伤了怎么半
四股圆编口诀最简单	四股圆编口诀最简单
吴亦凡在exo的地位	吴亦凡在exo的地位
产妇可以吃桃子	产妇可以吃桃子
怀孕能吃黄桃罐头	怀孕能吃黄桃罐头
驿站大概是什么意思	驿站大概是什么意思
支原体感染传染	支原体感染传染
疱疹几天能好	泡疹几天能好
内眼角痒是怎么回事	内眼角庠是怎么回事
坏肚子吃什么	坏肚子吃什药
大姨妈一个月来两次正常	大姨妈一个月来两次正常
脚底板痒是怎么回事	脚底版痒是怎么回事
二十年西工大研究生复试名单	二十年西工大研究生复试名单
什么叫定向流量	什么教定向流量
药过期了还能吃	药过期了还能吃
你是不是想死	你是不是想死
淋巴结肿大严重吗	林巴结肿大严重吗
嗜酸性粒细胞偏高	是酸性粒细胞偏高
我是什么星座	我是什么星座
机器人怎么做	机气人怎么做
如何控制不抠痘痘	如何控制不扣痘痘
苹果平板电脑可以打电话吗	平果平板电脑可以打电话吗
你有女朋友吗	你有女朋友吗
颈椎病会引起嘴唇麻吗	颈椎病会引起嘴唇麻麻
孕期血糖高能吃红薯	孕期血糖高能吃红薯
坐月子可以吃什么水果	作月子可以吃什么水果
你会骂我吗	你会骂我吗
月经推迟十几天正常	月经推迟十几天正常
你能干啥	你能干啥
连云港是哪个省	连云港是那个省
一米五的身高标准体重应该是多少	一米五的身高标准体重应该是多少
浙大十九年录取分数线	浙大十九年录取分数线
如何提高心理素质	如何提高心里素质
高烧是多少度	高烧事多少度
多囊卵巢综合症能怀孕	多囊卵巢综合症能怀孕
头孢是消炎药吗	头胞是消炎药吗
吃橙子可以减肥	吃橙子可以减肥
肠胃炎可以吃橘子吗	肠胃炎可以吃桔子吗
哪个牌子的奶油好	那个牌子的奶油好
咖啡拉花可以用速溶咖啡吗	咖啡拉花可以用速溶咖啡吗
痛经可以吃止疼药	痛经可以吃止疼药
九十六除四	九十六除四
十六岁还没有须佐能乎正常吗	十六岁还没有须佐能乎正常吗
我现在到哪里了	我现在到哪里了
世卫组织官员国籍	世卫组织官员国籍
维生素e软胶囊吃了对人体有什么好处	维生素e软胶囊吃了对人体有什么好处
你会啥呀	你会啥呀
八和二十四最小公倍数	八和二十四最小公倍数
oppo怎么打印	oppo怎么打印
你怎么可以这么笨	你怎么可以这么笨
快手上一天发几个作品容易热门	快手上一天发几个作品容易热门
红霉素软膏的作用	红霉素软高的作用
白醋可以洗脸	白醋可以洗脸
火龙果孕妇可以吃	火龙果孕妇可以吃
手发抖是什么原因引起的	手发斗是什么原因引起的
低回声是什么意思	低回升是什么意思
罗密欧与茱莉叶钢琴曲教程	罗密欧与朱丽叶钢琴曲教程
拔智齿后多久可以吃东西	把智齿后多久可以吃东西
农行信息服务怎么取消	农行信息服务怎么取消
脚底长水泡是什么原因	脚底长水疱是什么原因
芦荟可以直接擦脸吗	芦会可以直接擦脸吗
心律不齐怎么调养	心率不齐怎么调养
肾结石可以喝红茶吗	肾结石可以和红茶吗
晚上吃桃子会胖	晚上吃桃子会胖
二百加三百	二百加三百
有几种荨麻疹	有几种寻麻疹
膝关节韧带损伤	膝关节忍带损伤
睡觉睡到一半突然左耳朵痛	睡觉睡到一半突然左耳朵痛
a三十二的像素	a三十二的像素
慢性咽炎的症状	慢性咽严的症状
黄疸型肝炎能治好吗	黄疸性肝炎能治好吗
中兴通讯怎么样	中兴通迅怎么样
哺乳期能吃米线	哺乳期能吃米线
科大分数线	科大分数线
跳绳一小时消耗的热量	跳绳一小时消耗的热量
多囊卵巢能怀孕吗	多囊乱巢能怀孕吗
淤血淤青怎么消除	瘀血淤青怎么消除
感冒了可以打狂犬疫苗	感冒了可以打狂犬疫苗
减肥晚上可以吃橙子	减肥晚上可以吃橙子
颈椎病会引起头痛	颈椎病会引起头痛
月经能喝酒	月经能喝酒
胆结石能喝牛奶吗	胆节石能喝牛奶吗
心脏早搏的药	心脏早博的药
张子枫多大	张子风多大
今天星期几呀	今天星期几呀
招行实习工资	招行实习工资
白带带血丝是什么原因	百带带血丝是什么原因
你会吐位情况吗	你会吐胃情况吗
长痘痘的原因是什么	张痘痘的原因是什么
二十除二	二十除二
领导上海工人第三次武装起义的人是	领导上海工人第三次武装起义的人是
宝宝肚子有虫的症状	宝宝肚子又虫的症状
粗纤维食物有哪些	粗纤维实物有哪些
孕妇身上起痘痘是怎么回事	孕妇身上起痘痘是怎么回事
光的三字组词有哪些	光的三字组词有哪些
番茄可以和豆奶一起吃吗	番茄可以和豆奶一起吃吗
纸船怎么折	纸船怎么者
五菱荣光v中门中控锁安装	五菱荣光v中门中控锁安装
你长什么样	你长什么样
苏打水有什么作用	苏大水有什么作用
凯美瑞新车味道散不掉	凯美瑞新车味道散不掉
什么食物含维生素d	什么实物含维生素d
胃疼可以吃水果	胃疼可以吃水果
乌兰图雅的老公是谁	乌蓝图雅的老公是谁
怀孕能喝椰汁	怀孕能喝椰汁
高血压可以吃黄瓜	高血压可以吃黄瓜
十八乘九	十八乘九
卓别林为什么没有被杀	卓师林为什么没有被杀
大便解不出来怎么办	打便解不出来怎么办
视频会议软件把电脑卡死了	视频会议软件把电脑卡死了
tws耳机充电盒使用方法	tws耳机充电盒使用方法
经期可以喝菊花茶吗	经期可以喝菊花茶马
手机充不进去电	手机充不进去电
肩周炎的症状	肩周炎的正状
减肥能吃哈密瓜吗	减肥能吃哈蜜瓜吗
珍珠疹用什么药	珍珠珍用什么药
宝宝脸上长湿疹怎么办	宝宝脸上涨湿疹怎么办
孕妇可以吃冰激凌吗	孕妇可以吃冰激凌妈
经期可以吃地瓜	经期可以吃地瓜
软化血管的食物有哪些	软化血管的食物有那些
慢性荨麻疹怎么根治	慢性荨麻诊怎么根治
喝红豆水有什么好处	和红豆水有什么好处
上海农村危房鉴定标准	上海农村危房鉴定标准
艾滋病红点会痒吗	爱滋病红点会痒吗
怎么开微店	怎么凯微店
拨打杨杨的电话	拨打杨磊的电话
岔气怎么办	岔气怎么版
吃什么能提高免疫力	吃什么能提高勉疫力
近视影响捐献眼角膜吗	近视影响捐献眼角膜吗
移动营业厅更改套餐	移动营业厅更改套餐
孕妇可以吃桂圆吗	孕妇可以吃桂元吗
什么是甲状腺结节	什么是胛状腺结节
事业单位管理岗位可以转公务员吗	事业单位管理岗位可以转公务员吗
吃阿胶糕的好处	吃阿胶糕得好处
在快手评论别人久久的话	在快手评论别人久久的话
我的世界怎么去天堂	我的世界怎麼去天堂
脉搏八十五正常吗	脉博八十五正常吗
退出游戏	退出游戏
肾虚会引起失眠	肾虚会引起失眠
痛风可以喝冰水	痛风可以喝冰水
我国第几批加入世卫组织	我国第几批加入世卫组织
隔夜豆浆能喝	隔夜豆浆能喝
经期能喝茶吗	经期能和茶吗
海淀亿世界靠谱吗	海淀亿世界靠谱吗
月经期可以洗澡	月经期可以洗澡
怎么网上订机票	怎么网上定机票
是你美还是我美	是你美还是我美
汇集英文	汇聚英文
怎样申请微信号	怎样身请微信号
现代雅绅特变速箱加油口在哪	现代雅绅特变速箱加油口在哪
袁姗姗多高	郭姗姗多高
甲状腺结节钙化是怎么回事	甲状腺结节丐化是怎么回事
怀孕可以喝姜糖水	怀孕可以喝姜糖水
孕妇拉肚子怎么办	孕妇啦肚子怎么办
豆腐怎么做好吃	豆腐怎么作好吃
酸奶做出来很酸怎么办	酸奶做出来很酸怎么办
豆浆能隔夜喝	豆浆能隔夜喝
慢性荨麻疹吃什么好	慢性寻麻疹吃什么好
频繁的出现心脏往下坠的感觉	频繁的出现心脏往下坠的感觉
一百除十八	一百除十八
积累关于三国的歇后语	积累关于三国的歇后语
痛风能治断根吗	痛风能治段根吗
心脏不好吃什么	心脏不好吃什药
海竿一般用什么线	海杆一般用什么线
如何报考mba	如何报考mpa
在重庆买的医保在贵州可以使用么	在重庆买的医保在贵州可以使用么
那我可以叫你什么	那我可以叫你什么
大三阳是什么	大三样是什么
铝的密度是多少	铝的密度是多少
怀孕了还会有白带	怀孕了还会有白带
蓝光眼镜有必要带吗	蓝光眼镜有必要戴吗
西安属于历史古都吗	西安属于历史古都吗
写字的正确笔画	写字的正确笔划
下巴疼是怎么回事	下把疼是怎么回事
吃了头孢喝酒会怎么样	吃了头孢和酒会怎么样
子宫内膜厚是什么原因	字宫内膜厚是什么原因
肝硬化晚期症状	肝硬化晚期正状
水痘结痂几天能掉	水痘结痂几天能钓
水星无线路由器如何恢复出场设置	水星无线路由器如何恢复出厂设置
有子宫肌瘤能吃燕窝	有子宫肌瘤能吃燕窝
小说主角叶枫	小说主角叶斯
风油精能治灰指甲吗	风油精能制灰指甲吗
最强nba钻石艾弗森怎么加点	最强nba钻石艾佛森怎么加点
评价一下易烊千玺	评价一下易烊千玺
怀孕会犯困吗	怀孕回犯困吗
建行快贷服务电话	建行快贷服务电话
眼镜店验光一般收费多少呢	眼镜店验光一般收费多少呢
网上兼职是真的	网上兼职是真的
拉肚子可以喝咖啡	拉肚子可以喝咖啡
电脑怎么登陆微信	电脑怎么登入微信
咖啡能加红茶	咖啡能加红茶
马克思和恩格斯是哪国人	马克思和恩格斯是那国人
孕妇能吃泡椒凤爪吗	孕妇能吃泡椒风爪吗
喝完酒能洗澡吗	喝完就能洗澡吗
黄日华的女儿	黄旭华的女儿
中国肝癌治疗最佳医院	中国肝癌治疗最佳医院
怀孕能吃生鱼片	怀孕能吃生鱼片
法令纹怎么去除	法令纹怎么祛除
长辈过生日送什么花	长背过生日送什么花
哺乳期能吃桃	哺乳期能吃桃
开塞露可以擦脸吗	开塞路可以擦脸吗
身高一米八当啥兵种	身高一米八当啥兵种
经常喝柠檬蜂蜜水好	经常喝柠檬蜂蜜水好
大便出血是怎么回事	大变出血是怎么回事
室性早搏算不算心脏病	室性早博算不算心脏病
女生下面流水怎么回事	女生下面留水怎么回事
水痘和疱疹的区别	水豆和疱疹的区别
火龙果可以减肥	火龙果可以减肥
我的妈妈早上六点钟起床的英文	我的妈妈早上六点钟起床的英文
大蒜发芽了还能吃吗	打蒜发芽了还能吃吗
怎么查电话号码归属地	怎么差电话号码归属地
杨靖宇是一个怎么样的人	袁靖宇是一个怎么样的人
鬼压床是怎么回事	鬼押床是怎么回事
九十五年农历八月初三是什么星座	九十五年农历八月初三是什么星座
哺乳期可以吃阿莫西林胶囊吗	哺乳期可以吃啊莫西林胶囊吗
抽完血能洗澡	抽完血能洗澡
药流后多久来月经	药流后多就来月经
小时候玩过的玩具有什么	小时候玩过的玩具有什么
拔一颗牙多少钱	拔一棵牙多少钱
驾驶员安全措施怎样写	驾驶员安全措施怎样写
坐月子能不能吃方便面	做月子能不能吃方便面
林俊杰的白兰花的歌词	高俊杰的白兰花的歌词
中药一钱等多少克	中药一钱等多少克
你会不会打游戏	你会不会打游戏
刘心武作品	刘建武作品
变异型哮喘	变异性哮喘
七十六年的龙一生命运如何	七十六年的龙一生命运如何
感冒吃什么水果好	感帽吃什么水果好
解脲脲原体会自愈	解脲脲原体会自愈
梅花什么时候开	梅花什么时候凯
手麻木怎么回事	手麻木怎么会事
一个人手举着一座山打一成语	一个人手举着一座山打一成语
怎样才能让腿变细	怎样才能让退变细
十到三十之间的合数	十到三十之间的合数
梅毒的症状	梅毒的证状
怎么治疗驼背	怎么治疗驮背
补气血的药有哪些	布气血的药有哪些
枝江顺丰快递的电话	枝江顺丰快递的电话
长城m四变速箱油多久更换一次	长城m四变速箱油多久更换一次
电冰箱照明灯不亮什么原因	电冰箱照明灯不亮什么原因
江西共青城邮编多少	江西共青城邮编多少
李敏镐好看吗	葛敏镐好看吗
怀孕可以游泳	怀孕可以游泳
小米九后盖怎么拆	小米九后盖怎么拆
得了肩周炎怎么办	的了肩周炎怎么办
媳妇是怎么炼成的	媳妇是怎么练成的
幽门螺旋杆菌会传染吗	由门螺旋杆菌会传染吗
ibm上海年薪	ibm上海年薪
十边形内角和	十边型内角和
而应声答曰未闻孔雀是夫子家禽翻译成白话文	而应声答曰未闻孔雀是夫子家禽翻译成白话文
安卓如何查看安装路径	安卓如何查看安装路径
甲状腺结节需要手术吗	甲状腺结结需要手术吗
开塞露怎么用	凯塞露怎么用
怎么关注	怎么关注
我现在肚子饿了	我现在肚子饿了
韩币兑人民币的汇率	韩币对人民币的汇率
word怎么一键生成表格	word怎么一键生成表格
八个月婴儿智力低下	八个月婴儿智力低下
园洲中行电话号码是多少	园洲中行电话号码是多少
无痛胃镜是怎么麻醉的	无痛胃经是怎么麻醉的
孕妇可以做足疗吗	孕妇可以作足疗吗
牙周炎吃什么药	牙周炎吃什么要
关于二轮摩托车的年检新规	关于二轮摩托车的年检新规
头晕恶心是怎么回事	头晕恶心是怎么会事
甲亢的早期症状	甲亢的早起症状
半月板损伤的症状	半月板损伤得症状
用英语怎么说	用英语怎么说
你喜欢什么花	你喜欢什么花
二十年七月七日属什么	二十年七月七日是什么
现在流行什么装修风格	现在留行什么装修风格
胸大怎么办	胸大怎么班
蜂蜜水什么时候喝好	蜂蜜水什么时候和好
苹果手机怎么格式化	苹果手机怎么各式化
带套不会怀孕吧	戴套不会怀孕吧
加七	加七
十九点七六除五点二	十九点七六除五点二
零的平方是什么	零的平方是什么
子宫内膜多厚会来月经	子宫内膜多厚回来月经
生活如此美好用英文怎么说	生活如此美好用英文怎么说
眼睛黄是什么原因	眼镜黄是什么原因
淋巴在哪个位置	淋巴在那个位置
千兆网可以用七类线吗	千兆网可以用七类线吗
岳振华最高什么职务	农振华最高什么职务
脸上突然长斑是什么原因	脸上突然张斑是什么原因
给周红打电话	给周鑫打电话
新三界模式下退游的有多少	新三界模式下退游的有多少
打开密码本	打开密码本
形容作爱感觉的词语	形容作爱感觉的词语
下午能打预防针	下午能打预防针
珍珠的功效	珍珠得功效
明宣宗之后是哪个皇帝	明宪宗之后是哪个皇帝
的拼音	的拼音
长安景点	长安景点
蘑菇和菠菜能一起吃	蘑菇和菠菜能一起吃
她最喜欢的科目用英语怎么写	她最喜欢的科目用英语怎么写
甲状腺结节有什么症状	甲状腺结节有什么证状
怎样去疤痕	怎样去巴痕
腰间盘突出手术多少钱	腰肩盘突出手术多少钱
本来不痒用完硝呋太尔特别痒怎么办	本来不痒用完硝呋太尔特别痒怎么办
怀孕可以吃沙琪玛	怀孕可以吃沙琪玛
脱式计算是什么	脱式记算是什么
等腰三角形旋转九十度的画法	等腰三角形旋转九十度的画法
成都到昆山多少公里	成都到昆山多少公里
孕五月宫高	孕五月宫高
肾虚是男生还是女生	肾虚是男生还是女生
你是人还是机器人	你是人还是机器人
荷兰猪能吃橘子	荷兰猪能吃橘子
孕妇吃葡萄干好	孕妇吃葡萄干好
原核细胞有没有复杂的细胞器	原核细胞有没有复杂的细胞器
莫拉怎么画	米拉怎么画
普洱茶能减肥	普洱茶能减肥
0九立方米等多少立方分米	0九立方米等多少立方分米
牛奶和酒能一起喝	牛奶和酒能一起喝
水浒传作者	水浒转作者
李华是什么朝代	李寿是什么朝代
你空闲时间喜欢做什么英语	你空闲时间喜欢做什么英语
七号房的礼物exo	七号房的礼物exo
苹果手机在哪里打开数据流量	苹果手机在哪里打开数据流量
双眼周边网膜血管化未完成	双眼周边网膜血管化未完成
玫瑰香有籽好没籽好	玫瑰香有籽好没籽好
阿胶小孩可以吃吗	阿娇小孩可以吃吗
哪些人不适合吃阿胶	那些人不适合吃阿胶
山鹰乐队的歌曲	老鹰乐队的歌曲
八十除二	八十除二
明天有太阳吗	明天有太阳吗
猫粮自己做怎么配方	猫粮自己做怎么配方
小腿胀痛怎么办	小腿张痛怎么办
描写边塞将士的诗句	描写边塞将士的诗句
微波炉可以考披萨	微波炉可以考披萨
如何治疗脑梗	如何治疗脑埂
王牌对王牌假装打电话的是哪一期	王牌对王牌假装打电话的是哪一期
痔疮一般长在哪里	痔疮一般长在那里
清远旅游景点哪里好玩	清远旅游景点哪里好玩
怀孕初期可以吃牛油果	怀孕初期可以吃牛油果
南阳小麦收割时间	南阳小麦收割时间
破产案件诉讼费标准	破产案件诉讼费标准
喝绿茶能减肥	喝绿茶能减肥
北京租房公积金提取额度	北京租房公积金提取额度
带心的名字女孩子名字	带心的名字女孩子名字
为什么登录不了支付宝	为什么登入不了支付宝
什么病的人不能吃芹菜	什么病的人不能吃芹菜
什么食物降血糖	什么食物将血糖
手心出汗是怎么回事	手心出汗是怎么会事
女人多喝红枣枸杞水有什么好处	女人多喝红枣枸杞水有什么好处
两组对边什么的四边形叫做平行四边形	两组对边什么的四边形叫作平行四边形
女性尿结石的症状	女姓尿结石的症状
五分之四乘七表示	五分之四乘七表示
什么的小溪	什麼的小溪
感冒了鼻子不通气怎么办	感冒了鼻子不痛气怎么办
星座按阴历还是阳历算	星座安阴历还是阳历算
手机如何快速充电	手机如何快速冲电
低血糖是糖尿病吗	低学糖是糖尿病吗
今天是什么节日	今天是什麼节日
糖尿病的前期症状	唐尿病的前期症状
厦大教授名单	厦大教授名单
鱿鱼怎么做	鱿鱼怎么作
招行young信用卡年费	招行young信用卡年费
肺部有结节严重吗	肺不有结节严重吗
猪肝怎么炒好吃	猪肝怎么抄好吃
超人和奔腾剃须刀哪个好	超人和奔腾剃须刀哪个好
打开快手	打开快手
整数乘法的方法是什么	整数乘法的方法是什么
孕妇能吃韭菜吗	孕夫能吃韭菜吗
关于李隆基的电视剧有哪些	关于李聂基的电视剧有哪些
一直响铃然后直接挂了	一直响铃然后直接挂了
既是二的倍数又是五的倍	既是二的倍数又是五的倍
谢东的父亲是谁	何东的父亲是谁
双色球开奖结果	双色球开奖结果
黄瓜片敷脸有什么好处	黄瓜片肤脸有什么好处
孕七月躺下呼吸困难	孕七月躺下呼吸困难
北京到运城过路费多少钱	北京到运城过路费多少钱
耳朵里长痘痘是怎么回事	耳朵里张痘痘是怎么回事
怎样去除眼袋	怎样取除眼袋
我老婆是猪	我老婆是猪
怎么申请支付宝账号	怎么申请支付宝帐号
卵巢囊肿会影响怀孕吗	卵巢囊种会影响怀孕吗
湿气重喝什么茶好	湿气中喝什么茶好
脸上有绒毛怎么回事	脸上有绒毛怎么回事
橄榄油的功效与作用	敢榄油的功效与作用
贵定到金华高铁票查询	贵定到金华高铁票查询
分数是小数	分数是小数
精索静脉曲张怎么治疗	精缩静脉曲张怎么治疗
你现在干什么	你现在干什么
浩在五行中属什么	昊在五行中属什么
杨靖宇是一个怎么样的人	孔靖宇是一个怎么样的人
多久会怀孕	多久回怀孕
怎么练出腹肌	怎么连出腹肌
皇沃汽车是什么品牌	皇沃汽车是什么品牌
坐月子可以吃花菜	坐月子可以吃花菜
杨颖和黄晓明什么关系	杨颖和黄晓仓什么关系
封闭针是什么	封毕针是什么
陈坤的儿子是谁的啊	申坤的儿子是谁的啊
减肥可以吃牛油果	减肥可以吃牛油果
你有朋友	你有朋友
湿度八十八是什么概念	湿度八十八是什么概念
杜牧的诗有哪些	杜甫的诗有哪些
唐氏筛查多少钱	唐氏晒查多少钱
惊惶的惶的拼音	惊慌的惶的拼音
闲鱼在哪里改地址	咸鱼在哪里改地址
九十年五月是什么星座	九十年五月是什么星座
心脏彩超多少钱	心赃彩超多少钱
省钱的秘诀是什	省钱的秘诀是什
你觉得我怎么样	你觉得我怎么样
萧红带我回到身后的村庄的启示	萧红带我回到身后的村庄的启示
a七十二支持面容解锁吗	a七十二支持面容解锁码
胃肠感冒吃什么药	胃肠感冒吃什么要
腹泻能吃什么水果	腹泄能吃什么水果
早餐卖什么赚钱	早餐买什么赚钱
燃气热水器温度下不来咋回事	燃气热水器温度下不来咋回事
经常打嗝是怎么回事	经常打隔是怎么回事
脂肪肝怎么治	脂方肝怎么治
身体长红痣是什么原因	身体张红痣是什么原因
肾炎严重	肾炎严重
这个怎么读	这个怎么读
吃降压药能喝酒	吃降压药能喝酒
梅毒的症状有哪些	梅毒的症状有那些
学信网如何更改账号	学信网如何更改账号
脸上的痣可以去掉吗	脸上得痣可以去掉吗
腿部肌肉酸痛	腿不肌肉酸痛
辣条的热量高	辣条的热量高
哪里治疗鼻炎好	那里治疗鼻炎好
乙型肝炎表面抗体阳性是什么意思	乙行肝炎表面抗体阳性是什么意思
一百五十乘三十	一百五十乘三十
吴亦凡火吗	吴亦凡火吗
来例假能喝茶	来例假能喝茶
oppo和vivo是一家	oppo和vivo是一家
什么是躁郁症	什么是躁郁证
赞美教室的句子	赞美教师的句子
人体正常体温	人体正长体温
我说的是普通话吗	我说的是普通话吗
地中海贫血	地重海贫血
脚后跟疼是怎么回事	叫后跟疼是怎么回事
淋巴结肿大严重吗	淋巴节肿大严重吗
怎样走上人生巅峰	怎样走上人生巅峰
脉搏一分钟九十下正常吗	脉博一分钟九十下正常吗
为什么会长痤疮	为什么会张痤疮
糖尿病能吃水果吗	唐尿病能吃水果吗
女生来大姨妈怎么办	女生来打姨妈怎么办
大姨妈期间能喝中药吗	大姨妈期间能和中药吗
来月经可以吃海鲜	来月经可以吃海鲜
舌苔有裂纹是怎么回事	舌台有裂纹是怎么回事
来例假可以艾灸	来例假可以艾灸
喝中药会上火吗	喝中药回上火吗
脂肪肝有什么症状	脂肪肝有什么正状
清朝赔款实际支付总额	清朝赔款实际支付总额
来月经可以喝酸奶吗	来月经可以和酸奶吗
白癜风遗传吗	白癜风移传吗
九连籽的功效	九连子的功效
碳酸钠是什么	炭酸钠是什么
怎样调节内分泌失调	怎样调解内分泌失调
柠檬蜂蜜水的功效	拧檬蜂蜜水的功效
咳嗽可以喝豆浆	咳嗽可以喝豆浆
哈尔滨正义街的位置	哈尔滨正义街的位置
卡在oppo界面无法开机	卡在oppo界面无法开机
治湿疹的药膏	制湿疹的药膏
脚背痛是不是痛风	脚背痛是不是通风
酵素可以减肥	酵素可以减肥
你能帮我打王者吗	你能帮我打王者吗
怀孕可以喝豆浆吗	怀孕可以和豆浆吗
素菜有那些	蔬菜有那些
手机刷机怎么刷	手机耍机怎么刷
甲亢会遗传吗	甲亢回遗传吗
下巴长粉刺的原因	下巴张粉刺的原因
特斯拉普工好面试吗	特斯拉普工好面试吗
手机上安装什么软件可以播放swf	手机上安装什么软件可以播放swf
白带多是怎么回事	白带多是怎么会事
刘宪华出道时间	刘德华出道时间
小孩经常流鼻血怎么办	小孩经长流鼻血怎么办
fast是什么意思	fast是什么意思
什么是定向流量	什么是订向流量
招行信用卡卡片已寄出怎么查单号	招行信用卡卡片已寄出怎么查单号
广发信用卡好申请	广发信用卡好申请
淋巴结怎么治疗	淋吧结怎么治疗
乙肝携带者传染吗	乙肝协带者传染吗
河南有哪些学校开学了	河南有哪些学校开学了
相提什么什么救人四字成语	相提什么什么救人四字成语
慢性咽炎会自己好	慢性咽炎会自己好
包头防控中心电话	包头防控中心电话
微波炉能做披萨	微波炉能做披萨
孕晚期可以吃冰淇淋吗	孕晚起可以吃冰淇淋吗
衡水中学在临汾选址	衡水中学在临汾选址
小米八什么时候能更新miui十二	小米八什么时候能更新miui十二
公立医院为什么都没有男科	公立医院为什么都没有男科
卵巢囊肿能吃燕窝	卵巢囊肿能吃燕窝
word删除多页怎么删	word删除多页怎么删
剑来人间最得意是谁	剑来人间最得意是谁
麦滋林的作用是什么	麦滋林的作用是什么
彩票店赚钱	彩票店赚钱
结婚证上的花是啥花	结婚证上的花是啥花
四的多少次方等七	十的多少次方等七
河东人社局电话号码	河东人社局电话号码
重庆金辉城花样派房价	重庆金辉城花样派房价
狗粮能喂猫	狗粮能喂猫
吉林有哪些	吉林有哪些
东革阿里的功效与作用	东格阿里的功效与作用
湿疹和痱子的区别	湿疹和痱子得区别
韩语写给exo的话	韩语写给exo的话
吃火龙果会拉肚子吗	吃火龙果回拉肚子吗
脑梗塞的症状有哪些	脑梗赛的症状有哪些
来例假能洗澡	来例假能洗澡
手术后能吃海鲜	手术后能吃海鲜
长期坐着腰疼怎么办	长期做着腰疼怎么办
结婚证能补办	结婚证能补办
范冰冰整容了吗	庞冰冰整容了吗
新生儿要准备哪些东西	新生儿要准备那些东西
宫颈炎可以治愈	宫颈炎可以治愈
手机关机铃声的	手机关机铃声的
结婚戒指戴哪个手指	结婚戒指戴那个手指
脸上长痤疮怎么治疗	脸上张痤疮怎么治疗
慢性胃炎的症状	慢性胃炎的证状
脂肪肝有什么症状	脂防肝有什么症状
脸上一直长痘痘是什么原因	脸上一直张痘痘是什么原因
后背疼挂什么科	后辈疼挂什么科
做什么生意好呢	作什么生意好呢
枸杞石斛花泡水喝的功效	枸杞石斛花泡水喝的功效
没有幽门螺杆菌会得胃溃疡吗	没有幽门螺杆菌会得胃溃疡吗
柠檬水可以美白	柠檬水可以美白
如何申请小号	如何申清小号
张卫健西游记一共多少集	钟卫健西游记一共多少集
湖南师大高考分数线二千零一十九	湖南师大高考分数线二千零一十九
甲辰日怎样才能富贵	甲辰日怎样才能富贵
菠菜和鸡蛋能一起吃吗	波菜和鸡蛋能一起吃吗
孕初期可以吃榴莲	孕初期可以吃榴莲
来大姨妈可以洗澡	来大姨妈可以洗澡
肥西上派镇邮政编码	肥西上派镇邮政编码
关于书的名言	关于书的明言
二十年江西什么时候可以开学	二十年江西什么时候可以开学
无花果的功效	无花果的公效
石家庄到十堰飞机票	石家庄到十堰飞机票
四个月的宝宝才十一斤	四个月的宝宝才十一斤
你还能写出几个这样的字吗	你还能写出几个这样的字吗
人为什么会做梦	仁为什么会做梦
a九x的价格	a九x的价格
咽喉炎怎么治疗	咽候炎怎么治疗
体检前可以抽烟	体检前可以抽烟
经常流鼻血是怎么回事	经常留鼻血是怎么回事
乳腺癌手术后能活多久	乳现癌手术后能活多久
明天是什么日子	明天是什么日子
吃坏肚子怎么办	吃坏肚子怎么半
崔东俊演的电视剧	颜东俊演的电视剧
女人还是呆呆的坐在院子里等他	女人还是呆呆的坐在院子里等他
李嫣这个名字怎么样	李蕊这个名字怎么样
电热毯有辐射	电热毯有辐射
给我说句粤语	给我说句粤语
白癜风会痒吗	白癜风回痒吗
隐适美价格	隐世美价格
尿浑浊是什么原因	尿昏浊是什么原因
巨蟹座和天蝎座配	巨蟹座和天蝎座配
蓝牙耳机可以修	蓝牙耳机可以修
知名主持人死亡	著名主持人死亡
治疗过敏性鼻炎的方法	制疗过敏性鼻炎的方法
脚底长鸡眼怎么办	角底长鸡眼怎么办
胃炎吃什么	胃炎吃什药
艨艟的意思是什么意思	艨艟的意思是什么意思
怎么看出共同关注公众号的好友	怎么看出共同关注公众号的好友
经期可以喝逍遥丸吗	经期可以和逍遥丸吗
孕妇吃紫薯好	孕妇吃紫薯好
宫颈癌四价疫苗价格	宫颈癌四家疫苗价格
芒果的功效与作用	芒果的工效与作用
孕妇夏天可以吃冰淇淋	孕妇夏天可以吃冰淇淋
甲减能治愈	甲减能治愈
银行卡怎么激活	银行卡怎么几活
奥迪a六的铭牌在哪里啊	奥迪a六的铭牌在哪里啊
玻尿酸多少钱一支	玻尿酸多少钱一只
转氨酶高是什么原因	转按酶高是什么原因
急性白血病有哪些症状	急性白血病有那些症状
停经三天能测出怀孕	停经三天能测出怀孕
怀孕可以吃零食	怀孕可以吃零食
黑枸杞的功效与作用	黑枸杞得功效与作用
夏桑菊颗粒的作用	夏嗓菊颗粒的作用
大便次数多怎么回事	大便此数多怎么回事
咽喉癌的症状	咽喉癌的证状
怀孕后可以在家里钉钉子吗	怀孕后可以在家里钉钉子吗
玉米可以微波炉烤吗	玉米可以微波炉烤吗
drivingschool二千零一十七设置翻译	drivingschool二千零一十七设置翻译
左肺上叶小结节	左肺上页小结节
尿路感染会低烧	尿路感染会低烧
香港的电邮是什么意思	香港的电邮是什么意思
怀孕多久有胸胀的感觉	怀孕多久有胸涨的感觉
孕期能吃烧烤	孕期能吃烧烤
你能为我做什么	你能为我做什么
什么游戏好玩	什么游戏好晚
糖尿病能吃什么水果	糖尿病能吃什么水果
月经来之前乳房疼怎么回事	月经来之前乳房痒怎么回事
人流后能吃葡萄	人流后能吃葡萄
嘴巴周围长痘	嘴巴周围张痘
小孩正常体温是多少度	小孩正长体温是多少度
脚趾甲变黑怎么办	脚指甲变黑怎么办
为确保设计和开发的输出满足输入的要求应进行	为确保设计和开发的输出满足输入的要求应进行
咽喉癌的早期症状	咽喉癌的早起症状
么打电话	么打电话
四十四乘二	四十四乘二
三体系外审是指什么	三体系外审是指什么
咳嗽能游泳	咳嗽能游泳
脸上长小疙瘩怎么办	脸上张小疙瘩怎么办
六十四乘三点一四	六十四乘三点一四
膝盖可以拔罐	膝盖可以拔罐
月经期可以艾灸吗	月经期可以爱灸吗
月经期间可以吃逍遥丸	月经期间可以吃逍遥丸
大人咳嗽吃什么好的快	大人咳嗽吃什么好得快
微信如何添加银行卡	微信如何填加银行卡
经常做梦是什么原因	经常坐梦是什么原因
微博国际版登录不了	微博国际版登陆不了
痛经喝红糖姜水有用吗	痛经和红糖姜水有用吗
脚脱皮是怎么回事	脚脱皮是怎么会事
牛肉和西瓜能一起吃	牛肉和西瓜能一起吃
坐飞机能带充电宝吗	做飞机能带充电宝吗
八十九年农历四月初四是什么星座	八十九年农历四月初四是什么星座
心衰能治好	心衰能治好
醉后不知天在水满船清梦压星河什么意思	醉后不知天在水满船清梦压星河什么意思
怎么关闭斗鱼开机自启	怎么关闭斗鱼开机自启
今天的气温	今天的气温
六味地黄丸和逍遥丸可以一起吃吗	六味地黄丸和消遥丸可以一起吃吗
胃溃疡的症状有哪些	胃溃疡的证状有哪些
乳腺癌有哪些症状	乳线癌有哪些症状
utena正规品判定软件	utena正规品判定软件
支付宝限制登入淘宝	支付宝限制登陆淘宝
陈楚生是哪里的	沙楚生是哪里的
被猫咬了要打针吗	背猫咬了要打针吗
地板砖什么样的好	底板砖什么样的好
被蜱虫咬了有什么症状	被脾虫咬了有什么症状
过期的食用油可以吃	过期的食用油可以吃
缺维生素d的症状	却维生素d的症状
打开付款吗	打开付款码
接吻会怀孕	接吻会怀孕
舌头起泡怎么办	舌头气泡怎么办
附近有什么奶茶店	附近有什么奶茶店
充电器多少钱	充电器多少钱
哺乳期能吃大蒜吗	补乳期能吃大蒜吗
某工程项目有两个可供选择的方案	某工程项目有两个可供选择的方案
宝马三百二十五仪表盘指示灯图解	宝马三百二十五仪表盘指示灯图解
什么是幽默	什么事幽默
换个充点口多少钱	换个充电口多少钱
吉林最低工资标准	吉林最低工资标准
嘴唇发紫是什么原因	最唇发紫是什么原因
有哪些好看的动漫电影	有那些好看的动漫电影
感冒喉咙痛怎么办	感冒候咙痛怎么办
自的行书怎么写	紫的行书怎么写
贵州车牌号城市代号	贵州车牌号城市代号
余秋雨的作品	于秋雨的作品
一美金多少人民币	一美金多少人民币
术后可以吃牛肉	术后可以吃牛肉
什么时候用have	什么时侯用have
九月里的生日是什么星座	九月里的生日是什么星座
蓝海吉祥切割片怎么样	蓝海吉祥切割片怎么样
叶剑英是谁啊	雍剑英是谁啊
choosefor和chooseas的区别	choosefor和chooseas的区别
颈椎痛怎么缓解	颈椎同怎么缓解
颈椎病能每天洗澡吗	颈椎病能每天洗澡吗
混凝土抽样数量最低多少	混凝土抽样数量最低多少
左胸下方是什么器官	左胸下放是什么器官
三角形的周长怎么求	三角型的周长怎么求
玫瑰花茶的功效与作用	玫瑰花茶得功效与作用
反流性咽喉炎	反流性咽候炎
湖面像什么一样平静	湖面想什么一样平静
我们去哪里	我们去哪里
苹果店里买可以刻字吗	苹果店里买可以刻字吗
化疗要住院	化疗要住院
白癜风会传染吗	白癜风会传然吗
怀孕能吃蚬子	怀孕能吃蚬子
冒险岛天使link有没必要	冒险岛天使link有没必要
动感单车减肥效果好吗	动敢单车减肥效果好吗
阳虚怎么治疗	阳需怎么治疗
新生儿黄疸怎么退得快	新生儿黄疸怎么退的快
经期能拔牙	经期能拔牙
公文的成文时间使用	公文的成文时间使用
mba报名时间	mpa报名时间
牛仔裤口袋里有沙子正常吗	牛仔裤口袋里有沙子正常吗
左上腹疼痛	左上复疼痛
脚底板痒是什么原因	脚地板痒是什么原因
你可真有意思	你可真有意思
芜湖到彭泽火车时刻表查询	芜湖到彭泽火车时刻表查询
人流要做多久的月子	人流要坐多久的月子
发烧可以吃芒果	发烧可以吃芒果
孙玉厚扮演者	孙玉亭扮演者
什么的枝条	什么得枝条
坐月子可以吃银耳莲子汤吗	做月子可以吃银耳莲子汤吗
怀孕一个月可以药流吗	怀孕一个月可以药留吗
什么是京东卡	什么事京东卡
如何退出电脑监控画面	如何退出电脑监控画面
交通罚款网上怎么缴费	交通罚款网上怎么交费
骨密度检查多少钱	骨蜜度检查多少钱
身上长猴子是什么原因	身上涨猴子是什么原因
梦见已故的亲人	梦见一故的亲人
我也想关机睡觉了	我也想关机睡觉了
怎样把银行卡的钱转到支付宝	怎样把银行卡的钱赚到支付宝
张杰她老婆是谁	张杰他老婆是谁
胃病能吃桑椹吗	胃病能吃桑葚吗
肾结石能吃豆芽吗	肾结石能吃豆牙吗
孕妇吃火龙果好	孕妇吃火龙果好
坐月子拉肚子怎么办	座月子拉肚子怎么办
今天谁最好看	今天谁最好看
节育环哪种最好	节育环那种最好
在职研究生算应届吗	在职研究生算应届吗
家里的灯关灯后有时会闪一下	家里的灯关灯后有时会闪一下
葵花籽致癌吗	葵花籽治癌吗
淡奶油能做什么	淡奶油能做什麼
白术和艾草一起煮水喝行吗	白术和艾草一起煮水喝行吗
工行app怎么查询开户行	工行app怎么查询开户行
带状疱疹会自愈吗	带状疱疹回自愈吗
肖战帅吗	肖战帅吗
乙型肝炎表面抗体呈阳性是什么意思	乙型肝炎表面抗体成阳性是什么意思
游戏三个字情侣名字	游戏三个字情侣名字
怎样输入英语单词之间的空格	怎样输入英语单词之间的空格
慢性血热型荨麻疹	慢性血热性荨麻疹
十二乘十三	十二乘十三
主动的动字怎么写	自动的动字怎么写
舌苔发黑是什么原因	舌苔发嘿是什么原因
魏晨的女朋友是谁	姚晨的女朋友是谁
避孕套带反了会怀孕	避孕套带反了会怀孕
人流后多久来月经	人留后多久来月经
怎么可以瘦脸	怎么可以受脸
考试作弊打一数学名词	考试做弊打一数学名词
避孕药会导致不孕	避孕药会导致不孕
怎样清洗羽绒服	怎样请洗羽绒服
嗜酸性粒细胞偏低	是酸性粒细胞偏低
三百五十乘二十	三百五十乘二十
来例假可以吃橘子	来例假可以吃橘子
正常心率	正长心率
双重趋避冲突的例子三个	双重趋避冲突的例子三个
梦见买东西花钱是什么意思	梦见买东西花钱是什么意思
脚被砸到了肿了怎么办	脚背砸到了肿了怎么办
农行咨询电话号码	农行咨询电话号码
膝盖内侧疼是怎么回事	膝盖内测疼是怎么回事
什么是艾滋病	什麼是艾滋病
血小板计数偏高怎么办	血小板记数偏高怎么办
你吃饭了吗	你吃饭了吗
孕妇可以喝金银花吗	孕妇可以和金银花吗
阴道镜活检疼吗	阴道镜火检疼吗
师傅的师傅叫什么	师傅得师傅叫什么
肝不好吃什么食物	干不好吃什么食物
孕晚期能吃雪糕	孕晚期能吃雪糕
痔疮用什么药好	治疮用什么药好
怎样预防新生儿黄疸	怎样预防新生儿黄胆
颈椎压迫神经的症状	颈椎压迫神经的证状
喉咙长息肉有什么症状	喉咙张息肉有什么症状
乳腺癌是什么症状	乳腺言是什么症状
上吐下泻是怎么回事	上吐下泻事怎么回事
妊娠糖尿病能吃什么水果	任娠糖尿病能吃什么水果
猕猴桃能和酸奶一起吃吗	弥猴桃能和酸奶一起吃吗
对男生的赞美	对男性的赞美
痔疮吃什么药好得快	痔疮吃什么药好的快
怀孕可以吃冬枣	怀孕可以吃冬枣
乙肝e抗体阳性	已肝e抗体阳性
怀孕能吃火鸡	怀孕能吃火鸡
颧骨高怎么办	颧骨搞怎么办
蛋白质食物有哪些	蛋白质食物有那些
来月经可以吃生蚝	来月经可以吃生蚝
孕晚期能吃冰棍	孕晚期能吃冰棍
肠炎的症状有哪些	肠炎的症状有那些
地中海贫血有什么症状	地中海贫血有什么正状
袁姗姗多高	林姗姗多高
抑郁症如何治疗	抑郁正如何治疗
交通安全手抄报内容	交通安全收抄报内容
来大姨妈可以喝酒	来大姨妈可以喝酒
肛肠息肉怎么治	刚肠息肉怎么治
有人工客服么	有人工客服么
我的手机还有多少g内存	我的手机还有多少g内存
用手指弄完有血和血丝	用手指弄完有血和血丝
党的十八大提出的两个一百年的奋斗目标指的是	党的十八大提出的两个一百年的奋斗目标指的是
沈从文写的小说	沈从达写的小说
如何自制史莱姆视频	如何自制史莱姆视频
怀孕能吃面包	怀孕能吃面包
金毛能吃菠萝	金毛能吃菠萝
孕妇可以吃桔子吗	孕妇可以吃橘子吗
坐月子能吃李子吗	做月子能吃李子吗
该在河里死井里死不了	该在河里死井里死不了
贾玲多少岁了	贾青多少岁了
地中海贫血	地种海贫血
微信密码忘记了怎么办	微信蜜码忘记了怎么办
如何注册微信号	如何注册微信好
做胃镜需要空腹吗	作胃镜需要空腹吗
智齿没长出来能拔	智齿没长出来能拔
三伏贴有用	三伏贴有用
什么是唇炎	什么事唇炎
李华是什么朝代	濮华是什么朝代
去建行办etc需要什么	去建行办etc需要什么
毕业赠言给老师的	毕业增言给老师的
过期的药能吃吗	过起的药能吃吗
庞龙的原名是什么	庞符的原名是什么
邵阳内景点排名大全	邵阳内景点排名大全
颈椎退行性变如何治疗	颈椎推行性变如何治疗
孕妇糖尿病对胎儿有什么影响	孕妇唐尿病对胎儿有什么影响
哺乳期可以吃燕窝	哺乳期可以吃燕窝
十里春风不如你结局柳青	十里春风不如你结局柳青
北京的区号	北京得区号
孕妇可以吃冰激凌吗	孕妇可以吃冰激凌马
心脏二尖瓣轻度返流	心脏二尖瓣轻度反流
跟情绪有关的四字词	跟情绪有关的四字词
白云是什么	白连是什么
什么叫中型糖尿病	什么叫重型糖尿病
什么是肠胃炎	什么事肠胃炎
宝宝咳嗽流鼻涕怎么办	宝宝咳嗽留鼻涕怎么办
防溢乳垫有用	防溢乳垫有用
拉肚子吃什么药	拉度子吃什么药
减肥一直不成功怎么办	减肥一直不成功怎么办
五度白醋是什么意思	五度白醋是什么意思
哪种猫好养	那种猫好养
皮肤过敏的症状	皮肤过敏的正状
我儿子叫什么名字	我儿子叫什么名字
怎样利用网络赚钱	怎样立用网络赚钱
上吐下泻肚子疼吃什么药	上吐下泄肚子疼吃什么药
癣会传染吗	显会传染吗
一岁宝宝能吃桑椹吗	一岁宝宝能吃桑葚吗
哪个星座男人最好	那个星座男人最好
怀孕多久能查出男女	怀孕多就能查出男女
个人营业执照增项怎么办理	个人营业执照增项怎么办理
有什么酒店	有什么酒店
网红王岩是干什么的	网红赵岩是干什么的
艾滋病潜伏期能查出来	艾滋病潜伏期能查出来
一分米长的物体有什么	一分米长的物体有什么
嘴里长泡吃维生素几	嘴里长泡吃维生素几
阿普利亚gpr一百五十多久保养一次	阿普利亚gpr一百五十多久保养一次
功能性消化不良怎么治	功能性销化不良怎么治
怀孕初期能做阴超	怀孕初期能做阴超
怎样去皱纹	怎样去绉纹
恐龙怎么折	恐龙怎麼折
如何收缩毛孔	如何收索毛孔
心脏供血不足怎么调理	心脏共血不足怎么调理
六乘五	六乘五
抑郁症能治愈吗	抑郁证能治愈吗
怎样重启路由器	怎样重起路由器
什么酸奶喝了对身体好	什么酸奶喝了对身体好
page是什么意思中文	page是什么意思中文
角瓜生长周期多少天	角瓜生长周期多少天
a七十二几个卡槽	a七十二几个卡槽
暑湿感冒吃什么药	署湿感冒吃什么药
湿疹有什么症状	湿诊有什么症状
膝盖痛是什么原因	息盖痛是什么原因
丙肝会传染	丙肝会传染
白带异常怎么办	百带异常怎么办
来大姨妈可以吃香蕉吗	来大姨吗可以吃香蕉吗
为什么大便的时候白带特别多	为什么大便的时候白带特别多
乙肝表面抗体阳性正常	乙肝表面抗体阳性正常
塔一般放在家的哪里好	塔一般放在家的哪里好
你有爱人	你有爱人
打电话给宝宝	打电话给宝宝
手机上如何删除买家秀	手机上如何删除买家秀
剖腹产多久可以洗澡	剖复产多久可以洗澡
猫虱子咬的包是啥样子	猫虱子咬的包是啥样子
避孕药怎么吃	毕孕药怎么吃
灰原哀喜欢柯南吗	灰原哀喜欢柯文吗
艾滋病还能活多久	爱滋病还能活多久
怎么搭配衣服好看	怎么打配衣服好看
哺乳期能用化妆品吗	补乳期能用化妆品吗
身上长猴子怎么去掉	身上长瘊子怎么去掉
氯雷他定片和盐酸西替利嗪片能一起服用吗	氯雷他定片和盐酸西替利嗪片能一起服用吗
痛风能吃橙子	痛风能吃橙子
胆汁反流性胃炎的症状	胆汁反流性胃炎的证状
后天什么天气	后天什么天气
颈椎疼怎么办	颈椎腾怎么办
肺部积水严重	肺部积水严重
喝豆浆有什么好处	和豆浆有什么好处
支气管发炎怎么办	支汽管发炎怎么办
人为什么会做梦	人为什么会做梦
配件英语	备件英语
乳腺结节是乳腺增生	乳腺结节是乳腺增生
黄疸有哪些症状	黄疸有那些症状
纯碱作洗涤剂的原理	纯碱做洗涤剂的原理
长智齿疼怎么办	涨智齿疼怎么办
张宇彤名字打分	张宇菲名字打分
如果是梦就好了日文歌	如果是梦就好了日文歌
低血糖吃什么	低血糖吃什药
粉象生活邀请一个人多少钱	粉象生活邀请一个人多少钱
荷叶茶能减肥	荷叶茶能减肥
糖尿病可以吃木瓜	糖尿病可以吃木瓜
月经可以吃红枣	月经可以吃红枣
江宁男科多少钱就找金科	江宁男科多少钱就找金科
输卵管通而不畅能怀孕	输卵管通而不畅能怀孕
男人可以吃逍遥丸吗	男人可以吃消遥丸吗
范冰冰整容了吗	梅冰冰整容了吗
甲亢能彻底治愈吗	甲亢能彻底治愈吗
怀孕能吃原荽吗	怀孕能吃园荽吗
招行信用卡和花呗哪个利息高	招行信用卡和花呗哪个利息高
妊娠糖尿病可以喝绿豆汤	妊娠糖尿病可以喝绿豆汤
同型半胱氨酸偏高	同性半胱氨酸偏高
成都疫情防控等级	成都疫情防控等级
体检用挂号	体检用挂号
放屁臭是什么原因	防屁臭是什么原因
白癜风怎么治疗	白电风怎么治疗
月经期间可以吃山竹吗	月经其间可以吃山竹吗
乌鲁木齐仟叶学校怎样	乌鲁木齐仟叶学校怎样
给自己充电	给自己充电
喉咙痛可以吃橘子	喉咙痛可以吃橘子
风景唯美心情说说短句	风景唯美心情说说短句
浙大在中国的排名	浙大在中国的排名
你爹是谁	你爹是谁
肩周炎看哪个科室	肩周炎看那个科室
张子枫多大	张子宣多大
眼睛重影眯着眼看才正常	眼睛重影眯着眼看才正常
希沃易课堂客服电话	希沃易课堂客服电话
花生的功效与作用	花生的工效与作用
你是男性还是女性	你是男性还是女性
经常放屁是什么原因	经常放屁是什么愿因
隐私密码忘了怎么办	隐私密码忘了怎么办
什么是注册资本	什么事注册资本
李远庵为官清苦可以看出他怎样的品性	李远庵为官清苦可以看出他怎样的品性
烟台到安康多少公里	烟台到安康多少公里
哺乳期能吃马齿苋	哺乳期能吃马齿苋
泌乳素高怎么办	必乳素高怎么办
什么是天堂	什么事天堂
新生儿喉咙有痰怎么办	新生儿候咙有痰怎么办
每天吃多少芋头不会胖	每天吃多少芋头不会胖
银耳的功效与作用	银儿的功效与作用
怎样推迟月经	怎样推持月经
农行怎么查询开户银行	农行怎么查询开户银行
健脾胃的食物	建脾胃的食物
湿疹是什么引起的	湿诊是什么引起的
工行算商业银行	工行算商业银行
魔兽怀旧服ah是什么意思	魔兽怀旧服ah是什么意思
什么是维生素c	什么是微生素c
嗓子疼喝什么好	嗓子痒喝什么好
西关大少陈继棠结局	西关大少陈继棠结局
脚底长刺猴怎么治	脚底长刺瘊怎么治
肺结核的传播途径	肺结核的传播途经
皮炎平治脚气	皮炎平治脚气
核磁共振影响怀孕	核磁共振影响怀孕
竖折折钩怎么写	竖折折勾怎么写
咽炎吃什么药效果最好	咽严吃什么药效果最好
范冰冰整容了吗	双冰冰整容了吗
刑法的年龄	刑罚的年龄
白斑可以用激光治疗吗	白斑可以用激光治疗吗
腊七腊八冻死寒鸦的意思	蜡七腊八冻死寒鸦的意思
月经期能吃西瓜	月经期能吃西瓜
a九十二s支持面部解锁嘛	a九十二s支持面部解锁码
双氧水洗耳朵	双阳水洗耳朵
九十六除三	九十六除三
烤瓷牙一颗多少钱	考瓷牙一颗多少钱
产后能喝牛奶吗	产后能和牛奶吗
十个月宝宝可以吃橙子	十个月宝宝可以吃橙子
糖尿病能吃苹果吗	塘尿病能吃苹果吗
怎样排肝毒	怎样拍肝毒
怀孕多久可以测出来	怀孕多久可以侧出来
三百六十除六	三百六十除六
精神病会遗传	精神病会遗传
血常规挂哪个科	血常规挂那个科
cnp和hfp黑头鼻贴哪个好	cnp和hfp黑头鼻贴哪个好
怎样勾鱼夫帽	怎样钩鱼夫帽
乙肝喝什么茶好	已肝喝什么茶好
痛风可以吃红薯	痛风可以吃红薯
小孩吃蛋白还是蛋黄好	小孩吃蛋白还是蛋黄好
知道八五七什么意思吗	知道八五七什么意思吗
胃炎可以喝酸奶	胃炎可以喝酸奶
桂圆的功效与作用	桂员的功效与作用
泰安有哪些医院	泰安有哪些医院
张子枫多大	章子枫多大
感冒药饭前吃还是饭后吃	感冒药饭钱吃还是饭后吃
有什么用呢	有什么用呢
如何检查燃气是否泄漏	如何检查燃气是否泄露
十二月初八是什么座	十二月初八是什么座
脸上长斑是什么原因	脸上张斑是什么原因
红色经典书籍	红色精典书籍
淘宝运费险怎么买	淘宝运费险怎么卖
喝蜂蜜上火	喝蜂蜜上火
你是什么呢	你是什么呢
胃溃疡能吃什么	为溃疡能吃什么
兴义电子厂有招工的没	兴义电子厂有招工的没
孕晚期能吃方便面吗	孕晚期能吃放便面吗
什么游戏	什么游戏
什么品牌的护肤品补水保湿美白效果好	什么品牌的护肤品补水保湿美白效果好
上腹胀是什么原因	上腹帐是什么原因
来月经可以吃辣椒	来月经可以吃辣椒
例假能喝咖啡	例假能喝咖啡
公民应怎样依法行使权力	公民应怎样依法行使权利
我喜欢吃什么	我喜欢吃什么
日本aⅴ女星有那些	日本aⅴ女星有那些
脚水肿是怎么回事	脚水中是怎么回事
公共管理专业的职称是什么	公共管理专业的职称是什么
酊剂的乙醇浓度是多少	酊剂的乙醇浓度是多少
有关万思维的电视剧	有关万思维的电视剧
梦到自己被狗咬	梦到自己背狗咬
甲状腺癌术后能活多久	胛状腺癌术后能活多久
坐骨神经痛是怎么回事	做骨神经痛是怎么回事
橄榄油的功效与作用	橄兰油的功效与作用
舒筋健腰丸有效果	舒筋健腰丸有效果
带状疱疹的症状	带壮疱疹的症状
小孩能吃榴莲	小孩能吃榴莲
其的偏旁是什么	其的边旁是什么
眼睛里进东西了怎么办	眼睛里今东西了怎么办
李连杰演的中华英雄结局	李褚杰演的中华英雄结局
不停打嗝怎么办	不挺打嗝怎么办
打完玻尿酸多久可以洗脸	打完波尿酸多久可以洗脸
什么快快的四字词语	什么快快的四字词语
要不要	要不要
脸上长痘痘怎么调理	脸上涨痘痘怎么调理
十堰的高铁什么时候开通	十堰的高铁什么时候开通
粤省事粤康码小孩子怎么申请	粤省事粤康码小孩子怎么申请
月经来了可以喝可乐	月经来了可以喝可乐
菠萝上火	菠萝上火
来月经可以喝蜂蜜水吗	来月经可以喝蜂密水吗
经常腹泻是怎么回事	经常复泻是怎么回事
成语接龙	成语接龙
肾结石什么症状	肾结石什么证状
水浒传作者	水浒穿作者
宝宝嗓子红咳嗽吃啥药	宝宝嗓子红咳嗽吃啥药
杜甫诗怎么写	杜甫是怎么写
肾炎能吃豆制品	肾炎能吃豆制品
颈纹怎么消除	颈纹怎么消处
掉头发是什么原因	掉头发是什么愿因
肝不好有哪些症状	肝不好有哪些症壮
达克宁治龟头炎吗	达克宁治鬼头炎吗
熏艾条的功效与作用	薰艾条的功效与作用
拔罐起泡是怎么回事	拔管起泡是怎么回事
支付宝可以转账到信用卡吗	支付宝可以转帐到信用卡吗
怀孕可以吃豆腐	怀孕可以吃豆腐
寿命最长的血细胞是什么细胞	寿命最长的血细胞是什么细胞
外踝骨折严重	外踝骨折严重
十二和二十四的最大公因数是	十二和二十四的最大公因数是
卵巢多囊综合症能怀孕吗	卵巢多囊综合证能怀孕吗
杜鹃花可以净化空气吗	杜鹃花可以净化空气吗
哺乳期可以吃桃子吗	哺乳期可以吃桃子妈
眼睛怎样变大自然方法	眼睛怎样变大自然方法
国产轮胎质量排名	国产轮胎质量排名
梅毒能治好	梅毒能治好
怎么治口臭	怎么只口臭
牛奶和桔子可以一起吃吗	牛奶和橘子可以一起吃吗
你有对象吗	你有对象吗
无锡站在哪里	无锡站在那里
肾结石能喝酸奶	肾结石能喝酸奶
一直打嗝怎么办	一直大嗝怎么办
洒布沥青材料时气温不应低于	洒布沥青材料时气温不应低于
澳元兑人民币汇率趋势	澳元对人民币汇率趋势
月经期可以吃苦瓜	月经期可以吃苦瓜
兰花指捻红尘似水什么	兰花指捻红尘似水什么
微信把好友删了对方知道吗	微信吧好友删了对方知道吗
半月板损伤怎么治疗	板月板损伤怎么治疗
韵达是马云的	韵达是马云的
梦见被蛇咬	梦见备蛇咬
包皮龟头炎	包皮鬼头炎
物业管理费包括二次加压费吗	物业管理费包括二次加压费吗
九纳米光刻机是哪个公司生产	九纳米光刻机是哪个公司生产
心率不齐的危害	心律不齐的危害
怀孕初期可以吃李子	怀孕初期可以吃李子
bbc频率	bbc频率
坐月子能吃甜瓜吗	坐月子能吃田瓜吗
冰箱冻冰块需要多长时间	冰箱冻冰块需要多长时间
疫情期间老师对家长说的话	疫情期间老师对家长说的话
小米粥糖分高吗	小米粥糖份高吗
宝宝换奶粉拉肚子怎么办	宝宝换奶粉啦肚子怎么办
经期可以吃枸杞	经期可以吃枸杞
员工请假条怎么写	员工清假条怎么写
怎样戴古筝指甲	怎样带古筝指甲
肾虚会引起脱发	肾虚会引起脱发
喝咖啡对月经有影响吗	和咖啡对月经有影响吗
血糖高可以吃红薯吗	血糖高可以吃红署吗
喝什么粥养胃	喝什么州养胃
刘德华有孩子吗	刘德海有孩子吗
糖尿病人可以吃辣椒吗	唐尿病人可以吃辣椒吗
肾结石有什么症状	肾洁石有什么症状
端午节有什么好玩的	端午节有什么好玩的
痛风能吃菠菜么	通风能吃菠菜么
菠萝上火吗	菠罗上火吗
哪些动物是气象员	那些动物是气象员
得了湿疹可以吃橘子吗	得了湿疹可以吃桔子吗
脚后跟疼怎么治疗	脚后跟疼怎么制疗
关于项羽的成语	关于关羽的成语
点痣恢复期间颜色变化	点痣恢复期间颜色变化
莒南跑临沂客车时刻表	莒南跑临沂客车时刻表
先涂防晒霜还是隔离霜	先图防晒霜还是隔离霜
机械制图圆锥辅助圆法	机械制图圆锥辅助圆法
怎么去除黑眼圈	怎么去处黑眼圈
组织机构代码证在哪里办理	组织机构代码证在那里办理
经常抠鼻子有什么坏处	经常扣鼻子有什么坏处
咳嗽可以吃香瓜	咳嗽可以吃香瓜
来月经可以喝蜂蜜水吗	来月经可以喝峰蜜水吗
建行购房贷款条件	建行购房贷款条件
慢性肾炎吃什么药	慢行肾炎吃什么药
建行满十六岁可以办银行卡	建行满十六岁可以办银行卡
肝胆湿热的症状	肝胆湿热的正状
二保焊机不吐丝不出气原因	二保焊机不吐丝不出气原因
怎么可以语音召唤	怎么可以语音召唤
生育津贴差额是税前还是税后	生育津贴差额是税前还是税后
早上起来头晕是怎么回事	早上起来头晕是怎么会事
膀胱炎有什么症状	旁胱炎有什么症状
罗晋唐嫣最新访谈节目	钱晋唐嫣最新访谈节目
来月经可以吃木耳	来月经可以吃木耳
月经有血块怎么回事	月精有血块怎么回事
这是什么歌	这是什么歌
硫酸钙是沉淀	硫酸钙是沉淀
带清的昵称	带青的昵称
胸部胀痛是不是怀孕了	胸不胀痛是不是怀孕了
你有女朋友了吗	你有女朋友了吗
血常规能测出艾滋病	血常规能测出艾滋病
红色枫叶歌词薛之谦	红色枫叶歌词薛之谦
月经期可以吃阿胶吗	月经期可以吃阿娇吗
一百以内的英语单词怎么写	一百以内的英语单词怎么写
左小欣扮演者	左小青扮演者
创造与魔法礼包兑换码在哪里兑换	创造与魔法礼包兑换码在哪里兑换
温州的邮编	温州的邮编
ios怎么绕过商店下载	ios怎么绕过商店下载
排列五复式价格	排列五复试价格
表达对妈妈爱的成语	表达对妈妈爱的成语
白水江林业局领导名单	白水江林业局领导名单
肺结节是怎么回事	肺结接是怎么回事
坐月子可以吃饼干	坐月子可以吃饼干
舌苔厚腻是怎么回事	舌台厚腻是怎么回事
什么有助于睡眠	十么有助于睡眠
什么是更年期综合症	什么是更年期综合证
烂脚丫怎么治	烂脚丫怎么制
正常视力	正常视里
全国都带头盔吗	全国都戴头盔吗
王俊凯帅吗	王俊凯帅吗
吃什么水果补血	吃什么水果不血
怎么查残疾证被公司套用	怎么查残疾证被公司套用
黄贯中代表作是什么	罗贯中代表作是什么
连云港中级职称评定条件	连云港中级职称评定条件
先有鸡还是先有蛋	先右鸡还是先有蛋
喝可乐上火	喝可乐上火
被油烫伤起泡怎么处理	被油烫伤气泡怎么处理
那里有二手摩托车买	那里有二手摩托车卖
诺氟沙星治疗拉肚子	诺氟沙星治疗拉肚子
车内显示屏可以看电视吗	车内显示屏可以看电视吗
近视眼怎么恢复视力	近视眼怎么回复视力
王一博帅不帅	王一博帅不帅
嘉兴哪里有好玩的地方	嘉兴哪里有好玩的地方
药流后多久来月经	药留后多久来月经
放疗可以报销	放疗可以报销
建行app在哪买原油	建行app在哪买原油
玉金方的功效与作用	玉金方的功效与作用
孕晚期能吃花甲	孕晚期能吃花甲
解脲支原体阳性好治吗	解尿支原体阳性好治吗
变形金刚人物	变形金钢人物
你没有眼睛	你没有眼睛
适合上官婉儿的网名	适合上官婉儿的网名
孕妇可以喝蒲地蓝消炎口服液吗	孕妇可以喝蒲地兰消炎口服液吗
经常拉肚子是什么原因	经常垃肚子是什么原因
你为什么不跟我聊天	你为什么不跟我聊天
标准的胸围腰围臀围是多少	标准的胸围腰围臀围是多少
湘潭到昭山坐几路公交车	湘潭到昭山坐几路公交车
丁雪糕的做法	丁雪糕的做法
长治二甲医院有那些	长治二甲医院有哪些
抽血后可以洗澡	抽血后可以洗澡
宫颈糜烂传染	宫颈糜烂传染
结扎后能恢复	结扎后能恢复
胃肠胀气吃什么药	胃长胀气吃什么药
许崇怎么死的	许贡怎么死的
脖子痒是怎么回事	脖子痒是怎么会事
二甲双胍可以减肥吗	二家双胍可以减肥吗
城市桥梁工程施工与质量验收规范	城市桥梁工程施工与质量验收规范
常州最新防疫政策	常州最新防疫政策
鲁迅是八十一年发表的	鲁迅是八十一年发表的
excel如何退出筛选	excel如何退出筛选
小儿肠胃炎	小儿常胃炎
怎样在电脑上截图	怎样再电脑上截图
拉肚子能喝咖啡	拉肚子能喝咖啡
甲亢严重	甲亢严重
强直性脊椎炎的症状	强直性脊椎炎的症壮
莹石设备不在线	萤石设备不在线
腹腔淋巴结肿大的症状	腹腔淋巴结肿大的证状
手撕牛肉的做法大全	手撕牛肉的做法大全
五千加五千	五千加五千
红豆薏米小孩能喝	红豆薏米小孩能喝
周琴的英文名	美琴的英文名
脚底长水疱是湿气吗	脚底长水泡是湿气吗
坐飞机耳朵痛怎么办	做飞机耳朵痛怎么办
女生说她哪里好看怎么回复	女生说她哪里好看怎么回复
心肌酶高怎么办	心机酶高怎么办
痔疮可以吃橘子吗	痔疮可以吃桔子吗
乳房疼是怎么回事	乳妨疼是怎么回事
圣诞节礼物	圣诞接礼物
如何治疗荨麻疹	如何治疗寻麻疹
孕酮多少是怀孕	孕酮多少事怀孕
健脾的食物	建脾的食物
月经来了可以喝啤酒吗	月经来了可以和啤酒吗
湿疹的发病原因	湿诊的发病原因
发烧可以吹空调	发烧可以吹空调
clearimpression是什么品牌	clearimpression是什么品牌
一岁半宝宝能不能认字	一岁半宝宝能不能认字
六类网线的标识	六类网线的标志
小孩打喷嚏流鼻涕吃什么药	小孩打喷涕流鼻涕吃什么药
咳嗽能吃水果	咳嗽能吃水果
武子豪这个名字怎么样	张子豪这个名字怎么样
傅红雪最后和谁在一起	傅季雪最后和谁在一起
年代热水器t十二m三十七价格	年代热水器t十二m三十七价格
六十九除三	六十九除三
脚痒脱皮是什么原因	脚痒拖皮是什么原因
0六年是闰哪个月	0六年是润哪个月
尖锐湿疣传播途径	尖锐湿疣传播途经
房性早搏是怎么回事	房行早搏是怎么回事
怎样把循环小数化成分数方法	怎样把循环小数化成分数方法
二千零一十五的零次方	二千零一十五的零次方
快手怎么查看别人	快手怎么查看别人
晚上吃苹果好	晚上吃苹果好
水泡型脚气怎么办	水泡性脚气怎么办
可以写文章的app	可以写文章的app
孕妇可以做足疗	孕妇可以做足疗
两边肋骨痛是什么原因	两边勒骨痛是什么原因
吃方便面好吗	吃放便面好吗
老虎狮子谁厉害	老虎狮子谁历害
酸汤子的做法视频教程	酸汤子的做法视频教程
怎么去除痘印	怎么去除逗印
肺里有结节	肺里有节节
皮肤有油脂粒怎么去除	皮肤有油脂粒怎么去除
甲状腺结节能吃海参	甲状腺结节能吃海参
乳腺有结节怎么办	乳腺有结界怎么办
负一减一	负一减一
痔疮的危害	痔疮得危害
小布你会唱歌吗	小布你会唱歌吗
单唾液酸四己糖神经节苷脂钠	单唾液酸四几糖神经节苷脂钠
女人吃榴莲有什么好处	女人吃榴莲又什么好处
做仰卧起坐能减肥吗	做仰卧起座能减肥吗
百度在哪里提问	百度在那里提问
治疗灰指甲的药有哪些	治疗灰指甲的药有那些
腰椎间盘突出腰不疼大腿疼	腰椎间盘突出腰不疼大腿疼
紫砂工艺师职称等级	紫砂工艺师职称等级
哺乳期可以打乙肝疫苗	哺乳期可以打乙肝疫苗
脚背痒是怎么回事	教背痒是怎么回事
猫能喝椰汁	猫能喝椰汁
解锁的密码是多少	解锁的密码是多少
十五乘五十六	十五乘五十六
二十四乘二	二十四乘二
甲状腺球蛋白抗体高是什么意思	甲壮腺球蛋白抗体高是什么意思
艾滋病的传播途径有哪些	艾滋病的传播途径有那些
怎么治好荨麻疹	怎么治好寻麻疹
痛风病人能吃菠菜吗	痛风病人能吃波菜吗
保健品能治病	保健品能治病
建行网上修改银行预留手机号	建行网上修改银行预留手机号
你会讲笑话吗	你会讲笑话吗
茶叶蛋的营养价值	茶业蛋的营养价值
怀孕能吃橘子	怀孕能吃橘子
陈苏威歌曲	陈庭威歌曲
心脏造影副作用	心脏照影副作用
经期能喝茶	经期能喝茶
新生儿湿疹怎么办	新生儿时疹怎么办
沈阳铁路四小怎么样	沈阳铁路四小怎么样
怀孕初期可以吃辣条	怀孕初期可以吃辣条
乙肝有哪些症状	已肝有哪些症状
德高防水开裂怎么处理	德高防水开裂怎么处理
上海交大数学专业排名	上海交大数学专业排名
王俊凯在重庆哪里	王俊凯在重庆那里
弟是什么意思	悌是什么意思
打四价疫苗之前注意事项	打四价疫苗之前注意事项
悬挑脚手架多少层验收一次	悬挑脚手架多少层验收一次
阿司匹林和辛伐他丁什么时间吃	阿司匹林和辛伐他丁什么时间吃
二十年工程院院士	二十年工程院院士
奉贤邮编	奉贤邮编
枸杞有什么功效	苟杞有什么功效
洛阳到新蔡县多少公里	洛阳到新蔡县多少公里
猴头手串怎么盘变红视频	猴头手串怎么盘变红视频
空腹血糖正常值范围	空服血糖正常值范围
望谟县复兴镇派出所电话	望谟县复兴镇派出所电话
郑州建行几点上班	郑州建行几点上班
史泰龙有哪些电影	纪泰龙有哪些电影
糖耐有必要做	糖耐有必要做
先兆流产的症状	先找流产的症状
阜阳属于哪里	阜阳属于那里
生肖三合是什么意思	生肖三和是什么意思
眼睛变形怎么恢复	眼睛变性怎么恢复
葛根粉的作用与功效	葛根分的作用与功效
尿酸高是怎么回事	尿酸高是怎么回是
支气管炎咳嗽有痰吃什么好的快	支气管炎咳嗽有痰吃什么好得快
丙型肝炎抗体	丙性肝炎抗体
吉利汽车三月份销量	吉利汽车三月份销量
恐龙是怎么死的	孔龙是怎么死的
逍遥丸和加味逍遥丸有什么区别	消遥丸和加味逍遥丸有什么区别
孕妇可以吃腰果	孕妇可以吃腰果
橙子糖分高吗	橙子糖粉高吗
支付宝可以转账到信用卡	支付宝可以转账到信用卡
都有什么功能	都有什么功能
孕妇可以吃荠菜	孕妇可以吃荠菜
赣州高层次人才引进实施办法	赣州高层次人才引进实施办法
拉肚子吃什么药	垃肚子吃什么药
鼻塞流鼻涕吃什么药	鼻赛流鼻涕吃什么药
芒果湿热吗	芒果是热吗
脚上长水泡怎么办	教上长水泡怎么办
颈椎病怎样治疗	颈椎病怎样制疗
血氧饱和度低	血样饱和度低
月经有血块是怎么回事	月经又血块是怎么回事
张戈的作品	张龙的作品
拉肚子能吃蛋糕	拉肚子能吃蛋糕
梦幻西游手游强化打造项链需要哪种强化石	梦幻西游手游强化打造项链需要哪种强化石
西瓜的功效与作用	西瓜得功效与作用
支气管炎怎么治疗	支气官炎怎么治疗
新生儿黄疸多少正常	新生二黄疸多少正常
浦发银行可以绑定几个手机号码	浦发银行可以绑定几个手机号码
没有反应	没有反应
坐久了腰疼是怎么回事	做久了腰疼是怎么回事
御龙在天转国多少钱	御龙在天转国多少钱
小布你会唱什么歌	小布你会唱什么歌
每天晚上跑步能减肥	每天晚上跑步能减肥
五月应季水果有哪些	五月应季水果有哪些
大便拉不出来怎么办	大便垃不出来怎么办
好听的英文名字	好听的英问名字
一开始虐女主后来宠的小说	一开始虐女主后来宠的小说
艺伎线条多少钱	艺妓线条多少钱
后背疼是怎么回事	后背腾是怎么回事
根据刑法的规定年满周岁以上的人开始承担刑事责任	根据刑法的规定年满周岁以上的人开始承担刑事责任
冰点脱毛永久	冰点脱毛永久
新生儿打嗝怎么办	新生儿打隔怎么办
霍金得的什么病	霍金得得什么病
正往下落得树叶像什么	正往下落的树叶像什么
怎样排除体内湿毒	怎样排出体内湿毒
怀孕可以吃当归	怀孕可以吃当归
明天天气怎么样	明天天气怎么样
脑供血不足怎么治疗	脑功血不足怎么治疗
血糖高的症状	血糖高德症状
吃什么补维生素c	吃什么不维生素c
六百除二十五	六百除二十五
李小林丈夫是谁	布小林丈夫是谁
石家庄著名律师	石家庄著名律师
小孩得了荨麻疹怎么办	小孩得了寻麻疹怎么办
卵巢衰绝无排卵能调理吗	卵巢衰绝无排卵能调理吗
微信号怎么注销	微信号怎么注消
来月经可以喝奶茶	来月经可以喝奶茶
蓝牙耳机怎么用	蓝呀耳机怎么用
孕妇能吃海参吗	孕妇能吃海参妈
手机wps下划线怎么打出来	手机wps下滑线怎么打出来
项目式组织的缺点有	项目式组织的缺点有
拉不出来屎怎么办	拉不出来时怎么办
冀州在哪个省	蓟州在哪个省
解脲支原体阳性怎么办	解尿支原体阳性怎么办
双氯芬酸钠栓的作用与功效	双氯芬酸纳栓的作用与功效
赵本山有上春晚吗	赵本桓有上春晚吗
社区戒毒期限	社区解毒期限
麦滋林饭前吃还是饭后吃	麦兹林饭前吃还是饭后吃
下巴长痘痘的原因	下疤长痘痘的原因
糖尿病人可以吃银耳	糖尿病人可以吃银耳
进到随王位置和至今千里来桐柏中的词合适只	进到随王位置和至今千里来桐柏中的词合适只
怎么把领带系成蝴蝶结	怎么把领带系成蝴蝶结
都城的都的拼音是什么	都城的都的拼音是什么
甲状腺癌能吃豆制品吗	甲壮腺癌能吃豆制品吗
经常流鼻血是什么原因	经常留鼻血是什么原因
母亲节什么时候	母亲杰什么时候
子宫肌瘤能喝蜂蜜	子宫肌瘤能喝蜂蜜
浙江会在哪里	浙江会在那里
昆曲传承的当代意义	昆曲传承的当代意义
哺乳期可以吃薏米吗	哺乳期可以吃薏米马
孕妇可以用双氧水	孕妇可以用双氧水
十楼小高层买几楼最好	十楼小高层买几楼最好
补缴住房公积金可以贷款吗	补交住房公积金可以贷款吗
抑郁症怎么治疗	抑郁症怎么治辽
经期可以喝中药	经期可以喝中药
戴避孕套会怀孕	戴避孕套会怀孕
美菱和半球热水壶哪个好	美菱和半球热水壶哪个好
月经迟迟不来	月经吃迟不来
鬼鬼杨洋快乐大本营第几期	鬼鬼杨洋快乐大本营第几期
你不会说话吗	你不会说话吗
黑豆的功效与作用	黑豆的功效与做用
哺乳期能用面膜	哺乳期能用面膜
肾结石面粉类可以吃	肾结石面粉类可以吃
宋庆龄哪里人	殳庆龄哪里人
农行怎么注册网上银行	农行怎么注册网上银行
白内障怎么治疗	百内障怎么治疗
植物大战僵尸两最强五阶植物	植物大战僵尸两最强五阶植物
行车记录仪什么牌子好	行车纪录仪什么牌子好
来月经能喝茶水吗	来月经能和茶水吗
盆腔积液会影响怀孕	盆腔积液会影响怀孕
穿越火线名字	穿越火线名子
客服电话	客服电话
生理期可以喝红糖水	生理期可以喝红糖水
心脏病吃什么药	心脏病吃什么要
月经淋漓不尽怎么办	月经淋离不尽怎么办
一百除十五	一百除十五
企业所得税政策二千零一十九	企业所得税政策二千零一十九
月经能吃榴莲	月经能吃榴莲
肾功能检查有哪些项目	肾公能检查有哪些项目
你是机器人还是人	你是机器人还是人
角膜炎能治好	角膜炎能治好
oppo手机支持无线充电	oppo手机支持无线充电
多囊卵巢综合症	多馕卵巢综合症
怎么用卡纸做七巧板	怎么用卡纸做七巧板
水稻亩产量多少公斤	水稻亩产量多少公斤
什么是慢性病	什么事慢性病
你可不可以做我女朋友	你可不可以做我女朋友
辽宁各市城建排名	辽宁各市城建排名
怀孕能养猫	怀孕能养猫
取环后要注意什么	取环后要主意什么
微信号怎么改	微信号怎麼改
风油精可以口服吗	风油精可以口福吗
在南方男生一百八十算不算高	在南方男生一百八十算不算高
额头长痘痘是什么原因	额头张痘痘是什么原因
abab式的词语有哪些	abab式的词语有哪些
上航制服款式	上航制服款式
rh血型阳性是什么意思	rh血型阳性是什么意思
乳房疼是怎么回事	乳房疼是怎么回是
耳朵后面长疙瘩	耳朵后面长疙搭
中秋节的月相是什么样的	中秋节的月相是什么样的
世界上最傻的人是谁	世界上最傻的人是谁
手脱皮怎么回事	手脱皮怎么会事
王俊凯是什么星座	王俊杰是什么星座
蓝牙耳机怎么听歌	蓝牙儿机怎么听歌
眼镜看东西有蓝条黄条	眼镜看东西有蓝条黄条
串钩用什么线不缠绕	串钩用什么线不缠绕
哺乳期能喝菊花茶	哺乳期能喝菊花茶
口臭是什么原因引起的	口臭是什麼原因引起的
咳嗽可以喝蜂蜜水	咳嗽可以喝蜂蜜水
甲状腺结节是什么	甲状线结节是什么
经期可以吃芒果	经期可以吃芒果
侧柏叶的功效	则柏叶的功效
驻马店格力空调总代理地址	驻马店格力空调总代理地址
子宫肌瘤需要做手术	子宫肌瘤需要做手术
干眼症如何治疗	干眼证如何治疗
腰压迫神经怎么治疗	腰压破神经怎么治疗
朋友圈微视别人看不到	朋友圈微视别人看不到
淋巴严重	淋巴严重
盆腔积液是什么	盆腔积夜是什么
建行前面几位数	建行前面几位数
如何申请微信号	如和申请微信号
医用外科口罩一次能戴多久	医用外科口罩一次能带多久
充足的近义词可以是足够吗	充足的近义词可以是足够吗
北理工各专业分数线	北理工各专业分数线
鸡蛋和牛奶能一起吃吗	鸡蛋和牛奶能一起吃吗
医用酒精开启后有效期	医用酒精开启后有效期
如何治疗打呼噜	如何治疗大呼噜
裸车十万上路得多少钱	裸车十万上路得多少钱
贫血会引起手抖	贫血会引起手抖
叶绍翁是哪个朝代的	叶少翁是哪个朝代的
宫颈炎症状	宫颈炎正状
奥美拉唑是饭前吃还是饭后吃	奥美拉做是饭前吃还是饭后吃
航天员杨利伟是什么军衔	航天员杨宁伟是什么军衔
r十七屏幕价格	r十七屏幕价格
烧心反酸怎么办	烧心返酸怎么办
舌头俩侧发麻	舌头两侧发麻
小度打开拼多多	小度打开拼多多
行车记录仪有用	行车记录仪有用
咽喉炎怎么治疗	咽喉炎怎么治了
罗浩是哪部电视剧	沈浩是哪部电视剧
七十年女性哪一年退休	七十年女性哪一年退休
荨麻疹是啥样的	寻麻疹是啥样的
八十后女星名字	八十后女性名字
减肥可以吃火锅	减肥可以吃火锅
北京s一线首末时刻表	北京s一线首末时刻表
为什么来电之前先闪一下	为什么来电之前先闪一下
幼儿急疹可以出门	幼儿急疹可以出门
如和培养小孩的学习兴趣	如何培养小孩的学习兴趣
湖北可以进出	湖北可以进出
香蕉牛奶能一起吃	香蕉牛奶能一起吃
结肠黑变病严重	结肠黑变病严重
猕猴桃果汁怎么做	弥猴桃果汁怎么做
脸上的螨虫怎么去除	脸上得螨虫怎么去除
智能驾驶的功能	智能驾驶的功能
感冒吃什么药	敢冒吃什么药
香蕉敷脸治红血丝吗	香蕉敷脸治红血丝吗
孕妇可以吃海带	孕妇可以吃海带
iphone十一自动免提怎么关闭	iphone十一自动免提怎么关闭
怎样在网上赚钱	怎样再网上赚钱
泰迪能吃豌豆	泰迪能吃豌豆
宁波一院口腔科专家	宁波一院口腔科专家
精英律师带的表	精英律师戴的表
形容珍惜的	形容珍惜的
你能做什么	你能做什么
糖尿病能吃荞麦挂面	糖尿病能吃荞麦挂面
爱过的人陪我多少天	爱过的人陪我多少天
白癜风会传染吗	白癜风会传染吗
进入公会有什么用	进入工会有什么用
工行etc信用卡怎么样	工行etc信用卡怎么样
包钢钢业合肥有限责任公司怎么样	包钢钢业合肥有限责任公司怎么样
咳嗽可以吃橙子	咳嗽可以吃橙子
痛风能吃冰淇淋吗	通风能吃冰淇淋吗
美容养颜喝什么茶	美蓉养颜喝什么茶
俄罗斯清洁线好用吗	俄罗斯清洁线好用吗
怎么死不痛	怎么死不通
你玩过王者	你玩过王者
陈薇院士研究的疫苗属于哪类疫苗	陈微院士研究的疫苗属于哪类疫苗
committee的意思中文翻译	committee的意思中文翻译
招行明星理财产品	招行明星理财产品
怀二胎头疼是怎么回事	怀二胎头疼是怎么回事
普洱茶能减肥吗	谱洱茶能减肥吗
平煤大庄矿历任矿长	平煤大庄矿历任矿长
锁屏密码是多少	锁屏密码是多少
我是什么样的人	我是什么样的人
脚趾脱皮是怎么回事	脚指脱皮是怎么回事
孕酮低吃什么	孕酮滴吃什么
你喜欢鹿晗吗	你喜欢鹿晗吗
高俊杰的白兰花的歌词	福俊杰的白兰花的歌词
上海交大在职研究生好考	上海交大在职研究生好考
鸡腿怎么做不油腻还好吃	鸡腿怎么做不油腻还好吃
南宁到郑州火车票	南宁到郑州火车票
心梗的症状有哪些症状	心埂的症状有哪些症状
荨麻疹能用盐水洗	荨麻疹能用盐水洗
拉肚子喝藿香正气水管用吗	拉肚子和藿香正气水管用吗
肝脏血管瘤注意什么	肝脏血官瘤注意什么
痛风能吃红薯	痛风能吃红薯
梅毒的传播途径	梅毒得传播途径
描写乡村生活的段落	描写乡村生活的段落
黄斑水肿怎么治疗	黄班水肿怎么治疗
牙齿有裂痕是什么原因	牙齿有列痕是什么原因
过渡性是什么意思	过度性是什么意思
老是打喷嚏是怎么回事	老是打喷涕是怎么回事
唐山在哪	唐山在哪
怎样改转述句	怎样改传述句
叶伏天和余生是什么关系	叶伏天和余生是什么关系
云时代全屋整装怎样	云时代全屋整装怎样
记忆力差怎么办	记意力差怎么办
湿疹可以打预防针	湿疹可以打预防针
比格巧克力草莓披萨的做法	比格巧克力草莓披萨的做法
英文怎么读	英文怎么度
别人问为什么把他删了	别人问为什么把他删了
宝宝肠炎怎么办	宝宝肠严怎么办
做试管婴儿疼	做试管婴儿疼
爱因斯坦发明了什么	禹因斯坦发明了什么
打完百白破胳膊红肿	打完白白破胳膊红肿
腰左侧疼是怎么回事	要左侧疼是怎么回事
招聘信息的弹性工作是什么意思	招聘信息的弹性工作是什么意思
刮痧后多久可以洗澡	刮痧後多久可以洗澡
天正软件是哪家公司的	天正软件是哪家公司的
a四纸上站人科学原理	a四纸上站人科学原理
泌尿结石吃什么可以排石	秘尿结石吃什么可以排石
激光手术疼	激光手术疼
压力大怎么办	压力打怎么办
开机无反应	开机无反应
榴莲有哪些品种	榴莲有那些品种
膀胱过度活动症的症状	膀胱过度活动证的症状
被马蜂蛰了怎么处理	被马蜂折了怎么处理
八十除五	八十除五
作易者其有忧患乎什么意思	作易者其有忧患乎什么意思
有人宠你像个孩子的下一句	有人宠你像个孩子的下一句
如何绑定银行卡	如和绑定银行卡
精神分裂症吃什么药最好	精神分裂证吃什么药最好
细菌性阴道炎	细菌性阴倒炎
早上空腹喝蜂蜜水好吗	早上空腹和蜂蜜水好吗
周星驰的电影	周星星的电影
六味地黄丸怎么样	六位地黄丸怎么样
甲亢能治愈	甲亢能治愈
干咳吃什么食物好得快	干咳吃什么食物好的快
华为手机屏幕太次	华为手机屏幕太差
零点一百七十五除零点二五	零点一百七十五除零点二五
甲状腺球蛋白高	甲壮腺球蛋白高
猫可以吃橘子吗	猫可以吃桔子吗
至高广州企业管理有限公司	至高广州企业管理有限公司
吃果导片有什么副作用	吃果倒片有什么副作用
慢性咽炎的治疗方法	慢性咽炎得治疗方法
站桩站着满肚子都是气怎么办	站桩站着满肚子都是气怎么办
我怎么舍得生你的气呢	我怎么舍得生你的气呢
陕西计算机二级报名费多少钱	陕西计算机二级报名费多少钱
好听的女生英文名	好听得女生英文名
怎么删除淘宝订单	怎么删除陶宝订单
韵达沈阳到广州要多久	韵达沈阳到广州要多久
一砖多少金	一砖多少金
希望之村选不了服务器进不去	希望之村选不了服务器进不去
闭合性粉刺怎么治疗	闭和性粉刺怎么治疗
产妇可以吃什么零食	产妇可以吃什么零时
罗切斯特的疯妻子是怎么死的	罗切斯特的疯妻子是怎么死的
北京二十年棚改计划	北京二十年棚改计划
郑州到济南汽车时刻表	郑州到济南汽车时刻表
安徽取消一次性奖励	安徽取消一次性奖励
人体有多少根肋骨	人体有多少跟肋骨
靳东演的电视剧	晓东演的电视剧
程咬金是什么生肖	程咬何是什么生肖
因为我聪明的英文翻译	因为我聪明的英文翻译
深蹲可以减肥	深蹲可以减肥
甲亢能吃燕窝	甲亢能吃燕窝
甲哨唑注射夜的副作用	甲哨唑注射夜的副作用
顺序启动实物接线图	顺序启动实物接线图
怎样剪腿上的肉	怎样减腿上的肉
孩子拉不出来屎怎么办	孩子拉不出来是怎么办
运动后多久可以洗澡	运动厚多久可以洗澡
烤箱什么牌子的好	烤箱什么牌子得好
小猫的名字	小猫得名字
小孩子能吃巧克力	小孩子能吃巧克力
怎么把广场舞视频下载到u盘	怎么把广场舞视频下载到u盘
孕妇吃哪些食物容易流产	孕妇吃那些食物容易流产
膝盖疼是怎么回事	膝盖疼是怎么会事
大便变细是怎么回事	大便便细是怎么回事
膀胱炎有什么症状	膀胱炎有什么证状
颈椎病的症状有哪些	颈椎病的证状有哪些
哮喘有哪些症状	哮喘有那些症状
睢宁县魏集中学怎么样	睢宁县魏集中学怎么样
蛔虫药什么时候吃	蛔虫要什么时候吃
网络密码是什么	网络密码是什么
口腔溃疡能吃橙子	口腔溃疡能吃橙子
用手机怎么批照片	用手机怎么劈照片
每晚快走一小时能减肥吗	每晚快走一小时能减肥吗
李亚鹏的学校	程亚鹏的学校
猕猴桃会上火吗	弥猴桃会上火吗
幼儿舌头长泡疹图	幼儿舌头长疱疹图
民政局星期六上班	民政局星期六上班
心堵的慌是怎么回事	心堵得慌是怎么回事
三点一四乘零点二五	三点一四乘零点二五
猴属什么生肖	猴是什么生肖
孕妇能吃酸辣粉	孕妇能吃酸辣粉
交通事故赔护理费怎么算	交通事故赔护理费怎么算
表达离别之情的诗句有哪些	表达离别之情的诗句有哪些
蜜蜂蛰了怎么处理	蜜峰蛰了怎么处理
怀孕了可以纹眉	怀孕了可以纹眉
来月经可以喝红枣水吗	来月经可以和红枣水吗
千字文府罗将相从那篇开始	千字文府罗将相从那篇开始
颈椎变形怎么办	颈椎变型怎么办
鹦鹉怎么绝育	鹦鹉怎么节育
长期大便不成形是什么原因	长期大便不成型是什么原因
瘦脸仪有用	瘦脸仪有用
淋巴细胞百分比偏低	琳巴细胞百分比偏低
朱元漳为什么要大杀功臣	朱元璋为什么要大杀功臣
猝死的前兆是什么	促死的前兆是什么
幽门螺旋杆菌的三联疗法	幽门螺旋杆菌的三连疗法
频发室性早搏三联律	频发室性早搏三连律
吃李子会胖	吃李子会胖
西红柿苹果香蕉可以一起吃吗	西红柿苹果香蕉可以一起吃吗
五行缺土的女孩起名	五行缺土的女孩取名
海带吃了有什么好处	还带吃了有什么好处
怀孕会犯困吗	怀孕会范困吗
苹果手机怎么改字体	苹果手机怎么改自体
甲状腺旁腺瘤严重吗	甲状腺旁线瘤严重吗
词藻华丽的近义词	辞藻华丽的近义词
近视眼会得老花眼	近视眼会得老花眼
电脑开不了机	电脑开不了记
宝宝发烧可以吃橙子	宝宝发烧可以吃橙子
如何去除书中的油墨味	如何去除书中的油墨味
oppo手机是哪个国家的	oppo手机是哪个国家的
建行电话密码忘记了怎么办	建行电话密码忘记了怎么办
最美的安排杨洁结局	最美的安排杨清结局
心肌梗塞有哪些症状	心肌梗塞有那些症状
心绞痛动态心电图能查到吗	心绞痛动态心电图能查到吗
哪一种减肥药效果好	那一种减肥药效果好
八公山服务区在哪里	八公山服务区在哪里
女生会给男生看下面吗	女生会给男生看下面吗
北京站在哪个区	北京站在那个区
你他妈是什么意思	你她妈是什么意思
慢性非萎缩性胃炎伴糜烂	慢行非萎缩性胃炎伴糜烂
一百二十五乘四十	一百二十五乘四十
企业定价时应考虑的因素	企业定价时应考虑的因素
怎么教小孩学算术	怎么教小孩学算数
拔罐拔出水泡怎么办	拔管拔出水泡怎么办
血糖高可以吃玉米吗	雪糖高可以吃玉米吗
肩周炎怎么治疗	见周炎怎么治疗
怎样提高免疫力	怎样题高免疫力
我国十大名画有哪些	我国四大名画有哪些
中信信用卡怎么调账单日	中信信用卡怎么调账单日
艾滋病的前期症状	爱滋病的前期症状
咳嗽有痰怎么办	咳嗽有谈怎么办
柯震东的这款发型怎么剪求大神速解	柯震穆的这款发型怎么剪求大神速解
你今年几岁	你今年几岁
黑枸杞多少钱一斤	黒枸杞多少钱一斤
黑枸杞孕妇能吃	黑枸杞孕妇能吃
戴隐形眼镜可以滴眼药水吗	带隐形眼镜可以滴眼药水吗
手上长鸡眼	手上涨鸡眼
淘宝买手机靠谱吗	淘宝卖手机靠谱吗
胃溃疡可以吃红薯	胃溃疡可以吃红薯
艾滋病会通过唾液传染吗	爱滋病会通过唾液传染吗
上海互邦轮椅总部电话	上海互邦轮椅总部电话
怀孕了拉肚子怎么办	怀孕了垃肚子怎么办
植物神经功能紊乱有哪些症状	植物神精功能紊乱有哪些症状
月经来了可以吃橙子	月经来了可以吃橙子
功能固着和思维定式的区别	功能固着和思维定势的区别
今天气温多少度	今天气温多少度
宽带密码怎么改	宽带秘码怎么改
痔疮可以吃鸡肉	痔疮可以吃鸡肉
拉肚子可以喝粥吗	拉肚子可以和粥吗
怀孕能吃基围虾	怀孕能吃基围虾
怀孕可以吃麻油	怀孕可以吃麻油
月经来了可以洗头	月经来了可以洗头
水状白带是怎么回事	水壮白带是怎么回事
孕妇可以吃薄荷糖	孕妇可以吃薄荷糖
卡布奇诺是什么意思	卡布其诺是什么意思
沈阳养老保险个人缴费	沈阳养老保险个人缴费
禁止空挡滑行	禁止空档滑行
我当阴阳先生的那几年	我当阴阳先生的哪几年
铁皮石斛的功效与作用	铁皮石胡的功效与作用
浙江二千零二十交通事故赔偿标准	浙江二千零二十交通事故赔偿标准
怀孕可以吃棒冰	怀孕可以吃棒冰
怎么使用oppo互传	怎么使用oppo互传
转到财付通的钱去哪了	转到财付通的钱去哪了
蜂蜜的功效与作用	蜂密的功效与作用
表示风的词语	表是风的词语
什么原因导致的甲亢	什么原因导致得甲亢
咦春雨到底是什么颜色的呢类似句	咦春雨到底是什么颜色的呢类似句
十字短句签名	四字短句签名
厦门海警第三支队人员名单	厦门海警第三支队人员名单
今天是农历初几	今天是农历初几
睡前可以喝蜂蜜水	睡前可以喝蜂蜜水
灰指甲传染吗	灰指甲转染吗
螳螂吃蚂蚁	螳螂吃蚂蚁
我是谁你是谁	我是谁你是谁
梦见鞋跟断了	梦见鞋根断了
智宇是什么意思	奥宇是什么意思
二十年浙江哪天出梅	二十年浙江哪天出梅
在五月翻译	在五月翻译
充电的时候能玩手机吗	充电的时候能玩手机吗
喝藿香正气水能喝酒吗	和藿香正气水能喝酒吗
小肚子胀怎么回事	小肚子涨怎么回事
血肌酐正常值	雪肌酐正常值
关掉音乐	关掉音乐
尿毒症的症状有哪些	尿毒证的症状有哪些
网络干是什么意思是什么	网络干是什么意思是什么
怎么才能的高分	怎么才能得高分
蔡文涛是谁	陈文涛是谁
坐骨神经痛症状	坐骨神经痛证状
月经推迟吃什么药	月经退迟吃什么药
咳嗽艾灸哪个穴位	咳嗽艾灸那个穴位
梦到掉牙齿	梦到掉牙吃
腿为什么会抽筋	腿为什么回抽筋
胃炎能吃茄子	胃炎能吃茄子
哪种减肥药安全有效	那种减肥药安全有效
那里批发服装便宜	哪里批发服装便宜
甲状腺结节	甲状线结节
来例假能洗澡吗	来历假能洗澡吗
南瓜怎么做好吃	难瓜怎么做好吃
找梁静茹情歌的歌词要完整版的	找梁静覃情歌的歌词要完整版的
房事后有血怎么回事	房是后有血怎么回事
潮汕桃粿的皮怎么做	潮汕桃粿的皮怎么做
发什么快递	发什么快递
喝酒就拉肚子是怎么回事	喝酒酒拉肚子是怎么回事
无线鼠标推荐	无限鼠标推荐
为什么每天都会做乱七八糟的梦	为什么每天都会做乱七八糟的梦
计算机二级是nit还是ncre	计算机二级是nit还是ncre
明天有雨吗	明天有雨吗
肌肉腿怎么瘦	肌肉腿怎么收
咳嗽可以打预防针	咳嗽可以打预防针
你喜欢我哪里	你喜欢我哪里
赵云出反甲还是不详	赵云出反甲还是不祥
在下图所示同一铸件的两种结构设计方案中哪一个方案是合理的为什么应分别	在下图所示同一铸件的两种结构设计方案中哪一个方案是合理的为什么应分别
杨万里是哪个朝代的	杨咸里是哪个朝代的
经常有口臭是什么原因	经常有口臭是什么原因
泡面可以加生鸡蛋吗	泡面可以加生鸡蛋吗
五百零六乘二十四	五百零六乘二十四
芒果吃了会上火	芒果吃了会上火
航天员杨利伟是什么军衔	航天员杨伏伟是什么军衔
戴cb锁的危害	带cb锁的危害
oppo怎么刷机	oppo怎么刷机
乳癖舒胶囊有什么副作用	乳癖舒胶囊有什么副作用
离骚体现了什么情感	离骚体现了什么情感
经常头痛是什么原因	经常头痛是什么愿因
尿道炎吃什么药	尿导炎吃什么药
菠萝蜜吃了上火	菠萝蜜吃了上火
有没有可以赚钱的游戏	有没有可以赚钱的游戏
怎样腌罗卜干	怎样淹罗卜干
黑米黑豆粥是不是不容易消化	黑米黑豆粥是不是不容易消化
一千零八十p高清画质的	一千零八十p高清画质的
闲鱼的名字可以改吗	咸鱼的名字可以改吗
牧原集团类似的企业	牧原集团类似的企业
缺氧怎么办	缺氧怎么半
大学选修心理学要求	大学选修心理学要求
荣耀小哨兵怎么安装	荣耀小哨兵怎么安装
华侨华人华裔有什么区别	华侨华人华裔有什么区别
临时过生日没有蛋糕怎么办	临时过生日没有蛋糕怎么办
减肥晚上可以吃水果	减肥晚上可以吃水果
十一乘五十	十一乘五十
刘昊然演的综艺	刘浩然演的综艺
属马的是什么命	数马的是什么命
你有情商吗	你有情商吗
月经不调吃什么药	月经不调吃什么要
鸡蛋橘子能一起吃吗	鸡蛋桔子能一起吃吗
髋关节积液的治疗方法	宽关节积液的治疗方法
交强险需要补交吗	交强险需要补缴吗
薄荷的功效与作用	薄荷的功效与做用
胃溃疡什么症状	胃溃阳什么症状
转角处安全标志设在什么位置	转角处安全标志设在什么位置
微信聊天记录怎么备份	威信聊天记录怎么备份
乙型肝炎表面抗体阳性是什么意思	乙性肝炎表面抗体阳性是什么意思
便秘吃什么	便秘吃什药
一百二十乘五	一百二十乘五
拉肚子能不能吃橘子	拉肚子能不能吃桔子
糖尿病患者可以吃火龙果	糖尿病患者可以吃火龙果
秦始皇为什么要建兵马俑	秦始皇为什么要见兵马俑
深圳有什么好玩的地方	深圳有什么好完的地方
你会一直在	你会一直在
四匹一拖三中央空调费电吗	四匹一拖三中央空调费电吗
满月黄疸正常值	满月黄胆正常值
血氧饱和度低怎么办	血养饱和度低怎么办
天翼网关怎么关闭ipv六	天翼网关怎么关闭ipv六
怀孕能吃生蚝	怀孕能吃生蚝
如何判断幼儿急疹	如何判断幼儿急诊
决明子的功效	决明子的功校
血糖高的人能吃橘子吗	血糖高的人能吃桔子吗
打开qq安全中心	打开qq安全中心
网上如何问女生要微信	网上如何问女生要微信
神经官能症的治疗	神经管能症的治疗
三围是哪三围	三维是哪三围
月亮的别称	月亮得别称
what是什么意思	what是什么意思
投诉电话	投诉电话
大空翼是哪个球队的	大平翼是哪个球队的
邓丽君是怎么死的	郑丽君是怎么死的
我的世界怎么去天堂	我的世界怎么去天唐
荨麻疹是怎么引起来的	寻麻疹是怎么引起来的
一万乘一万	一万乘一万
刚出生的婴儿打嗝怎么办	刚出生的婴儿打隔怎么办
孕酮低吃什么补得快	孕酮低吃什么补的快
吃什么长卵泡	吃什么张卵泡
种牙多少钱一颗	种呀多少钱一颗
小腿痒是怎么回事	小腿氧是怎么回事
泰迪可以吃山药	泰迪可以吃山药
戴隐形眼镜能睡觉	戴隐形眼镜能睡觉
激光去痣多少钱	激光取痣多少钱
有跳蚤怎么弄	有跳骚怎么弄
孕妇可以喝杏仁露	孕妇可以喝杏仁露
糖尿病人可以吃莲藕吗	糖尿病人可以吃连藕吗
深圳网络诈骗举报电话号码	深圳网络诈骗举报电话号码
你知道我是男的还是女的	你知道我是男的还是女的
吃榴莲能喝酒吗	吃榴连能喝酒吗
背痛是什么原因	背痛是什麼原因
五岁小儿的正常血压约为	五岁小儿的正常血压约为
多囊卵巢综合征好治	多囊卵巢综合征好治
微信如何升级	微信如何生级
什么是世界文化遗产	什么事世界文化遗产
李白的诗句	李晨的诗句
张彬彬古装电视剧	冷彬彬古装电视剧
邢台到聊城多少公里	邢台到聊城多少公里
帮我把音量调大一点	帮我把音量调大一点
我长得丑吗	我长得丑吗
脚后跟长骨刺怎么办	脚后跟涨骨刺怎么办
孕妇可以喝蜂蜜柚子茶吗	孕妇可以喝蜂密柚子茶吗
南通保险个人和公司的比例	南通保险个人和公司的比例
低血压吃什么好得快	低血压吃什么好的快
扎手指验血能验出是否怀孕么	扎手指验血能验出是否怀孕么
痛风能吃海带	痛风能吃海带
设置一个七点半的闹钟	设置一个七点半的闹钟
右脚大拇指发麻	右脚大母指发麻
怎么制作二维码	怎么制作二维玛
宣政院什么时候设立的	宣政院什么时候设立的
刘恺威多少岁数	刘凯威多少岁数
泽霈什么意思	泽翰什么意思
什么情况下需要根管治疗	什么情况下需要跟管治疗
双肺纹理增多增粗是什么意思	双肺文理增多增粗是什么意思
生姜发芽还能吃	生姜发芽还能吃
橘子皮泡水是酸性还是碱性	橘子皮泡水是酸性还是碱性
糟糕的近义词是什么	糟糕的近义词是什么
宝宝贫血有什么症状	宝宝贫血有什么证状
老年人大脑供血不足吃什么好	老年人大脑供血不足吃什么好
亲密的爱人王若琳什么时候	亲密的爱人金若琳什么时候
韩惠恩用韩文怎样读	韩游恩用韩文怎样读
膀胱炎的症状	膀胱炎的证状
金俊是哪部电视剧	文俊是哪部电视剧
三点四除十等多少	三点四除四等多少
七乘十五	七乘十五
解脲支原体阳性好治	解脲支原体阳性好治
孕妇能吃酸菜	孕妇能吃酸菜
吃什么药来月经	吃什么要来月经
容易出汗怎么办	容易出汗怎么半
铝青铜圆棒重量怎么算	铝青铜圆棒重量怎么算
手搓冰粉的做法	手挫冰粉的做法
沃尔沃最贵的是哪一款价格	沃尔沃最贵的是哪一款价格
腰椎间盘突出症的锻炼方法	腰椎间盘突出症的锻练方法
读书读的多的成语	读书读得多的成语
爱你在干嘛	爱你在干嘛
火锅鸡的做法	活锅鸡的做法
湿气重的症状有哪些	湿气中的症状有哪些
什么情况下需要做胃镜	什么情况下需要作胃镜
肝火旺怎么治	肝火望怎么治
喝咖啡能减肥吗	和咖啡能减肥吗
驾照实习期能扣分	驾照实习期能扣分
慢性胃炎能喝酸奶	慢性胃炎能喝酸奶
哪些食物含维生素d	哪些食物含微生素d
你还会唱什么歌	你还会唱什么歌
打电话给康伟	打电话给钟伟
剖腹产后怎样减肥	破腹产后怎样减肥
什么是寒性体质	什么事寒性体质
心肌受损怎么治疗	心机受损怎么治疗
晚上吃梨好吗	晚上吃黎好吗
输卵管堵塞会宫外孕	输卵管堵塞会宫外孕
新型肺炎对中小企业的影响	新型肺炎对中小企业的影响
高血压怎么治疗	高血压怎么治辽
头发有头皮屑怎么办	头发又头皮屑怎么办
输尿管末端结石好排吗	输尿管末端结石好牌吗
手指关节痛怎么治疗	手只关节痛怎么治疗
淘宝钻石号是什么意思	淘宝钻石号是什么意思
豆腐渣白带能自愈	豆腐渣白带能自愈
小说主角叶枫	小说主角秦枫
华夏京东支付有积分	华夏京东支付有积分
什么洗发水好	什么洗法水好
结业证书有用	结业证书有用
慕丝妮火鸡面是国产的	慕丝妮火鸡面是国产的
喝红茶上火吗	和红茶上火吗
梦见下大雪	梦见吓大雪
两k二十职业业余混合赛怎么加入球队	两k二十职业业余混合赛怎么加入球队
做引产疼	做引产疼
痛经吃什么	痛经吃什药
男朋友是用来干嘛的	男朋友是用来干嘛的
融洽的词语	融洽的词语
牌照能换	牌照能换
自动测量海拔高度软件	自动测量海拔高度软件
鼻窦炎的症状	鼻逗炎的症状
脂肪肝能吃鸡肉	脂肪肝能吃鸡肉
牛油果怎么吃	牛油国怎么吃
昆明离阜阳有多远	昆明离阜阳有多远
什么是美尼尔氏综合症	什么是美尼尔氏综合证
肾结石要注意什么	肾结石要主意什么
心率慢是什么原因	心律慢是什么原因
佳敏的拼音	淑敏的拼音
肝痛是在哪个位置	肝痛是在那个位置
怎么在网上交电费	怎么再网上交电费
苹果官方回收价格查询在哪里	苹果官方回收价格查询在哪里
金华汽车开锁公司电话	金华汽车开锁公司电话
什么食物降血糖	什么食物绛血糖
带有政字的女孩名字	带有政字的女孩名字
燃气灶打不着火是什么原因	然气灶打不着火是什么原因
哺乳期能吃头孢克洛咀嚼片吗	哺乳期能吃头孢克洛咀嚼片吗
甲醛有气味吗	甲荃有气味吗
尿酸高能治愈	尿酸高能治愈
肉苁蓉怎么泡酒	肉苁蓉怎么炮酒
世界文化遗产古城位于什么省	世界文化遗产古城位于什么省
头部伽玛刀十大副作用	头部伽马刀十大副作用
吗啡片多长时间起效	吗啡片多长时间起效
胃胀气怎么回事	胃长气怎么回事
胸部胀痛是不是怀孕了	胸部帐痛是不是怀孕了
糖尿病人可以吃地瓜	糖尿病人可以吃地瓜
社保能补缴十五年吗	社保能补交十五年吗
绘画形式有那些	绘画形式有哪些
朱耷的字	朱棣的字
ace两的价格	ace两的价格
颈椎病引起头晕怎么办	颈椎病引气头晕怎么办
评价一下王源	评价一下王源
节约用水下一句怎么说	节约用水下一句怎么说
初霜和御剑仙女杯怎么区分	初霜和御剑仙女杯怎么区分
五十岁男脸上长黑斑了怎么办	五十岁男脸上长黑斑了怎么办
脚后跟痛怎么办	角后跟痛怎么办
刘昊然参加过什么综艺	刘昊然参加过什么综艺
白云是什么	白风是什么
大拇指疼怎么办	大姆指疼怎么办
剖腹产坐月子能吃虾吗	剖腹产做月子能吃虾吗
形容林徽因的成语有哪些	形容林徽因的成语有哪些
刺激性食物有哪些	刺激性实物有哪些
为什么会得白血病	为什么会德白血病
教学过程流程图的基本内容	教学过程流程图的基本内容
妊娠糖尿病可以吃小米粥	妊娠糖尿病可以吃小米粥
即可以组什么词	既可以组什么词
乳腺结节需要手术吗	乳腺结节须要手术吗
人流后多久可以洗澡	人流厚多久可以洗澡
子宫疼怎么回事	字宫疼怎么回事
做无痛胃镜要多少钱	作无痛胃镜要多少钱
李白的诗句	李娟的诗句
什么食物养胃	什么事物养胃
大姨妈期间可以拔牙	大姨妈期间可以拔牙
苹果手机怎么定位	苹果手机怎么订位
做肠镜多少钱	做肠竟多少钱
酒喝多了头疼怎么办	就喝多了头疼怎么办
怎么关机	怎么关机
中国交通最差的城市	中国交通最差的城市
痛风能喝绿豆汤	痛风能喝绿豆汤
肝右叶小囊肿	肝右叶小囊中
经常放屁是怎么回事	经常放屁事怎么回事
中国与美国的文化差异有哪些英文	中国与美国的文化差异有哪些英文
假性湿疣会自己消失	假性湿疣会自己消失
贵阳鸿通城是什么时候开业的	贵阳鸿通城是什么时候开业的
喝阿莫西林能喝酒吗	喝啊莫西林能喝酒吗
他长得帅吗	他长得帅吗
黑龙江明星演员	黑龙江明星演员
治疗腰间盘突出	治疗腰间盘凸出
孕妇可以吃马蹄	孕妇可以吃马蹄
青岛城区常住人口	青岛城区常住人口
穿什么衣服	穿什么衣服
甲状腺炎症状	甲状线炎症状
金乡九星花园物业电话	金乡九星花园物业电话
现在什么行业好做	现在什麼行业好做
怎么查看自己的手机号码	怎么察看自己的手机号码
孕妇什么时候开始补钙	孕服什么时候开始补钙
幽门螺旋杆菌高温能杀死吗	优门螺旋杆菌高温能杀死吗
世界人口最多的国家是哪个	世界人口最多的国家是那个
比熊能吃红薯	比熊能吃红薯
人流后可以吃水果	人流后可以吃水果
长痘痘可以敷面膜吗	张痘痘可以敷面膜吗
王羲之是哪个朝代的人	王夫之是哪个朝代的人
后边牙齿坏了一个窟窿	后边牙齿坏了一个窟窿
铁山港潮汐表	铁山港潮汐表
什么是肺结节	什么是肺结结
胆结石可以吃鸭蛋	胆结石可以吃鸭蛋
霉菌性阴道炎怎么治疗	霉菌性阴道炎怎么治了
脸上长斑怎么办	脸上长办怎么办
我的手机是什么版本	我的手机是什么版本
如何取消分隔符	如何取消分格符
土豆属于发物	土豆属于发物
主持人怎么介绍领导致辞	主持人怎么介绍领导致辞
米黄色裤子配什么上衣	米黄色裤子陪什么上衣
月经量少影响怀孕吗	月经亮少影响怀孕吗
怀孕可以吃花螺	怀孕可以吃花螺
猎人宝宝换不了天赋	猎人宝宝换不了天赋
新生儿黄疸高怎么办	新声儿黄疸高怎么办
照样子写词语	照样子解词语
你说你喜欢上了谁	你说你喜欢上了谁
有没有人喜欢我	有没有人喜欢我
白带是排卵	白带是排卵
猪脚闷莲藕的做法大全家常	猪脚焖莲藕的做法大全家常
血红蛋白高是怎么回事	学红蛋白高是怎么回事
现在的你在干嘛	现在的你在干嘛
拔火罐可以去湿气吗	把火罐可以去湿气吗
先是声音嘶哑后咳嗽晚上加重	先是声音嘶哑后咳嗽晚上加重
霉菌性阴道炎能怀孕	霉菌性阴道炎能怀孕
申请公众号提示姓名不匹配	申请公众号提示姓名不匹配
治疗白癜风的药物有哪些	治疗白殿风的药物有哪些
智能家居房间管理功能	智能家居房间管理功能
怀孕初期白带多	怀孕初期白带多
公主连接母猪石怎么得	公主连结母猪石怎么得
明星人气榜投票	名星人气榜投票
感动中国十大人物	敢动中国十大人物
小孩剪什么发型好看	小孩减什么发型好看
面膜补水效果好的	面膜补水效果好的
冬天荨麻疹	冬天寻麻疹
女孩子取什么名字好听	女孩子娶什么名字好听
正确处理改革发展稳定三者的结合点是	正确处理改革发展稳定三者的结合点是
荨麻疹该怎么治疗	荨麻疹改怎么治疗
十二星座里面谁打架最厉害	十二星座里面谁打架最厉害
缥缈的释义	飘渺的释义
城身份证开头	城身份证开头
瘦腿霜有用	瘦腿霜有用
来月经可以吃木瓜	来月经可以吃木瓜
到此为止用文言文怎么说	到此为止用文言文怎么说
过敏性鼻炎怎么治	过敏星鼻炎怎么治
酸奶什么时候喝最好	酸奶什么时侯喝最好
中石化财务部主任	中石化财务部主任
胚胎生化有那些前兆	胚胎生化有哪些前兆
小米三恢复出厂设置	小米三恢复出厂设置
两个字聚财网名	两个字聚财网名
游戏术语hp	游戏术语hp
四百九十除七	四百九十除七
游戏账号怎么找回	游戏账号怎么找回
刮痧后多久可以洗澡	刮莎后多久可以洗澡
尿毒症能治好吗	尿毒症能知好吗
艾滋病检测多久出结果	爱滋病检测多久出结果
六十二点八除三点一四	六十二点八除三点一四
湖北十八年高考人数	湖北十八年高考人数
仓鼠身上有跳蚤怎么办	仓鼠身上有跳蚤怎么办
慢性浅表性胃炎伴糜烂	漫性浅表性胃炎伴糜烂
r十七proar测量功能	r十七proar测量功能
银行卡能在手机上办吗	银行卡能在手机上办吗
怀孕初期可以吃金针菇	怀孕初期可以吃金针菇
重庆哪些是三甲医院	重庆那些是三甲医院
什么是半月板损伤	什么是半月半损伤
女生做什么工作比较好	女生坐什么工作比较好
怀孕能喝苹果醋	怀孕能喝苹果醋
林俊杰专辑为啥小十四	冉俊杰专辑为啥小十四
人为什么要睡觉	仁为什么要睡觉
学生买的保险生病了可以报销吗	学生买的保险生病了可以报销吗
十四乘十四	十四乘十四
吃完榴莲不能吃什么	吃完榴连不能吃什么
慢性非萎缩性胃炎能吃方便面吗	慢性非萎缩性胃炎能吃方便面吗
称怎么组词	称怎么组词
打电话给王思	打电话给王文
宝宝几个月可以坐	宝宝几个月可以座
拉肚子能吃橘子	拉肚子能吃橘子
三百六十乘十五	三百六十乘十五
山药的功效与作用	山药的功效与做用
可以帮我打王者吗	可以帮我打王者吗
豆浆会发胖	豆浆会发胖
免疫球蛋白多少钱一针	免疫求蛋白多少钱一针
乳腺结节怎么治最好	乳腺节节怎么治最好
青岛和大连哪个好	青岛和大连那个好
实用新型和外观设计专利权的期限	使用新型和外观设计专利权的期限
天上下来的人很多吗	天上下来的人很多吗
招行宝可梦卡年费	招行宝可梦卡年费
你为什么不唱歌	你为什么不唱歌
联通员工总数数量	联通员工总数数量
食用油过期能吃	食用油过期能吃
省呗借钱必须要买会员吗	省呗借钱必须要买会员吗
怀孕初期白带多正常	怀孕初期白带多正常
三视图怎么画	三视图怎么花
流鼻血怎么办	留鼻血怎么办
现在怎么办	现在怎么办
张曼玉结过几次婚	邓曼玉结过几次婚
十月四日是什么星座	四月四日是什么星座
心率不齐严重	心率不齐严重
马群有建行	马群有建行
滑石粉的功效与作用	华石粉的功效与作用
感冒能吃橘子吗	感冒能吃桔子吗
初至天目双清庄记	处至天目双清庄记
甲状腺球蛋白抗体高是怎么回事	甲壮腺球蛋白抗体高是怎么回事
忽如一夜春风来千树万树梨花开是哪个季节	呼如一夜春风来千树万树梨花开是哪个季节
孕妇能吃玉米	孕妇能吃玉米
吃避孕药会流血吗	吃避孕药会留血吗
吃完药能喝牛奶	吃完药能喝牛奶
腰疼是怎么回事	腰疼事怎么回事
血压低是贫血	血压低是贫血
胃癌都有哪些症状	胃癌都有那些症状
脚丫子痒有水泡怎么回事	脚丫子痒有水泡怎么回事
冷冻鳕鱼的做法	冷冻雪鱼的做法
肚子胀气怎么办	肚子胀气怎么半
怀孕能喝苹果醋吗	怀孕能和苹果醋吗
鹿晗和黄子韬张艺兴关系	鹿晗和黄子韬张艺兴关系
女孩子大腿根部疼痛是什么原因	女孩子大腿根部疼痛是什么原因
孕妇早期可以吃辣条吗	孕妇早起可以吃辣条吗
你会唱你笑起来真好看吗	你会唱你笑起来真好看吗
四十亿零八百零三万零六百九十五这电话正规吗	四十亿零八百零三万零六百九十五这电话正规吗
花甲的形状是什么样子	花甲的形状是什么样子
韩红个人捐款多少钱了	韩红个人捐款多少钱了
月初十是什么星座	月初四是什么星座
范冰冰整容了吗	海冰冰整容了吗
大便排不出来怎么办	大便拍不出来怎么办
手爆皮是怎么回事	手报皮是怎么回事
体检怎样才能避免胸透	体检怎样才能避免胸透
修眉的注意事项	绣眉的注意事项
低血压的危害	低血压得危害
标志杆厂家六千二百六十六一七百八十八沧州胜翔实体厂家电话	标志杆厂家六千二百六十六一七百八十八沧州胜翔实体厂家电话
吃避孕药月经会推迟多久	吃避孕要月经会推迟多久
关于王熙凤的诗词	关于王熙爱的诗词
经期能喝红茶	经期能喝红茶
孕妇能吃卤肉	孕妇能吃卤肉
哺乳期可以吃葡萄	哺乳期可以吃葡萄
补中益气丸的功效	补中一气丸的功效
二十乘二十四	二十乘二十四
月经期间可以喝绿茶吗	月经期间可以和绿茶吗
甲状腺结节能吃海苔	甲状腺结节能吃海苔
艾叶可以泡水喝	艾叶可以泡水喝
月经期可以喝益母草吗	月经期可以喝意母草吗
阿飞是谁	阿鹏是谁
招行账户管理费怎么取消	招行账户管理费怎么取消
孕妇可以吃核桃	孕妇可以吃核桃
带状疱疹怎么治疗	带装疱疹怎么治疗
垃圾桶怎么折	垃圾筒怎么折
福州到长沙多少公里	福州到长沙多少公里
正常血压范围	正常学压范围
关节响是怎么回事	关结响是怎么回事
孕妇可以吃黄鳝吗	孕妇可以吃黄善吗
类风湿能治愈	类风湿能治愈
怎样在手机上挣钱	怎样再手机上挣钱
什么是世界文化遗产	十么是世界文化遗产
熬夜有什么危害	熬夜有什么威害
川大是不是重本	川大是不是重本
你是不是有毛病	你是不是有毛病
余秋雨的作品	余秋里的作品
如何补气血	入何补气血
红外可见分光光度法	红外可见分光光度法
角声满天秋色里前一句	角声满天秋色里前一句
康宁的盘子可以加热吗	康宁的盘子可以加热吗
本机电池容量	本机电池容量
那应该怎么回答	那应该怎么回答
嗓子哑了怎么办	嗓子哑了怎么班
南京哪最好玩	南京那最好玩
怀孕能吃木耳	怀孕能吃木耳
鸡肉痛风可以吃吗	鸡肉通风可以吃吗
避孕药有副作用	避孕药有副作用
朱兰是什么花	铁兰是什么花
皮肤痒一抓就红	皮肤养一抓就红
撒的多音字组字	散的多音字组字
痘痘留下的黑点怎么办	痘痘留下的黑点怎么办
上海快三技巧	上海快三技巧
九百除五	九百除五
李华是什么朝代	李越是什么朝代
宝宝发烧可以开空调	宝宝发烧可以开空调
左旋肉碱胶囊有用	左旋肉碱胶囊有用
佝偻病是什么	佝楼病是什么
六乘八	六乘八
哺乳期能吃茄子吗	补乳期能吃茄子吗
莲子的功效与作用	莲子的工效与作用
苹果手机为什么一卡顿就重启	苹果手机为什么一卡顿就重启
如何调字体大小	如何调字体大小
肾炎的症状	肾炎得症状
胃不好喝什么	胃不好和什么
你喜欢打王者	你喜欢打王者
坐月子期间能吃红薯吗	做月子期间能吃红薯吗
评价诸葛亮	评价诸葛明
嘴巴周围长痘	最巴周围长痘
血小板增多症	血小板赠多症
怀孕会肚子疼吗	怀孕回肚子疼吗
六十六除六	六十六除六
天津下雨了	天津下雨了
硫磺皂洗脸好吗	流磺皂洗脸好吗
非布司他可以长期吃吗	非布斯他可以长期吃吗
上错花轿嫁对主题曲	上错花轿嫁对主题曲
东丽学校排行	东丽学校排行
一港币等多少人民币	一港币等多少人民币
妊娠糖尿病可以喝纯牛奶	妊娠糖尿病可以喝纯牛奶
粉底液哪个牌子好	粉底液那个牌子好
世界上最美的女人是谁	世界上最美的女人是谁
例假前十天是安全期吗	例假前四天是安全期吗
肾结石吃什么好	肾结实吃什么好
办公楼窗户的常规尺寸	办公楼窗户的常规尺寸
华罗庚是什么样的人	华柯庚是什么样的人
怎么不吃	怎么不吃
肺上有结节	肺上有结界
荆芥性味归经功效主治	荆芥性味归经功效主治
六味地黄丸有副作用	六味地黄丸有副作用
糖尿病可以吃黄瓜	糖尿病可以吃黄瓜
检查艾滋病多久出结果	检查爱滋病多久出结果
如何设置语音唤醒	如何设置语音唤醒
哮喘能根治吗	哮喘能跟治吗
牛奶和榴莲能一起吃	牛奶和榴莲能一起吃
怎么修改手机号	怎么修改手机号
大便不成形次数多是什么原因	大便不成型次数多是什么原因
一百乘一千	一百乘一千
血糖高吃什么水果好	雪糖高吃什么水果好
蛋黄胆固醇高	蛋黄胆固醇高
我能考多少分	我能考多少分
植物晚上释放的是二氧化碳还是氧气	植物晚上释放的是二氧化碳还是氧气
流产后的注意事项	流产后的住意事项
波司登羽绒服公司在哪里	波司登羽绒服公司在哪里
社保卡怎么激活	社宝卡怎么激活
玻璃体混浊会导致失明吗	玻璃体浑浊会导致失明吗
桥本甲状腺炎能吃海带	桥本甲状腺炎能吃海带
怀孕可以吃莴笋吗	怀孕可以吃窝笋吗
飞机上能带生羊肉吗	飞机上能带生羊肉吗
试管婴儿多少钱	试官婴儿多少钱
陈丹青关于祖国的言论	陈丹青关于祖国的言论
你最喜欢哪个星座	你最喜欢哪个星座
乙肝大三阳传染	乙肝大三阳传染
拉的屎是黑色的	啦的屎是黑色的
益母草的功效与作用	益母草的工效与作用
刘涛结婚了	刘涛结婚了
楼梯的词语	楼梯的词语
小腹痛是怎么回事	小腹痛是怎麼回事
被蚂蚁咬了怎么办	被吗蚁咬了怎么办
世界十大动物儿童电影排名	世界十大动物儿童电影排名
眼肌型重症肌无力治疗	眼肌形重症肌无力治疗
格力售后服务电话	格立售后服务电话
副处级干部几年后升正处	副处级干部几年后升正处
桑叶的功效与作用	桑什的功效与作用
你会做什么	你会做什么
佟大为老婆是谁	蒋大为老婆是谁
中联重科董事长是谁	中联重科懂事长是谁
丈夫的医保卡可以给老婆生孩子报销吗	丈夫的医保卡可以给老婆生孩子报销吗
霉菌性阴道炎	霉菌行阴道炎
百多邦可以擦肛门吗	百多邦可以搽肛门吗
射手女和水瓶男的配对指数	射手女和水平男的配对指数
四维彩超有必要做	四维彩超有必要做
子宫内膜癌十年不复发	子宫内膜癌十年不复发
苯甲酸钠抑制什么菌	苯甲酸钠抑制什么菌
糖尿病可以吃胡萝卜吗	糖尿病可以吃胡罗卜吗
删除u盘密码	删除u盘密码
伊利纯牛奶好	伊利纯牛奶好
感冒了能吃冰激凌	感冒了能吃冰激凌
吃减肥药会反弹	吃减肥药会反弹
我要运动	我要运动
怎么改无线网密码	怎么改无限网密码
练习本的长约两什么	练习本的长约两什么
四十三乘二	四十三乘二
ip六十八防水等级	ip六十八防水等级
婴儿打嗝是什么原因	婴儿打隔是什么原因
石家庄花样年华小区怎么样	石家庄花样年华小区怎么样
苯和汽油互融吗	苯和汽油互溶吗
高血压能吃带鱼	高血压能吃带鱼
科颜氏为什么放骷髅	科颜氏为什么放骷髅
怎么查询中考成绩	怎么查寻中考成绩
一百八十°的余弦值是多少	一百八十°的余弦值是多少
失眠怎么办	失眠怎么办
什么是疱疹	什么事疱疹
白癜风能吃黄瓜	白癜风能吃黄瓜
交行网银转账限额	交行网银转账限额
结节性痤疮是什么	结节型痤疮是什么
脾虚湿气重吃什么药	脾需湿气重吃什么药
怎么说的	怎么说的
尖锐湿疣怎么治疗	尖锐湿疣怎么治了
你有脑袋	你有脑袋
林志颖的老婆是谁	牟志颖的老婆是谁
real原声技术哪样	real原生技术哪样
学驾照刷学时什么意思	学驾照刷学时什么意思
化州属于哪个地级市	化州属于哪个地级市
子宫肌瘤能吃豆类	子宫肌瘤能吃豆类
一百二十乘七十三	一百二十乘七十三
月经期能喝茶	月经期能喝茶
多高的身高可以扣篮	多高的身高可以扣篮
来月经能吃海鲜	来月经能吃海鲜
乙肝病毒表面抗体阳性是什么意思	已肝病毒表面抗体阳性是什么意思
复方黄柏液涂剂可以坐浴吗	复方黄柏液涂剂可以坐浴吗
疫苗都是病毒制成的吗	疫苗都是病毒制成的吗
黑头怎么去掉	黒头怎么去掉
oppowatch的价格	oppowatch的价格
被骗二十块钱报警有用吗	被骗二十块钱报警有用吗
打狂犬疫苗注意事项	打狂犬疫苗主意事项
经期可以吃葡萄	经期可以吃葡萄
现在公认为最好的杀毒软件是哪个	现在公认为最好的杀毒软件是哪个
三十七度一算发烧	三十七度一算发烧
什么物流可以运活鸡	什么物流可以运活鸡
创维电视音量自动回零	创维电视音量自动回零
四百八十除十二	四百八十除十二
广东什么时候开始考全国卷	广东什么时候开始考全国卷
梦见戴手环	梦见带手环
乡下手工棉裤裁剪教程	乡下手工棉裤裁剪教程
刚受孕成功后会腹痛	刚受孕成功后会腹痛
镇康邮政编码	镇康邮政编码
不可想象不能理解的成语	不可想像不能理解的成语
湖北有多少个市县	湖北有多少个市县
经期可以泡脚吗	经期可以跑脚吗
爸爸去哪主题曲	爸爸去哪主体曲
经常用开塞露有什么副作用	经常用开赛露有什么副作用
张俊豪的电影	张子豪的电影
天猫什么时候活动力度大	天猫什么时候活动力度大
上海有名的酒吧聚集地	上海有名的酒吧聚集地
一岁宝宝能吃火龙果	一岁宝宝能吃火龙果
长时间站着能减肥	长时间站着能减肥
股票买的人多好还是卖的人多好	股票卖的人多好还是买的人多好
社保能补交	社保能补交
一百二十除八	一百二十除八
孕妇可以喝咖啡吗	孕妇可以和咖啡吗
怀孕mt检查	怀孕nt检查
肾结石患者可以吃南瓜	肾结石患者可以吃南瓜
你在干什么	你在干什么
成龙带的什么眼镜	成龙戴的什么眼镜
开封的植物油能放多久	开封的植物油能放多久
支付宝可以买充值卡吗	支付宝可以卖充值卡吗
晚上喝牛奶会长高吗	晚上和牛奶会长高吗
肺部衣原体感染症状	肺部依原体感染症状
六乘九	六乘九
什么是大三阳	什么事大三阳
李治廷和范冰冰什么关系	华治廷和范冰冰什么关系
你是什么oppo	你是什么oppo
晚上跑步减肥	晚上跑步减肥
文娱类完结小说排行榜	文娱类完结小说排行榜
gta五自由视角怎么用	gta五自由视角怎么用
喝酒喝多了会不会出现什么幻觉	喝酒喝多了会不会出现什么幻觉
你知道是	你知道是
天猫京东哪个好	天猫京东那个好
肾癌的症状	肾癌得症状
脸上长脂肪粒怎么回事	脸上张脂肪粒怎么回事
糜丽的拼音	糜竺的拼音
脚指头痒是怎么回事	脚只头痒是怎么回事
柯基能吃桃	柯基能吃桃
怎么孵小鸡	怎么孚小鸡
发烧的症状	发烧得症状
孕妇可以吃料酒吗	孕妇可以吃料酒马
新生儿喉咙有痰怎么办	新生儿喉咙有谈怎么办
纸船怎么折	只船怎么折
比比东的魂技是什么	比比东的魂技是什么
脸上长痘痘是什么原因	脸上涨痘痘是什么原因
现在多少点	现在多少点
人生是什么	认生是什么
类似一百二十三木头人的游戏	类似一百二十三木头人的游戏
大脑供血不足的症状	打脑供血不足的症状
被开水烫伤起泡怎么办	被开水汤伤起泡怎么办
颈部淋巴结肿大	颈不淋巴结肿大
白云是什么	龙云是什么
慢性胃炎能吃海带	慢性胃炎能吃海带
注意力不集中	主意力不集中
rap是什么意思	rap是什么意思
珠海皮肤疾病的医院	珠海皮肤疾病的医院
如何降尿酸	如何将尿酸
柯南中好看经典的柯哀集数	茅南中好看经典的柯哀集数
养猫需要打疫苗	养猫需要打疫苗
你有喜欢的人	你有喜欢的人
吃葡萄上火	吃葡萄上火
得失心疯了是什么意思	得失心疯了是什么意思
小米账号怎么注销	小米帐号怎么注销
舌头有黑点	舌头又黑点
初中求角度的方法总结	初中求角度的方法总结
乳腺看什么科	乳线看什么科
男生第一次吃延时药可以吗	男生第一次吃延时药可以吗
cad编组后不能解除编组	cad编组后不能解除编组
吃冰糖会发胖	吃冰糖会发胖
什么是汗斑	什么是汉斑
马丽年龄	牛丽年龄
刘德华最新电影有哪一些	桓德华最新电影有哪一些
如何查询自己的手机号	如何查寻自己的手机号
好听的男孩名字	好听的男孩名子
小肚子疼是怎么回事	小度子疼是怎么回事
书籍的装订方法有哪些	书籍的装订方法有哪些
山东有什么海	山东有什么海
放疗一次多少钱	放了一次多少钱
关于红军长征的诗	关于红军长征的事
电脑游戏里打字总是字母怎么办	电脑游戏里打字总是字母怎么办
怎么样去黑眼圈	怎么样取黑眼圈
游泳可以减肥	游泳可以减肥
微信密码忘记了怎么办	薇信密码忘记了怎么办
乙肝能自愈	乙肝能自愈
演员傅亨年龄	演员傅淼年龄
老放屁怎么办	老方屁怎么办
哺乳期感冒可以喝板蓝根吗	哺乳期感冒可以和板蓝根吗
同姓的人可以结婚	同姓的人可以结婚
今天星期几	今天星期几
为什么手机收不到验证码	为什么手机收不到验正码
乳腺增生能不能吃蜂蜜	乳腺增升能不能吃蜂蜜
失眠了怎么办	失眠了怎么办
上眼皮长斑是怎么回事	上眼皮长斑是怎么回事
逍遥丸能治黄褐斑吗	消遥丸能治黄褐斑吗
李连杰演的中华英雄结局	苏连杰演的中华英雄结局
来月经能练瑜伽	来月经能练瑜伽
湖北的什么面有青岛什么面有台湾	湖北的什么面有青岛什么面有台湾
体温计要量多久	体温计要两多久
哺乳期怀孕了还会有奶水	哺乳期怀孕了还会有奶水
离过年还有多久	离过年还有多久
游戏为什么退不出来	游戏为什么退不出来
荔枝上火	荔枝上火
孕妇可以吃香菜	孕妇可以吃香菜
坐月子可以吃鹿茸吗	做月子可以吃鹿茸吗
声字的笔顺笔画	声字的笔顺笔划
中暑会肚子疼吗	中署会肚子疼吗
新生儿打嗝怎么办	新生儿打嗝怎么半
被召唤巨人是什么体验笔趣阁	被召唤巨人是什么体验笔趣阁
什么轮胎噪音小抓地力好	什么轮胎噪音小抓地力好
苏轼哪个朝代	姚轼哪个朝代
李艺泽这个名字怎么样	李雨泽这个名字怎么样
宁波属于哪个市	宁波属于那个市
新生儿可以吹风扇	新生儿可以吹风扇
西红柿首富在哪拍的	西红柿首富在那拍的
里巴巴如何开店	里巴巴如何开店
附近有什么好吃的	附近有什么好吃的
怎么样的	怎么样的
白云是什么	白巩是什么
糖尿病人能喝牛奶吗	糖脲病人能喝牛奶吗
膀胱炎有什么症状	膀胱炎有什么症壮
何炅老婆是谁	海炅老婆是谁
纳兹怎么画	纳尔怎么画
女的被男的叉什么感觉	女的被男的插什么感觉
怎么使胸变大	怎么是胸变大
妊娠糖尿病可以吃南瓜	妊娠糖尿病可以吃南瓜
什么是内分泌失调	什么是内分必失调
个人简历自我评价怎么写	个人简力自我评价怎么写
种植牙多少钱一颗	种植牙多少钱一科
甘蔗和马蹄煮水的功效与作用	甘蔗和马蹄煮水的功效与作用
学水彩可以找什么工作	学水彩可以找什么工作
五十乘七十	五十乘七十
抑郁症治疗方法	抑郁证治疗方法
肠胃炎能吃橙子	肠胃炎能吃橙子
正方体的体积	正方体的体积
珠江零度保质期多久	珠江零度保质期多久
做完人流可以吃巧克力	做完人流可以吃巧克力
肩周炎是什么症状	肩周炎是什么症状
俩腿之间有疙瘩	两腿之间有疙瘩
石英砂用途	石英沙用途
如果卫星通过k二十一地区的间隔时间服从指数分布	如果卫星通过k二十一地区的间隔时间服从指数分布
肚子痛拉肚子怎么办	肚子痛啦肚子怎么办
双相情感障碍的患病率	双向情感障碍的患病率
乙型肝炎表面抗体阳性是什么意思	已型肝炎表面抗体阳性是什么意思
孕妇可以吃甜瓜	孕妇可以吃甜瓜
八位数颜色代码	八位数颜色代码
月经后几天是安全期	月经后几天事安全期
宝宝发烧能吹风扇吗	宝宝发烧能吹凤扇吗
家长意见和建议	家长意见和建意
护士转行可以做什么	护士转型可以做什么
三十mm是多少厘米	三十mm是多少厘米
练单杠可以治疗腰椎间盘突出吗	练单杠可以治疗腰椎间盘突出吗
试述生长素极性运输的机理	试述生长素极性运输的机理
贾玲多少岁了	嘉玲多少岁了
我有多重	我有多重
黄海波和高圆圆什么关系	黄海波和屈圆圆什么关系
浙江应急管理厅办公室主任是谁	浙江应急管理厅办公室主任是谁
什么是功能性	什么事功能性
海南买车上牌新政策	海南买车上牌新政策
血糖偏高怎么办	雪糖偏高怎么办
什么时候清明节	什么时侯清明节
大乐透怎么中奖	大乐透怎么种奖
四角粽子做法	四角粽子做法
摔伤了涂什么药好得快	摔伤了涂什么药好的快
我家的wifi密码是多少	我家的wifi密码是多少
二乘五	二乘五
响水是不是贫困县	响水是不是贫困县
一百八十乘十五	一百八十乘十五
新生儿为什么老打嗝	新生儿为什么老打隔
姜柏的功效与作用	姜子的功效与作用
蓬江哪里有鸡叫	蓬江哪里有鸡叫
肠息肉有哪些症状	肠西肉有哪些症状
江苏二建缴费	江苏二建缴费
三百五十八的立方根	三百五十八的立方根
男人大腿根部内侧瘙痒	男人大腿根部内测瘙痒
左手发麻怎么回事	左手发麻怎么会事
糖尿病能活多久	唐尿病能活多久
多西他赛副作用	多西他塞副作用
不吃晚饭可以减肥	不吃晚饭可以减肥
凯立德导航怎么升级	凯立得导航怎么升级
坐月子吃什么好	座月子吃什么好
酷睿i五万四千五百七十配什么主板	酷睿i五万四千五百七十配什么主板
老式显微镜有收藏的	老式显微镜有收藏的
孩子上火流鼻血怎么办	孩子上火留鼻血怎么办
中老年适合什么工作	中老年适合什么工作
为什么睡觉会打呼噜	为什么睡觉会打呼噜
不吃米饭只吃菜能瘦	不吃米饭只吃菜能瘦
胃不好能吃西瓜	胃不好能吃西瓜
声音怎么这么小	声音怎么这么小
为什么眼睛总是睡不醒的感觉	为什么眼睛总是睡不醒的感觉
二乘四	二乘四
胡桃木地板搭配什么颜色的家具	胡桃木地板搭配什么颜色的家具
女性内分泌失调吃什么药	女姓内分泌失调吃什么药
关节松动术的适应证	关节松动术的适应症
怎样去除眼袋	怎样去出眼袋
oppo客服电话	oppo客服电话
表格四次方怎么打出来	表格十次方怎么打出来
周文王活了多少岁	周宣王活了多少岁
如何预防青春痘	如何预防青春豆
卵子的存活时间	卵子的存火时间
我爱的人是谁	我爱的人是谁
眼皮上长麦粒肿怎么办	眼皮上张麦粒肿怎么办
不吃早餐的危害	不吃早餐的威害
小说主角叶枫	小说主角凌枫
七十七年这年的高考不是在夏天而是在哪一天	七十七年这年的高考不是在夏天而是在哪一天
长智齿疼怎么办	张智齿疼怎么办
关羽怎么死的	项羽怎么死的
猫为什么舔爪子	猫为什么添爪子
妇科纳囊是什么病	妇科那囊是什么病
血管堵塞吃什么好	血管赌塞吃什么好
你生病了吗	你生病了吗
乙肝大三阳会传染	乙肝大三阳会传染
按哪个穴位可以缓解头晕	按哪个穴位可以缓解头晕
国家环境质量标准由哪里制定	国家环境质量标准由哪里制定
大象的耳朵想什么	大象的耳朵象什么
心电图导联位置	心点图导联位置
今天多少号	今天多少号
荨麻疹能吃橙子吗	寻麻疹能吃橙子吗
胆囊炎可以吃红薯	胆囊炎可以吃红薯
你怎么不睡觉	你怎么不睡觉
绝对温度的零度是	绝对温度的零度是
结扎了还能接上吗	接扎了还能接上吗
工行是不是倒闭了	工行是不是倒闭了
浙商银行的理财产品	浙商银行的理财产品
偶像练习生每个人的名字	偶像练习生每个人的名字
我是你大哥吗	我是你大哥吗
一般纳税人可以使用普通发票吗	一般纳税人可以使用普通发票吗
胃不好可以吃葡萄	胃不好可以吃葡萄
怎么数胎动	怎么书胎动
形容春天雨夜的古诗词	形容春天雨夜的古诗词
咸鱼卖东西靠谱吗	闲鱼卖东西靠谱吗
珍五金装与珍品珍酒哪个好	珍五金装与珍品珍酒哪个好
你能唱歌给我听吗	你能唱歌给我听吗
明天几度	明天几度
小腹痛怎么回事	小服痛怎么回事
放疗和化疗有什么区别	方疗和化疗有什么区别
怀不了孕做哪些检查	怀不了孕做那些检查
可以帮我打游戏吗	可以帮我打游戏吗
南京治疗糖尿病最好的医院	南京治疗糖尿病最好的医院
小度打开抖音	小度打开抖音
二百八十乘四	二百八十乘四
两个月宝宝下颚有白点	两个月宝宝下颚有白点
印度带鼻环什么意思	印度带鼻环什么意思
诸暨医保局在什么地方	诸暨医保局在什么地方
肾结石会引起尿潜血	肾结石会引起尿潜血
鼻咽癌可以治愈	鼻咽癌可以治愈
乙型肝炎病毒核心抗体	乙性肝炎病毒核心抗体
鼻梁上有鸡皮疙瘩一样的小痘怎么办	鼻梁上有鸡皮疙瘩一样的小痘怎么办
你认识王俊凯吗	你认识王俊凯吗
龟头炎会传染给女性	龟头炎会传染给女性
二尖瓣三尖瓣轻度反流	二间瓣三尖瓣轻度反流
农行员工人数	农行员工人数
招行开户行号	招行开户行号
脚面扭伤红肿该怎么办呀	脚面扭伤红肿该怎么办呀
司马迁名言	明马迁名言
台式无线网卡什么牌子的好	台式无线网卡什么牌子的好
精神分裂症吃什么药好	精神分列症吃什么药好
被鬼上身怎么办	背鬼上身怎么办
二十三乘五十	二十三乘五十
陕西出省务工的健康证在哪里办理	陕西出省务工的健康证在哪里办理
吃降压药能喝酒吗	吃将压药能喝酒吗
今天是几号	今天是几号
心情不好怎么调节	心情不好怎么调解
肾结石能吃橘子	肾结石能吃橘子
拉肚子能吃蒜	拉肚子能吃蒜
荨麻疹可以吃鸡翅吗	寻麻疹可以吃鸡翅吗
吃鸡灵敏度怎么调最稳苹果十一	吃鸡灵敏度怎么调最稳苹果十一
我是你的谁	我是你的谁
手链掉河里了有没有打捞的工具	手链掉河里了有没有打捞的工具
补脾胃的食物有哪些	补脾胃的食物有那些
易烊千玺帅吗	易烊千玺帅吗
宽带密码怎么查	宽带蜜码怎么查
没有wifi	没有wifi
泰迪可以吃米饭	泰迪可以吃米饭
沈阳十二中学是重点吗	沈阳十二中学是重点吗
属蛇七月出生好不好	属蛇七月出生好不好
新生儿两手抓的紧紧的	新生儿两手抓的紧紧的
浑身冷不发烧怎么回事	混身冷不发烧怎么回事
你不困吗	你不困吗
韵达送到几点	韵达送到几点
斗罗大陆四为什么不更新了	斗罗大陆四为什么不更新了
感冒喉咙痛吃什么药好	感帽喉咙痛吃什么药好
你现在在干嘛呀	你现在在干嘛呀
李涵这个名字怎么样	杨涵这个名字怎么样
脸上汗毛多怎么去除	脸上汗毛多怎么祛除
二十年山东退休养老金调整方案	二十年山东退休养老金调整方案
月子里能吃蛋糕	月子里能吃蛋糕
大腿内侧磨的疼	大腿内侧磨得疼
白面少红薯多可以做出馒头	白面少红薯多可以做出馒头
六除二	六除二
肚子饿了怎么办	度子饿了怎么办
朝阳离大连多远	朝阳离大连多远
刷牙时牙龈出血怎么办	刷牙是牙龈出血怎么办
小腿酸痛是什么原因	小退酸痛是什么原因
细胞的结构和功能概念图	细胞的结构和功能概念图
张无忌和张三丰谁厉害	张无忌和张三史谁厉害
枸杞怎么保存	苟杞怎么保存
哪个牌子拖把好	那个牌子拖把好
坐骨神经痛症状	座骨神经痛症状
腰椎间盘突出能做仰卧起坐	腰椎间盘突出能做仰卧起坐
学音乐难	学音乐难
海边欢快的歌曲有哪些	海边欢快的歌曲有哪些
冬虫夏草和什么一起吃比较好	冬虫夏草和什么一起吃比较好
喝什么可以去湿气	和什么可以去湿气
肾阴虚吃什么药	肾阴虚吃什么要
糖尿病吃什么蔬菜好	糖尿病吃什么蔬才好
孕妇能吃生蚝	孕妇能吃生蚝
孕妇能喝柠檬蜂蜜水	孕妇能喝柠檬蜂蜜水
神庭的准确位置和作用	神庭的准确位置和作用
高血糖可以吃什么水果	高雪糖可以吃什么水果
来例假可以喝酸奶	来例假可以喝酸奶
小数有哪三部分组成	小数有哪三部分组成
草珊瑚的功效与作用	草珊湖的功效与作用
现在几点钟了	现在几点钟了
脚趾甲有瘀血怎么办	脚趾甲有淤血怎么办
吴中离哪个高铁站近	吴中离哪个高铁站近
宅是啥意思	斋是啥意思
食物中毒症状	食物种毒症状
卡莎哪个皮肤	卡沙哪个皮肤
肩袖损伤的治疗方法	肩秀损伤的治疗方法
abb写词语	abb写词语
肠梗阻怎么治疗	肠梗组怎么治疗
科二约了几天可以看见结果	科二约了几天可以看见结果
糖尿病能治好	糖尿病能治好
什么属于大变局中存在的风险	什么属于大变局中存在的风险
建行养老理财产品	建行养老理财产品
邵阳属哪个地区	邵阳是哪个地区
膀胱癌的症状	膀胱癌的证状
痛风不能吃哪些食物	痛风不能吃那些食物
李湘和王岳伦离婚了吗	敖湘和王岳伦离婚了吗
葡萄减肥可以吃	葡萄减肥可以吃
感冒喝什么药	感冒和什么药
脸上长斑的原因	脸上长斑得原因
增强记忆力的食物	增强计忆力的食物
经期可以喝桂圆红枣茶	经期可以喝桂圆红枣茶
急性咽炎严重了会怎么样	急性咽炎严重了会怎么样
前列腺炎的治疗方法	前列腺炎得治疗方法
怀孕能吃米酒	怀孕能吃米酒
海丰码头到镇海怎么走	海丰码头到镇海怎么走
中国最大的鱼具市场	中国最大的渔具市场
肝硬化有什么症状	肝硬化有什么症状
肺炎的症状	肺炎得症状
马超怎么死的	班超怎么死的
血清阳性是什么意思	血青阳性是什么意思
甲状腺肿大的症状	甲状腺肿大得症状
怎样申请微信号	怎样伸请微信号
子宫纤维性粘连是什么意思	子宫纤维性粘连是什么意思
西南交大研究生拟录取名单	西南交大研究生拟录取名单
谢娜追张杰追了多久	谢娜追张杰追了多久
杨宇轩名字怎么样	李宇轩名字怎么样
怎么连蓝牙	怎么连蓝牙
无花果糖尿病人能吃吗	无花果糖尿并人能吃吗
眼睛冒绿光	眼镜冒绿光
得了脂肪肝怎么办	的了脂肪肝怎么办
视频特效的功能	视频特效的功能
宝宝鼻炎鼻塞晚上严重怎么办	宝宝鼻炎鼻塞晚上严重怎么办
蓝爸爸叫什么	胥爸爸叫什么
oppo怎么投屏	oppo怎么投屏
小赢易贷怎么样靠谱吗	小赢易贷怎么样靠谱吗
高血压可以坐飞机	高血压可以坐飞机
新西兰是澳大利亚的	新西兰是澳大利亚的
怀孕一个月可以药流	怀孕一个月可以药流
三十厘米等多少立方厘米	三十厘米等多少立方厘米
黄体破裂严重	黄体破裂严重
古代皇子好听的字辈	古代皇子好听的字辈
骨刺怎样治疗比较好	骨刺怎样治疗比较好
百合的功效与作用	百合的功效与做用
风神h三十自动挡怎么样	风神h三十自动挡怎么样
黄芩的功效与作用	黄芩的功效与做用
二十五乘二十五	二十五乘二十五
一个人吃午饭的心情	一个人吃午饭的心情
低血糖是糖尿病吗	低雪糖是糖尿病吗
孕妇可以吃燕麦片	孕妇可以吃燕麦片
怀孕初期能吃方便面	怀孕初期能吃方便面
绿豆糕的做法	绿豆糕的作法
十堰离武汉有多远	十堰离武汉有多远
杨幂的英语怎么写	杨琼的英语怎么写
孕妇能吃皮皮虾	孕妇能吃皮皮虾
钟汉良结婚了啊	成汉良结婚了啊
压疮的预防措施	压疮得预防措施
湿疹能吃橘子吗	湿疹能吃桔子吗
扣肚脐眼有什么坏处	抠肚脐眼有什么坏处
月经后几天容易怀孕	月精后几天容易怀孕
尿液混浊是怎么回事	尿夜混浊是怎么回事
打印机扫描不好用是电脑的问题吗	打印机扫描不好用是电脑的问题吗
已婚妇女戒指戴哪个手指	已婚妇女戒指带哪个手指
怀孕后手掌周围红中间白	怀孕后手掌周围红中间白
女主强大男主宠的小说	女主强大男主宠的小说
华为畅享十怎么设置图形密码	华为畅享十怎么设置图形密码
喉咙痛可以吃橙子	喉咙痛可以吃橙子
手脱皮是什么原因	手拖皮是什么原因
ct诊断是人工还是机器	ct诊断是人工还是机器
脑梗塞病人吃什么食物好	脑更塞病人吃什么食物好
你是个美女吗	你是个美女吗
西安到郑州多少公里	西安到郑州多少公里
你会长大	你会长大
方天画戟削苹果什么梗	方天画戟削苹果什么梗
王琳凯几岁	华琳凯几岁
六月一号需要带头盔吗	六月一号需要带头盔吗
三十二乘二十四	三十二乘二十四
嘴唇长疱疹是什么原因	嘴唇长泡疹是什么原因
现在干啥	现在干啥
小孩换牙是全换	小孩换牙是全换
咳嗽吃什么药好的快	咳嗽吃什么药好得快
电脑用手机热点打天龙八部	电脑用手机热点打天龙八部
厦大的热门专业	厦大的热门专业
apple是什么意思	apple是什么意思
月经期间能敷面膜	月经期间能敷面膜
低血糖的症状有哪些	低雪糖的症状有哪些
南通在哪个省	南通在那个省
通州区政务大厅电话	通州区政务大厅电话
嗓子疼能吃冰淇淋	嗓子疼能吃冰淇淋
左眼一直跳怎么回事	昨眼一直跳怎么回事
恶性肿瘤是癌症	恶性肿瘤是癌症
舌苔厚腻是怎么回事	舌态厚腻是怎么回事
测血糖需要空腹吗	侧血糖需要空腹吗
血小板偏高	血小版偏高
喉咙发炎可以吃雪糕	喉咙发炎可以吃雪糕
蒲公英能降血压吗	蒲公英能将血压吗
感冒喝什么汤好	感冒和什么汤好
吃太胀了怎么办	吃太涨了怎么办
迷你世界陷阱怎么做	迷你世界陷阱怎么做
建行信用卡怎样激活使用方法	建行信用卡怎样激活使用方法
生物之间物质和能量的传递主要是通过	生物之间物质和能量的传递主要是通过
脚心疼怎么回事	脚心疼怎么会事
四川哪个地方吃兔子有名	四川哪个地方吃兔子有名
怎样快速长高	怎样快速张高
口字旁的当	口字旁的当
带状疱疹的症状	带状疱疹的正状
可乐和雪碧哪个好喝	可乐和雪碧哪个好喝
联想电脑已重置应用默认设置	联想电脑已重置应用默认设置
龙泉驿长	龙泉驿长
三十六乘六	三十六乘六
喝完益母草颗粒肚子胀	喝完益母草颗粒肚子胀
糖尿病可以吃黄瓜吗	塘尿病可以吃黄瓜吗
伊可尔治疗扁平疣	伊可儿治疗扁平疣
带状泡疹最佳治疗方法	带壮泡疹最佳治疗方法
月经期能吃桔子吗	月经期能吃橘子吗
肺炎会传染吗	肺炎会传染吗
从工资中扣回代垫分录	从工资中扣回代垫分录
宫颈癌前期有什么症状	宫颈癌前期有什么证状
左下腹痛怎么回事	左下复痛怎么回事
长征一号是什么运载火箭	长征一号是什么运载火箭
拉肚子可以吃酸奶	拉肚子可以吃酸奶
拉肚子挂什么科	拉肚子挂什么课
孕妇能吃蛏子	孕妇能吃蛏子
迷你牛奶盲盒的制作方法	迷你牛奶盲盒的制作方法
一喝酒头疼怎么回事	一喝就头疼怎么回事
怀孕肚子胀怎么回事	怀孕肚子帐怎么回事
月经期间可以喝蜂蜜吗	月经期间可以和蜂蜜吗
嘉兴有什么好玩的地方	嘉兴有什么好玩的地方
怎么治疗静脉曲张	怎么制疗静脉曲张
耳朵痒是怎么回事	耳朵庠是怎么回事
二百除四十	二百除四十
一加六怎么使用两张电信卡	一加六怎么使用两张电信卡
时间水印照片怎么拍	时间水印照片怎么拍
范冰冰整容了吗	李冰冰整容了吗
红糖的功效与作用	红糖得功效与作用
糖尿病可以吃橙子	糖尿病可以吃橙子
最厉害的武器是什么	最历害的武器是什么
分数怎么化成小数	分数怎么划成小数
衡阳中国人民银行上班时间	衡阳中国人民银行上班时间
来月经可以吃阿胶	来月经可以吃阿胶
手腕酸痛是怎么回事	手湾酸痛是怎么回事
磷酸奥司他韦颗粒是消炎药	磷酸奥司他韦颗粒是消炎药
艾灸能天天做	艾灸能天天做
北京五环的房价是多少	北京五环的房价是多少
宝宝感冒鼻塞怎么办	宝宝感冒鼻赛怎么办
这个世界上谁最帅	这个事界上谁最帅
李丽珍的电影	李玉珍的电影
王一博喜欢肖战吗	王一博喜欢肖战吗
有什么好看的电视剧	有什么好看的电视剧
你是机器人	你是机器人
这个很好笑吗	这个很好笑吗
三十六除二	三十六除二
nvidia控制面板怎么调出来	nvidia控制面板怎么调出来
中山几个区	中山几个区
头围正常双顶径偏小原因	头围正常双顶径偏小原因
来月经可以喝豆浆吗	来月经可以喝豆江吗
什么玛丽亚	什么玛利亚
怎么登陆vps	怎么登录vps
你在玩什么游戏	你在玩什么游戏
急性心肌梗死的治疗方法	急性心机梗死的治疗方法
怀孕初期可以吃生蚝	怀孕初期可以吃生蚝
怎样用电脑破解wifi	怎样用电脑破解wifi
天气怎么样	天气怎么样
火影忍者四代火影秽土转生哪一集	火影忍者四代火影秽土转生哪一集
治口腔溃疡的药	制口腔溃疡的药
蚊子会传播艾滋病吗	蚊子会转播艾滋病吗
来月经能吃生蚝	来月经能吃生蚝
心率低的原因	心律低的原因
小儿肺炎有哪些症状	小儿肺炎有那些症状
额头下巴长痘痘是什么原因	额头下巴涨痘痘是什么原因
肺炎有少量胸腔积液不住院行吗	肺炎有少量胸腔积液不住院行吗
鲜鲍鱼怎么做好吃	先鲍鱼怎么做好吃
鸡蛋豆浆能一起吃	鸡蛋豆浆能一起吃
心率过缓是怎么回事	心律过缓是怎么回事
痛风能吃馒头	痛风能吃馒头
酒醉的蝴蝶是谁作的曲	酒醉的蝴蝶是谁做的曲
狗粮猫能吃	狗粮猫能吃
拔牙多少钱	把牙多少钱
尖锐湿疣是怎么得的	尖锐湿疣是怎么得得
下巴玻尿酸多久可以打第二针	下巴玻尿酸多久可以打第二针
妊娠糖尿病能吃玉米吗	妊娠唐尿病能吃玉米吗
咽炎会发烧	咽炎会发烧
林俊杰专辑为啥小十四	宰俊杰专辑为啥小十四
人工授精的孩子健康吗	人工受精的孩子健康吗
肠炎能吃红薯	肠炎能吃红薯
枸杞红枣泡水喝的功效	狗杞红枣泡水喝的功效
王俊凯的学校在哪	种俊凯的学校在哪
写三月春暖花开的句子	写三月春暖花开的句子
桥本氏甲减会遗传	桥本氏甲减会遗传
跑步之后全身酸痛第二天还要跑吗	跑步之后全身酸痛第二天还要跑吗
张sir是什么意思	姚sir是什么意思
姐姐的女儿叫什么	姐姐得女儿叫什么
abb的词语有	abb的词语有
广播电视播音员主持人资格证	广播电视播音员主持人资格证
荨麻疹注意事项	荨麻诊注意事项
新鲜竹笋怎么做不麻嘴	新鲜竹笋怎么做不麻嘴
我能行吗	我能行吗
怀孕第一个月有什么反应	怀孕第一个月有什么反映
网上定火车票怎么取票	网上订火车票怎么取票
怎么才能长高	怎麼才能长高
绝味鸭脖加盟费多少	决味鸭脖加盟费多少
交行周六周日上班	交行周六周日上班
渭南的大学	渭南的大学
孕妇拉肚子怎么办	孕妇拉肚子怎么半
根号六	根号六
红细胞计数偏高是什么原因	红细胞记数偏高是什么原因
怀男孩的症状	怀男孩的证状
尖锐湿疣的症状	尖锐湿疣的正状
中暑会拉肚子	中暑会拉肚子
商务公司起名	商务公司取名
怎么开心呢	怎么开心呢
身份证号码怎么	身份证号码怎么
尿液有泡沫是怎么回事	尿液有泡末是怎么回事
见闻vip怎么样	见闻vip怎么样
梅毒是艾滋病	梅毒是艾滋病
坐月子能做面膜吗	做月子能做面膜吗
听力九十五分贝能上学吗	听力九十五分贝能上学吗
月经推迟两天正常	月经推迟两天正常
申子的意思	白子的意思
你会萝莉音吗	你会萝莉音吗
尿液长期发黄是什么原因造成的	尿液长期发黄是什么原因造成的
肾结石会影响怀孕	肾结石会影响怀孕
售后换屏需要手工费嘛	售后换屏需要手工费嘛
头皮上长痘痘是怎么回事	头皮上涨痘痘是怎么回事
股骨头坏死怎么治	股骨头坏死怎么制
正当防卫四手机版怎么下	正当防卫四手机版怎么下
奥美拉唑饭前吃还是饭后吃	奥美垃唑饭前吃还是饭后吃
办健康证需要空腹吗	班健康证需要空腹吗
都安到南宁拼车顺风车群	都安到南宁拼车顺风车群
请问三十二寸电视机什么牌子好	请问三十二寸电视机什么牌子好
陈烈的近义词	陈胜的近义词
电饼铛哪个牌子好	电饼挡哪个牌子好
华为密码忘记了怎么手动刷机	华为密码忘记了怎么手动刷机
六味地黄丸哪个牌子好	六味地黄丸那个牌子好
花儿为什么那么红	花儿未什么那么红
二十四乘八	二十四乘八
怎么降血糖	怎么将血糖
孕后期可以吃冰淇淋	孕后期可以吃冰淇淋
慢性阑尾炎需要手术	慢性阑尾炎需要手术
今天有什么新闻	今天有什么新闻
oppowatch防水	oppowatch防水
水果什么时候吃最好	水果什么时侯吃最好
拉肚子可以吃橘子	拉肚子可以吃橘子
牙痛怎么治	牙痛怎么志
九十六年七点二十三号什么星座	九十六年七点二十三号什么星座
双相情感障碍的诊断	双向情感障碍的诊断
经常放屁是怎么回事	经常方屁是怎么回事
转氨酶高有什么症状	转氨酶高有什么证状
拉肚子可以喝粥	拉肚子可以喝粥
老式热水器安装	老式热水器安装
孟浩然是哪里人	木浩然是哪里人
最好的避孕方法	最好得避孕方法
脚踝骨疼是怎么回事	脚怀骨疼是怎么回事
bb霜排名	bb霜排名
如何制定公司制度	如何制订公司制度
河北省内异地就医备案流程	河北省内异地就医备案流程
频发房性早搏严重吗	频发房性早博严重吗
小儿生长发育的一般规律	小二生长发育的一般规律
家里突然来了一只鸟好不好	家里突然来了一只鸟好不好
肺癌吃不下饭能撑多久	肺癌吃不下饭能撑多久
西安西三爻属于哪个区	西安西三爻属于哪个区
更改报税人需要什么资料	更改报税人需要什么资料
荨麻疹中医如何治疗	寻麻疹中医如何治疗
电话是谁发明的	电话是谁发名的
胆囊炎可以喝牛奶吗	胆囊炎可以和牛奶吗
西安反诈骗中心地址	西安反诈骗中心地址
牙齿痛怎么办	牙吃痛怎么办
吉林恒大温泉小镇在哪里	吉林恒大温泉小镇在哪里
桔子糖分高吗	桔子糖份高吗
神威参麦注射剂价格	神威参麦注射剂价格
心肌梗塞有哪些症状	心机梗塞有哪些症状
尿道炎是怎么引起的	尿到炎是怎么引起的
孕妇能吃冰棍	孕妇能吃冰棍
晚上跑步能减肥吗	晚上跑不能减肥吗
痛风可以吃毛豆	痛风可以吃毛豆
羊奶和牛奶哪个好	羊奶和牛奶那个好
吃烧烤会胖	吃烧烤会胖
苏茜的英文怎么写	苏姗的英文怎么写
怀孕木耳能吃	怀孕木耳能吃
你喜欢王俊凯	你喜欢王俊凯
怀孕会尿频吗	怀孕回尿频吗
什么是心率不齐	什么事心率不齐
康妇消炎栓为什么是直肠给药	康复消炎栓为什么是直肠给药
中考让带手表吗	中考让戴手表吗
oppo蓝牙音箱断开连接的设备	oppo蓝牙音箱断开连接的设备
荨麻疹能吃姜	寻麻疹能吃姜
王者怎么用别人的微信登陆	王者怎么用别人的微信登录
你会吹口哨吗	你会吹口哨吗
蜂蜜水什么时候喝好	风蜜水什么时候喝好
中国服装上市公司第一品牌是	中国服装上市公司第一品牌是
盆腔积液会影响怀孕吗	盆腔积液回影响怀孕吗
耳朵痒是怎么回事	儿朵痒是怎么回事
慢性肠胃炎吃什么药	漫性肠胃炎吃什么药
神经炎是什么症状	神精炎是什么症状
你知道我是谁吗	你知道我是谁吗
月经不调怎么办	月经不条怎么办
经期可以吃什么水果	经期可以吃什麼水果
中暑会肚子疼	中暑会肚子疼
怎么分辨公鸭母鸭	怎么分辩公鸭母鸭
九百九十九乘九十九	九百九十九乘九十九
扁桃体发炎化脓吃什么药	扁桃体发炎化浓吃什么药
华为怎么给苹果无线充电	华为怎么给苹果无限充电
党员有哪些权利	党员有那些权利
来月经可以喝姜糖水吗	来月经可以和姜糖水吗
怎么打开反向充电	怎么打开反向充电
小孩咳嗽吃什么好的快	小孩咳嗽吃什么好得快
嗓子哑怎么办	嗓子哑怎么班
乌鸦是怎么叫的文字	乌鸦是怎么叫的文字
脚趾甲往肉里长怎么办	脚止甲往肉里长怎么办
孕妇喝纯牛奶好	孕妇喝纯牛奶好
火车进站前几分钟停止检票	火车进站前几分钟停止检票
脸上长了脂肪粒怎么办	脸上张了脂肪粒怎么办
胃肠功能紊乱的症状	胃肠工能紊乱的症状
陈情表出自哪位西晋文学家	陈情表出自哪位西晋文学家
六味地黄丸的功效	六位地黄丸的功效
供血不足吃什么	公血不足吃什么
何为严重侵害赠与人的情形	何为严重侵害赠与人的情形
下肢静脉曲张的治疗	下支静脉曲张的治疗
强直性脊椎炎的症状	强直性脊椎严的症状
子宫肌瘤能吃燕窝	子宫肌瘤能吃燕窝
六十八号机械润滑油的性能	六十八号机械润滑油的性能
大乐透怎么算中奖	大乐头怎么算中奖
怎么不行	怎么不行
紫癜有什么症状	紫殿有什么症状
胃肠功能紊乱的症状	胃肠功能稳乱的症状
怀孕可以吃龙眼	怀孕可以吃龙眼
深圳物价局客服电话	深圳物价局客服电话
乙烯使高锰酸钾溶液褪色的化学方程式	乙烯使高锰酸钾溶液褪色的化学方程式
坐地铁恶心呼吸不上来	坐地铁恶心呼吸不上来
酒酿一定要烧熟了才能吃	酒酿一定要烧熟了才能吃
肝脏不好有什么症状	肝脏不好有什么正状
莲子孕妇可以吃	莲子孕妇可以吃
海参小孩可以吃	海参小孩可以吃
小孩能吃秋葵	小孩能吃秋葵
甲状腺功能减退能治好	甲状腺功能减退能治好
原油下跌对中石化的影响	原油下跌对中石化的影响
荨麻疹会不会传染	荨麻诊会不会传染
拉肚子能打预防针吗	啦肚子能打预防针吗
毛囊炎症状	毛囊炎证状
微信收款码怎么删除收款记录	微信收款码怎么删除收款记录
你什么时候升级	你什么时候升级
开塞露有副作用	开塞露有副作用
柠檬泡水功效	宁檬泡水功效
偏头痛是怎么引起的	遍头痛是怎么引起的
熟牛蹄筋的蘸料怎么做	熟牛蹄筋的蘸料怎么做
做肠镜需要多长时间	做肠境需要多长时间
晚上吃香蕉有什么好处	晚上吃香焦有什么好处
肠胃炎会发烧	肠胃炎会发烧
井上雄彦死了	井上雄彦死了
肩膀长痘痘是什么原因	肩膀张痘痘是什么原因
二十年五月suv汽车销量	二十年五月suv汽车销量
诸葛亮的儿子是谁	诸葛明的儿子是谁
东莞到杭州	东莞到杭州
什么人不适合吃芒果	什么人不适合吃忙果
艾滋病身上会痒	艾滋病身上会痒
朱开山是哪个地方的人	朱开滕是哪个地方的人
哪些网站可以免费发布信息	那些网站可以免费发布信息
小腿酸胀是怎么回事	小腿酸帐是怎么回事
雷锋祭日是哪天	赵锋祭日是哪天
要聊什么呢	要聊什么呢
心脏早搏是怎么引起的	心脏早博是怎么引起的
喉咙有痰是怎么回事	候咙有痰是怎么回事
大便便不出来怎么办	大便变不出来怎么办
胃恶心想吐	为恶心想吐
南航是在机场北还是机场南	南航是在机场北还是机场南
肠胃炎吃什么药	常胃炎吃什么药
楚瑜的意思	策瑜的意思
戴避孕套会怀孕吗	待避孕套会怀孕吗
西宁高铁站在哪里	西宁高铁站在哪里
我女儿叫什么	我女儿叫什么
甲状腺胶质结节超声描述	甲状腺胶质结节超声描述
色弱可以考驾照	色弱可以考驾照
怀孕可以吃无花果干	怀孕可以吃无花果干
用英语怎么读	用英语怎么读
你谈过几次恋爱	你谈过几次恋爱
身体水分低怎么回事	身体水份低怎么回事
李贺人称什么	李元人称什么
江苏师范大学有哪些专业怎么样	江苏师范大学有哪些专业怎么样
电烤箱能烤什么	电烤箱能考什么
大姨妈来了要注意什么	大姨妈来了要主意什么
冰箱为什么不制冷	冰箱为什么不治冷
怀孕能不能泡温泉	怀孕能不能跑温泉
梦中的婚礼简谱	梦中的婚礼间谱
糖尿病能吃红枣	糖尿病能吃红枣
霍金得的什么病	霍金德的什么病
尚品雪花粉是什么面粉	尚品雪花粉是什么面粉
频发室性早搏三联律	频发室性早搏三联率
仓鼠能吃蛋糕	仓鼠能吃蛋糕
左下眼皮跳是怎么回事	左下眼皮条是怎么回事
红薯糖分高吗	红署糖分高吗
有痰咳不出来吃什么药	有谈咳不出来吃什么药
脚底长水疱很痒怎么办	脚底长水泡很痒怎么办
程颖是什么朝代	慎颖是什么朝代
新鲜莲子的功效与作用	新鲜连子的功效与作用
怎样才能戒烟	怎样才能介烟
脚痒脱皮起水疱是怎么回事	脚痒脱皮起水泡是怎么回事
怎么不一样	怎么不一样
教师资格证有有效期	教师资格证有有效期
足浴器哪个牌子好	足浴器那个牌子好
梦到自己遇到危险但自救了	梦到自己遇到危险但自救了
葡萄是热性还是凉性	葡萄是热性还是良性
布洛芬吃下去多久后才有效果	布洛芬吃下去多久后才有效果
五菱宏光后雾灯怎么开	五菱宏光后雾灯怎么开
八由哪两个数字组成	八由哪两个数字组成
我是不是天下第一美少女	我是不是天下第一美少女
东南西北怎么折	动南西北怎么折
二十六乘十二	二十六乘十二
怀孕初期能喝姜糖水吗	怀孕初期能喝姜汤水吗
寂寞寂寞就好歌词是什么意思	寂寞寂寞就好歌词是什么意思
肠胃炎可以吃水果	肠胃炎可以吃水果
婴儿能坐飞机	婴儿能坐飞机
存在银行的钱不见了银行赔吗	存在银行的钱不见了银行赔吗
别人欠钱不还怎么办	别人歉钱不还怎么办
青春痘疤痕怎么消除	青春豆疤痕怎么消除
你有没有女朋友	你有没有女朋友
什么的月光	什么得月光
晚上吃鱼会胖	晚上吃鱼会胖
冠心病症状	冠新病症状
宝宝爱出汗是什么原因	宝宝爱出汉是什么原因
王维的古诗	吴维的古诗
吃橘子会胖吗	吃桔子会胖吗
密集恐惧症怎么治疗	密极恐惧症怎么治疗
玩游戏怎么赚钱	玩游戏怎么钻钱
ab胶硬度	ab胶硬度
oppocare加的退换规则	oppocare加的退换规则
燃气热水器怎么安装	燃汽热水器怎么安装
工行生肖信用卡额度	工行生肖信用卡额度
腰疼针灸有用吗	腰疼针久有用吗
口腔溃疡吃什么药	口腔溃疡吃十么药
虾和地瓜能一起吃	虾和地瓜能一起吃
孕妇的尿液与一般人的一样吗	孕妇的尿液与一般人的一样吗
孙红雷的电视剧	孙红梅的电视剧
熬夜喝什么好	熬夜和什么好
月经期间可以健身吗	月经期间可以建身吗
范冰冰用什么面膜	犯冰冰用什么面膜
戴隐形眼镜可以睡午觉吗	带隐形眼镜可以睡午觉吗
什么牌子的洗发水好用	什么牌子得洗发水好用
淋巴细胞低是艾滋病	淋巴细胞低是艾滋病
减肥后面部憔悴怎么办	减肥后面部憔悴怎么办
抖音里面的流行音乐怎么没有搜索到	抖音里面的流行音乐怎么没有搜索到
皮肤晒伤怎么办	皮夫晒伤怎么办
发烧能开空调	发烧能开空调
李欣汝三围	李欣冉三围
龙胆泻肝丸小孩可以服用吗	龙胆泻肝丸小孩可以服用吗
左眄怎么读	左辅怎么读
吃橘子会回奶吗	吃桔子会回奶吗
咸鱼退款卖家拒绝	闲鱼退款卖家拒绝
痛风能吃豆芽	痛风能吃豆芽
膏药贴多久	膏药铁多久
你的智商有多高	你的智商有多高
常熟到濮阳的私家车	常熟到濮阳的私家车
停车熄火正确的方法	停车熄火正确的方法
训练德国牧羊犬的方法	训练德国牧羊犬的方法
浑身发热但不发烧	混身发热但不发烧
新生儿可以喝葡萄糖吗	新生儿可以和葡萄糖吗
长痱子可以打预防针	长痱子可以打预防针
怎么去除扁平疣	怎么去除扁平尤
六月怀孕几月生	六月怀孕几月生
视网膜脱落	是网膜脱落
北京最好的中医院	北京最好的中医院
ar镀膜玻璃的	ar镀膜玻璃的
怀孕初期能喝可乐	怀孕初期能喝可乐
吃榴莲会便秘吗	吃榴莲回便秘吗
徐州到乌鲁木齐	徐州到乌鲁木齐
二十二乘三	二十二乘三
天龙八部什么时装好看	天龙八部什么时装好看
右下腹是什么器官	又下腹是什么器官
音乐类省统考考什么	音乐类省统考考什么
孕妇打喷嚏肚子抽痛	孕妇打喷嚏肚子抽疼
哺乳期可以烫发吗	哺乳期可以汤发吗
阿斯匹林作用	阿司匹林作用
上火吃什么水果好	上活吃什么水果好
人力资源管理师四级报名网站	人力资源管理师四级报名网站
月是故乡明作者在文中借月亮表达了什么	月是故乡明作者在文中借月亮表达了什么
林正英的电影	汪正英的电影
感冒了吃什么药	感冒了吃什么要
慢性咽炎有哪些症状	慢性咽炎有那些症状
齐齐哈尔的明星有哪些	齐齐哈尔的明星有哪些
艾灸可以减肥吗	爱灸可以减肥吗
怡养堂化妆品怎么样	怡养堂化妆品怎么样
小提琴琴拖怎么安装	小提琴琴托怎么安装
宋茜演过什么电视	宿茜演过什么电视
感冒了还能给宝宝喂奶吗	感冒了还能给宝宝喂奶吗
孕妇能喝金银花露吗	孕妇能和金银花露吗
吃什么能降血糖	吃什么能将血糖
负一的负一次方	负一的负一次方
建行怎么取消转账限额	建行怎么取消转账限额
二千零二十杭州小升初摇号结果	二千零二十杭州小升初摇号结果
什么样的嘴巴	什么样的嘴吧
孕妇能喝加多宝吗	孕妇能和加多宝吗
人流挂哪个科	人流挂那个科
贷款是转lpr好还是不转好	贷款是转lpr好还是不转好
落枕脖子疼怎么办	洛枕脖子疼怎么办
网上怎么选车牌号	往上怎么选车牌号
营口在哪里	营口在那里
鸡眼会自己好	鸡眼会自己好
痛风能喝茶	痛风能喝茶
感冒吐血是什么原因引起的	感冒吐血是什么原因引起的
低血压症状	低血压证状
七十二乘五	七十二乘五
痔疮脱出怎么办	痔疮拖出怎么办
宫颈糜烂治好会复发吗	宫颈糜烂治好会复发吗
新桥办居住证在哪里	新桥办居住证在哪里
妊娠糖尿病能吃菠萝	妊娠糖尿病能吃菠萝
高铁站是郑州东站吗	高铁站是郑州东站吗
生孩子的苦怎么表达	生孩子的苦怎么表达
左腹部隐痛的原因	做腹部隐痛的原因
感冒咳嗽晚上咳得厉害	感冒咳嗽晚上咳的厉害
二十年青木川古镇开放了吗	二十年青木川古镇开放了吗
芦荟可以直接涂在脸上吗	芦会可以直接涂在脸上吗
大食堂用的烧电的灶	大食堂用的烧电的灶
现在什么电视剧好看	先在什么电视剧好看
消费者有哪些权益	消费者有那些权益
玉米糖分高	玉米糖分高
面瘫治疗后能喝可乐吗	面瘫治疗后能喝可乐吗
咳嗽的原因有哪些	咳嗽的原因有那些
如何呼唤你	如何呼唤你
大腿根部痱子一样的很痒	大腿根部痱子一样的很痒
一百以内的质数表有什么规律	一百以内的质数表有什么规律
胆囊炎的症状	胆囊研的症状
教学设计过程模式	教学设计过程模式
太阳穴长痘怎么回事	太阳穴长痘怎么会事
你是oppo什么型号	你是oppo什么型号
司马迁姓什么	司马懿姓什么
什么的目光	什么得目光
尿毒症有什么症状	尿毒症有什么证状
搪瓷锅可以熬中药吗	唐瓷锅可以熬中药吗
种植牙能用多久	种值牙能用多久
枸杞和西洋参可以一起泡水喝吗	狗杞和西洋参可以一起泡水喝吗
关于汉字的广告	关于汉子的广告
手发麻是怎么回事	手法麻是怎么回事
法制是什么	法治是什么
孕妇可以吃青蛙	孕妇可以吃青蛙
孕妇可以吃川贝炖雪梨吗	孕妇可以吃川北炖雪梨吗
喝牛奶可以长高	喝牛奶可以长高
申请公积金需要准备什么材料	申请公积金需要准备什么材料
新生儿体温多少正常	新生二体温多少正常
喝蜂蜜水减肥	喝蜂蜜水减肥
怀孕可以吃黄骨鱼	怀孕可以吃黄骨鱼
月经期间可以吃芒果	月经期间可以吃芒果
生产成本账户按用途和结构分类	生产成本账户按用途和结构分类
喊出振兴中华最强音的是谁	喊出振兴中华最强音的是谁
舌尖上的中国有几个导演	舌尖上的中国有几个导演
激光祛斑留疤	激光祛斑留疤
拉屎拉不出来怎么办	拉屎啦不出来怎么办
查过敏源怎么查	查过敏原怎么查
你可以给我讲故事吗	你可以给我讲故事吗
菠萝和鸡蛋能一起吃	菠萝和鸡蛋能一起吃
炉甘石洗剂孕妇能用	炉甘石洗剂孕妇能用
脂肪肝吃苏子籽好吗	脂肪肝吃苏子籽好吗
机器人搭建有什么好处	机器人搭建有什么好处
什么是人生最早出现的认识过程是其他认识过程的基础	什么是人生最早出现的认识过程是其他认识过程的基础
肌肝高是什么意思	几肝高是什么意思
怀孕能吃溜溜梅	怀孕能吃溜溜梅
来月经可以健身	来月经可以健身
清华第一校长	清华第一校长
蓝正龙大s什么时候分手的	蓝正蔡大s什么时候分手的
湿热吃什么药	湿热吃什么药
鼻炎会引起耳鸣	鼻炎会引起耳鸣
还有什么意思	还有什么意思
莜面和小麦面粉的区别	莜面和小麦面粉的区别
取环多久可以怀孕	去环多久可以怀孕
王俊凯帅不帅	王俊凯帅不帅
脚跟痛如何治疗	脚根痛如何治疗
消化不良可以吃香蕉	消化不良可以吃香蕉
痛风可以喝豆奶吗	通风可以喝豆奶吗
如何去除老年斑	如何去处老年斑
北京那个医院皮肤科最好	北京哪个医院皮肤科最好
汉赋九问兰草八章作者	汉赋九问兰草八章作者
坐骨神经痛症状	坐骨神经痛症壮
肿瘤引起的性早熟有什么症状	肿瘤引起的性早熟有什么症状
邢台货车通行证高峰期	邢台货车通行证高峰期
丰台离石景山多远	丰台离石景山多远
减肥每天喝多少水	减肥每天和多少水
小孩扁桃体发炎咳嗽	小孩篇桃体发炎咳嗽
复方氢氧化铝片孕妇可以吃	复方氢氧化铝片孕妇可以吃
尿毒症的症状	尿毒症得症状
孕妇可以喝金银花	孕妇可以喝金银花
陕西最好男科医院	陕西最好男科医院
吃什么养胃	吃十么养胃
ns怪物猎人gu怎么面联	ns怪物猎人gu怎么面联
小布打开颜色反转	小布打开颜色反转
闲鱼芝麻信用未授权的买家	闲鱼芝麻信用未授权的买家
北大几个食堂	北大几个食堂
两个名字的歌手有哪些	两个名字的歌手有哪些
山东属于哪个地区	山东属于哪个地区
五系百公里加速几秒	五系百公里加速几秒
经常熬夜会肾虚	经常熬夜会肾虚
眼睛上长针眼	眼睛上张针眼
一把青哪里可以看	一把青那里可以看
小腿痒是怎么回事	小退痒是怎么回事
蚕宝宝生长需要什么条件	蚕宝宝生长需要什么条件
宜昌建行营业时间	宜昌建行营业时间
老年性皮肤瘙痒症	老年性皮肤瘙痒证
扁桃体炎能抽烟	扁桃体炎能抽烟
糜烂性直肠炎灌肠用什么药	糜烂性直肠炎灌肠用什么药
来月经可以喝蜂蜜水	来月经可以喝蜂蜜水
达尔文还发明了什么	关尔文还发明了什么
无线鼠标没反应	无限鼠标没反应
六大行动台帐	六大行动台账
张鲁芸是什么公司的经理啊	张闻芸是什么公司的经理啊
淋巴结发炎怎么办	淋巴杰发炎怎么办
玩一会儿	玩一会儿
眼药水有副作用	眼药水有副作用
怎么样检验黄金的真假	怎么样检验黄金的真假
甘肃的省会	甘肃的省会
下眼眶疼是怎么回事	下眼框疼是怎么回事
试管婴儿移植后几天着床	试管婴儿移值后几天着床
不睡枕头好	不睡枕头好
西安公积金贷款额度上限	西安公积金贷款额度上限
高血压能吃黄瓜	高血压能吃黄瓜
逍遥丸什么时候吃好	消遥丸什么时候吃好
三角形的周长	三角形的周长
苹果手机的录音在哪里	苹果手机的录音在那里
台湾著名大学世界排名	台湾知名大学世界排名
蒲地蓝口服液小孩用量	铺地蓝口服液小孩用量
成都社保养老金计算方法	成都社保养老金计算方法
萍果煮红枣有什么功能	萍果煮红枣有什么功能
做心电图多少钱	作心电图多少钱
唇裂遗传	唇裂遗传
济南先行区房价怎么样	济南先行区房价怎么样
内分泌失调怎么调理	内分秘失调怎么调理
睡前喝牛奶有助于睡眠	睡前喝牛奶有助于睡眠
结肠癌早期症状	结肠癌早起症状
潘静娴是谁	孟静娴是谁
白志勇是谁	万志勇是谁
慢性胃窦炎严重	慢性胃窦炎严重
天天向上有徐莉的那期是什么时候	天天向上有阿莉的那期是什么时候
拉肚子可以吃西瓜	拉肚子可以吃西瓜
高血压能吃菠菜	高血压能吃菠菜
肾结石吃什么水果好	肾结石吃什麼水果好
口臭是怎么回事	口臭是怎么会事
妊娠糖尿病可以吃红枣	妊娠糖尿病可以吃红枣
支付宝怎么做公交车扫码	支付宝怎么做公交车扫码
农村户口可以买社保	农村户口可以买社保
贫血怎么办	贫血怎么半
全麦粉能不能做蛋糕	全麦粉能不能做蛋糕
黄明昊今年多少岁	疏明昊今年多少岁
糖尿病并发症有哪些	糖尿病屏发症有哪些
被辣椒辣到手怎么办	被辣椒拉到手怎么办
小学五字古诗	小学五字古诗
扁桃体发炎挂哪个科	扁桃体发炎挂那个科
怀孕可以吃草鱼	怀孕可以吃草鱼
失眠吃什么	失眠吃什药
十二乘五十	十二乘五十
李华是什么朝代	李巴是什么朝代
孔雀钻石画适合挂哪里	孔雀钻石画适合挂哪里
糖尿病的症状有哪些	糖尿病的证状有哪些
周公解梦梦见蛇	周工解梦梦见蛇
在我们国家英语翻译	在我们国家英语翻译
怎样制作圆锥	怎样制做圆锥
宝宝喉咙有痰怎么办	宝宝吼咙有痰怎么办
吃什么补锌	吃什么补锌
买二手车用缴税吗	买二手车用交税吗
睡眠障碍最常见的是	睡眠障碍最常见的是
今天什么时候	今天什么时候
震动环怎么用	振动环怎么用
大便拉不出来怎么办	打便拉不出来怎么办
月经期可以喝益母草	月经期可以喝益母草
手指上长小水泡	手指上张小水泡
荨麻疹不能吃什么食物	荨麻诊不能吃什么食物
烂嘴角是怎么回事	烂嘴角是怎么会事
带状疱疹是怎么引起的	带壮疱疹是怎么引起的
ace两的上市停产时间	ace两的上市停产时间
黄鳝的价格	黄蟮的价格
不给你充电行不行	不给你充电行不行
减肥塑形大套盒哪里有	减肥塑形大套盒哪里有
一只拉布拉多狗多少钱	一只拉不拉多狗多少钱
细辛的功效与作用	细心的功效与作用
丙氨酸转氨酶偏高是什么原因	丙氨酸转安酶偏高是什么原因
帕金森综合症	帕金森总合症
喉咙有异物怎么办	喉咙有异物怎么半
孙红雷什么时候结的婚啊	万红雷什么时候结的婚啊
beautiful是什么意思	beautiful是什么意思
苏轼是什么朝代的	苏辙是什么朝代的
在微信朋友圈里怎么发长视频	在微信朋友圈里怎么发长视频
李华是什么朝代	李白是什么朝代
冰箱里一个世界的电影	冰箱里一个世界的电影
十二乘十五	十二乘十五
服用逍遥丸的副作用	服用消遥丸的副作用
感冒可以拔罐	感冒可以拔罐
孕妇感冒能喝板蓝根吗	孕妇感冒能和板蓝根吗
什么东西越洗越脏	什么东西越西越脏
促甲状腺激素受体抗体	促甲壮腺激素受体抗体
一除三	一除三
肺癌的治疗方法	肺癌的制疗方法
打开酷狗音乐	打开酷狗音乐
李晟和张睿是什么关系	李晟和郎睿是什么关系
美食的作文怎么写	美食的作文怎么写
萝卜樱怎么做好吃	萝卜婴怎么做好吃
章子怡是那里人	张子怡是那里人
还有什么	还有什么
rapper是什么意思	rapper是什么意思
现在还有多少电	现在还有多少电
疱疹的初期症状	疱疹的初起症状
护肝片有副作用	护肝片有副作用
脖子上有结节怎么办	脖子上有结界怎么办
黄钻消失了背景墙会消失吗	黄钻消失了背景墙会消失吗
胳膊扭伤怎么办	胳膊纽伤怎么办
来月经可以吃乌鸡白凤丸吗	来月经可以吃乌鸡白风丸吗
坐月子可以吃红枣么	做月子可以吃红枣么
怀孕初期出血	怀孕出期出血
浙江是哪个省的	浙江是那个省的
产妇能吃冬瓜	产妇能吃冬瓜
ipad怎么检测屏幕	ipad怎么检测屏幕
薏米的功效与作用	苡米的功效与作用
杨俊杰这个名字怎么样	刘俊杰这个名字怎么样
脚上长湿疹	脚上涨湿疹
联系不上	联系不上
什么是激烈的运动	什么是剧烈的运动
眼睛腿怎么调最合适	眼镜腿怎么调最合适
你什么性别	你什么性别
治疗胃病的药	治疗胃病的要
隔离的做用	隔离的作用
喉咙有痰怎么办	侯咙有痰怎么办
坏蛋是怎样炼成的	坏蛋是怎样连成的
嗓子哑了怎么办	嗓子哑了怎么半
江苏口罩第三方检测机构	江苏口罩第三方检测机构
孕妇可以吃提子	孕妇可以吃提子
请关闭手机	请关闭手机
前额胀痛是什么原因	前额帐痛是什么原因
扁桃体发炎能吃虾	扁桃体发炎能吃虾
打开作业帮	打开作业帮
离过年还有几天	离过年还有几天
香蕉脂肪高	香蕉脂肪高
艾灸的时间	艾灸得时间
文言文翻译器	文言文翻译其
如何让胸变小	如何让凶变小
石河子市属于哪个地区	石河子是属于哪个地区
华为手机如何截屏	华维手机如何截屏
吃头孢喝白酒	吃头孢和白酒
京东优惠卷怎么兑换	京东优惠劵怎么兑换
孕妇小便混浊	孕妇小便浑浊
右腹部疼痛	又腹部疼痛
荨麻疹不能吃什么	荨麻诊不能吃什么
小孩什么时候会走路	小孩什么时候回走路
十一月二十二是什么星座的	十一月二十二是什么星座的
江苏什么时候清零	江苏什么时候清零
体检心率不齐	体检心律不齐
吃完榴莲可以喝牛奶吗	吃完榴连可以喝牛奶吗
狗癣传染人	狗癣传染人
oppo十一怎么截屏	oppo十一怎么截屏
以下皮损中消退快消退后不留痕迹的是	以下皮损中消退快消退后不留痕迹的是
吸毒后感觉下面在流水	吸毒后感觉下面在流水
颜体飞字怎么写	颜体快字怎么写
梦见死去姑父	梦见死去姑夫
经期可以洗牙吗	经期可以洗呀吗
大拇指甲上有黑色竖纹是怎么回事	大姆指甲上有黑色竖纹是怎么回事
兰州的邮箱	兰州的邮箱
我可以叫你小布吗	我可以叫你小美吗
怎么折爱心	怎么哲爱心
如何去痘坑	如何去逗坑
血糖高能吃西瓜吗	血唐高能吃西瓜吗
糖尿病能治好吗	糖尿病能知好吗
胚胎着床会出血	胚胎着床会出血
小狗活动的特点有哪些	小狗活动的特点有哪些
经期喝红糖水好吗	经期和红糖水好吗
小腹隐隐作痛是什么原因	小腹隐隐做痛是什么原因
你叫什么名字	你叫什么名字
吃头孢可以喝啤酒	吃头孢可以喝啤酒
跑步腿会粗	跑步腿会粗
药流后可以洗澡	药流后可以洗澡
现在做什么行业最挣钱	现在做什么行也最挣钱
子宫肌瘤能吃红枣	子宫肌瘤能吃红枣
上厕所时马桶圈要掀开上面的盖吗	上厕所时马桶圈要掀开上面的盖吗
腋下淋巴结肿大怎么办	夜下淋巴结肿大怎么办
怡宝是矿泉水	怡宝是矿泉水
什么是细菌性阴道炎	什么事细菌性阴道炎
江南招行营业网点	江南招行营业网点
系统可卸载应用找回	系统可卸载应用找回
中医学的基本特点	中医学得基本特点
坐月子能用足光粉泡脚吗	坐月子能用足光粉泡脚吗
什么时候清明节	什么时候青明节
keep下载后的运动视频在哪里删除	keep下载后的运动视频在哪里删除
糖尿病能吃芒果	糖尿病能吃芒果
喉咙干痛是怎么回事	喉咙千痛是怎么回事
那我是什么座	那我是什么座
小孩流口水是什么原因	小孩留口水是什么原因
来例假能喝酒	来例假能喝酒
雷克萨斯产自哪个国家	雷克萨斯产自那个国家
四mod两等多少	十mod两等多少
腋下黑怎么办	腋下黑怎么半
什么时候开学	十么时候开学
三亚康莱德酒店多少钱一晚	三亚康莱德酒店多少钱一晚
蚕的生长过程	蚕的生长过成
中山学校排名	中山学校排名
我的座右铭是什么意思	我的坐右铭是什么意思
微波炉能做蛋糕	微波炉能做蛋糕
淘宝买家客服	淘宝卖家客服
买房子上什么网	卖房子上什么网
微信零钱通和支付宝余额宝哪个收益高	微信零钱痛和支付宝余额宝哪个收益高
上环后会怀孕吗	上环后回怀孕吗
湿气重的食物有哪些	湿气重的食物有那些
胡萝卜怎么做好吃	胡罗卜怎么做好吃
短信验证码	短信验证码
西曲溴铵与苯扎氯铵哪个更好	西曲溴铵与苯扎氯铵哪个更好
怎么教孩子画画	怎么教孩子画花
奥得力是什么意思	奥得利是什么意思
乘三	乘三
什么是定向流量	什么事定向流量
可以设置来电秀	可以设置来电秀
耳洞发炎还能戴耳钉吗	耳洞发炎还能带耳钉吗
精囊炎有哪些症状	精囊炎有那些症状
吃豆腐减肥	吃豆腐减肥
我叫什么	我叫什么
腰肌劳损怎么治疗	腰肌劳损怎么治辽
喝水能减肥	喝水能减肥
四乘十四	四乘十四
骨质疏松的症状	骨质疏松得症状
打乙脑疫苗发烧怎么办	打已脑疫苗发烧怎么办
什么是更年期	什麼是更年期
如何让胸变大	如何让熊变大
来月经可以跳绳	来月经可以跳绳
亲你多大了	亲你多大了
怀孕了可以缝针线活吗	怀孕了可以缝针线活吗
什么是包皮垢	什么事包皮垢
打电话给吴一	打电话给吴总
谷歌怎么注册账号	谷歌怎么注册帐号
株洲考驾照多少钱	株洲考驾照多少钱
手机怎么登录腾讯会员	手机怎么登入腾讯会员
来月经可以喝蜂蜜水吗	来月经可以呵蜂蜜水吗
电信套餐修改	电信套餐修改
有没有好玩的游戏	有没有好玩的游戏
月经推迟一天能测出怀孕吗	月经退迟一天能测出怀孕吗
原始凭证商品名称错误	原始凭证商品名称错误
大雁为什么要飞到南方过冬	大眼为什么要飞到南方过冬
罗晋唐嫣最新访谈节目	罗窦唐嫣最新访谈节目
王者李信怎么打	王者韩信怎么打
五gcpet一支持的频段	五gcpet一支持的频段
跳绳可以减肥	跳绳可以减肥
肾炎遗传	肾炎遗传
梦到摸喜欢的人头发	梦到摸喜欢的人头发
强直性脊柱炎能治好	强直性脊柱炎能治好
石榴籽能吃吗	石榴子能吃吗
杜甫是哪个朝代的诗人	杜牧是哪个朝代的诗人
粮票值钱	粮票值钱
马超怎么死的	张超怎么死的
拔罐出水泡是怎么回事	拔灌出水泡是怎么回事
孕妇可以吃烧仙草吗	孕妇可以吃烧鲜草吗
糖尿病人可以吃辣椒	糖尿病人可以吃辣椒
单字名字女	单子名字女
情侣之间高情商说话方式	情侣之间高情商说话方式
头皮糠疹治疗方法	头皮康疹治疗方法
什么是激素脸	什麼是激素脸
血小板低的症状	血小板低得症状
十万乘十万	十万乘十万
六十三除九	六十三除九
我有什么优点	我有什么优点
空腹跑步好	空腹跑步好
拔智齿危险吗	把智齿危险吗
体检抽血可以喝水	体检抽血可以喝水
你会背乘法口诀吗	你会背乘法口诀吗
肚子上的赘肉怎么减	肚子上的坠肉怎么减
无网络连接请连接网络后重试	无网络连接请连接网络后重试
和平精英玛莎拉蒂可以隐藏	和平精英玛莎拉蒂可以隐藏
校园广播系统如何设置时间	校园广播系统如何设置时间
工行密码输错三次怎么办	工行密码输错三次怎么办
齐齐哈尔到昂昂溪多少公里	齐齐哈尔到昂昂溪多少公里
血糖高吃什么好能降糖	血塘高吃什么好能降糖
孕妇能吃卤味	孕妇能吃卤味
脚气会传染到手上	脚气会传染到手上
骶一隐性脊椎裂	骶一隐形脊椎裂
荷叶的功效与作用	荷叶得功效与作用
禁止标志英语	禁止标识英语
我要玩词语王者	我要玩词语王者
孟鲁司特钠要吃多久	孟鲁司特纳要吃多久
病毒性疱疹怎么治疗	病毒性泡疹怎么治疗
白细胞高怎么回事	白细胞高怎么会事
你吃过屎吗	你吃过屎吗
孕妇能吃桔子吗	孕妇能吃橘子吗
手电筒打不开怎么回事	手电筒打不开怎么回事
减肥可以吃葡萄吗	减肥可以吃葡萄妈
衡阳在哪里	衡阳在那里
婴宝湿疹膏有激素	婴宝湿疹膏有激素
信用卡还重了怎么办	信用卡还重了怎么办
减肥能喝牛奶吗	减肥能和牛奶吗
怀孕能吃淮山吗	怀孕能吃怀山吗
补血的药物有哪些	补血的药物有那些
七百二十除十二	七百二十除十二
南京优秀的装饰公司	南京优秀的装饰公司
圆形和水滴形做出来	圆形和水滴形做出来
性刘的女明星有哪些人	姓刘的女明星有哪些人
牙痛怎么治	牙痛怎么制
哪个在攻击沉睡目标时不会让其苏醒	哪个在攻击沉睡目标时不会让其苏醒
哺乳期可以喝米酒	哺乳期可以喝米酒
全切双眼皮多久能戴隐形眼镜	全切双眼皮多久能戴隐形眼镜
孕妇可以吃鸡公	孕妇可以吃鸡公
一百六十专用武器伤害范围	一百六十专用武器伤害范围
孕妇能吃蒲地蓝消炎口服液吗	孕妇能吃蒲地兰消炎口服液吗
一万二千一百二十三显示处理失败钱去哪里了	一万二千一百二十三显示处理失败钱去哪里了
ace两的呼吸灯	ace两的呼吸灯
经常感冒是怎么回事	经长感冒是怎么回事
大便不成型是直肠癌吗	大便不成形是直肠癌吗
腹股沟在什么位置	服股沟在什么位置
湿疹可以吃生蚝	湿疹可以吃生蚝
神经衰弱能治愈	神经衰弱能治愈
佛山到桂林货车	佛山到桂林火车
整形医院回访电话话术	整形医院回访电话话术
五个月宝宝可以吹风吗	五个月宝宝可以吹风吗
乙肝的症状有哪些	已肝的症状有哪些
怀孕初期可以喝茶吗	怀孕初期可以和茶吗
家常菜都有哪些	家常菜都有那些
胃下垂的症状	胃下垂的症壮
淘宝退货单号总是不正确	淘宝退货单号总是不正确
芒果吃了会上火吗	芒果吃了回上火吗
糖尿病人能吃花生吗	塘尿病人能吃花生吗
不孕不育的原因	不孕不育得原因
脚趾发麻怎么办	脚指发麻怎么办
家用暖气循环泵安装在什么位置合适	家用暖气循环泵安装在什么位置合适
怀孕一周的征兆	还孕一周的征兆
三十加三十	三十加三十
justin是谁	justin是谁
如何注册淘宝账号	如何注册淘宝帐号
热感冒可以喝姜汤	热感冒可以喝姜汤
把什么比作什么	把什么比做什么
女人会的疝气吗	女人会得疝气吗
胆结石能不能喝雪碧	胆结石能不能喝雪碧
来月经腰酸怎么回事	来月经要酸怎么回事
俊琛的意思	俊祺的意思
肩膀痛是什么原因	肩旁痛是什么原因
本命年丢了金项链什么预兆	本命年丢了金项链什么预兆
重庆银行渝中区网点分布	重庆银行渝中区网点分布
怀孕可以吃咸鱼	怀孕可以吃咸鱼
什么牌子的行车记录仪好	什么牌子的行车记录仪号
抗甲状腺球蛋白抗体高怎么办	康甲状腺球蛋白抗体高怎么办
无锡海鲜批发市场在哪里	无锡海鲜批发市场在哪里
口腔溃疡吃什么好	口腔溃疡吃什么号
手机进水一个月还能修好吗	手机进水一个月还能修好吗
心率不齐的症状	心率不齐得症状
小孩可以涂万金油吗	小孩可以涂万金油吗
苹果八plus怎么样	苹果八plus怎么样
如何一夜暴富	如何一夜爆富
司马懿是哪里人	司马徽是哪里人
刘慈欣是个什么样的人	刘雨欣是个什么样的人
我忘记密码了怎么办	我忘记密码了怎么办
小度小度今天天气怎么样	小度小度今天天气怎么样
胃溃疡的症状有哪些	胃溃疡的症状有那些
脂肪肝可以吃猪肝	脂肪肝可以吃猪肝
必须犯规的游戏	必须范规的游戏
高速公路收费标准	高速工路收费标准
奶粉过期还能喝	奶粉过期还能喝
卖零食赚钱	卖零食赚钱
脚底蜕皮怎么回事	脚底脱皮怎么回事
怎么种豆芽	怎麼种豆芽
怎么修改ipad名字	怎么修改ipad名字
胃不好能吃水果	胃不好能吃水果
吃小南瓜对身体有什么好处	吃小南瓜对身体有什么好处
qq网名女生有特殊符号	qq网名女生有特殊符号
小孩手脱皮是怎么回事	小孩手托皮是怎么回事
镶嵌式煤气灶怎样换电池	镶嵌式煤气灶怎样换电池
古代四大美女那几个	古代四大美女哪几个
蒲公英泡水喝的功效	普公英泡水喝的功效
电动车用驾照	电动车用驾照
boy尺码	boy尺码
你的名字叫什么	你的名字叫什么
抑郁症的治疗方法	抑郁症得治疗方法
焦虑症的症状	焦虑症得症状
嘉兴是哪个省的	嘉兴是那个省的
过敏时哮喘发生的原因	过敏时哮喘发生的原因
懒羊羊是男是女	美羊羊是男是女
咳嗽可以吃螃蟹	咳嗽可以吃螃蟹
宋慧敏是谁	李慧敏是谁
怎么去除痘印	怎么去处痘印
电子烟有危害	电子烟有危害
二千零一十九内蒙古脱贫摘帽旗县名单	二千零一十九内蒙古脱贫摘帽旗县名单
人流后可以吃水果吗	人流厚可以吃水果吗
怎么在微店上买东西	怎么在微店上卖东西
大便黏腻是怎么回事	大便粘腻是怎么回事
简笔画怎么画	简笔画怎么花
舌苔白是怎么回事	舌台白是怎么回事
肠胃炎吃什么好	肠胃炎吃什药好
楚留香聊天记录保存多久	晋留香聊天记录保存多久
子宫脱落是怎么回事	子宫托落是怎么回事
慢性咽炎吃什么药	慢性咽炎吃什么要
建行app登录信息不正确	建行app登录信息不正确
尿道感染怎么治	尿到感染怎么治
肾虚什么症状	肾虚什么证状
打开酷狗音乐并播放	打开酷狗音乐并播放
社区戒毒期限	社区介毒期限
怎么制作蛋挞	怎么制做蛋挞
白癜风能根治吗	白癜风能跟治吗
植物大战僵尸两原始坚果墙装扮怎么获得	植物大战僵尸两原始坚果墙装扮怎么获得
含人体器官的成语	含人体器关的成语
手上长鸡眼	手上张鸡眼
现在几点了	现在几点了
减肥吃苹果可以	减肥吃苹果可以
什么的锦缎	什么的锦锻
橘子吃了有什么好处	桔子吃了有什么好处
农历六月是什么星座	农历六月是什么星座
陈宇航名字	王宇航名字
十二律名和对应的现代名	十二律名和对应的现代名
你知道r十七	你知道r十七
建行职务等级	建行职务等级
身份证过期了还能乘坐飞机吗	身份证过期了还能乘坐飞机吗
郎朗为什么出名	朗朗为什么出名
脑梗塞一定会复发	脑梗塞一定会复发
抽烟会瘦吗	抽烟回瘦吗
清平乐表达了词人的什么感情	清平乐表达了词人的什么感情
吃黄瓜可以减肥	吃黄瓜可以减肥
全民宫斗怎么生孩子	全民宫斗怎么生孩子
胃疼拉肚子怎么回事	胃疼垃肚子怎么回事
肺炎吃什么药	费炎吃什么药
怀孕能吃橄榄菜	怀孕能吃橄榄菜
杭州哪里有摩托车卖	杭州哪里有摩托车买
有什么功能	有什么功能
细腻绵长是什么意思	细密绵长是什么意思
来月经可以吃韭菜	来月经可以吃韭菜
患者女性二十七岁甲状腺肿大一年消瘦易疲劳失眠心悸怕热	患者女性二十七岁甲状腺肿大一年消瘦易疲劳失眠心悸怕热
怎样去除眼袋	怎样去处眼袋
中暑的急救方法	重暑的急救方法
九十除三十	九十除三十
胳膊麻木怎么回事	胳膊麻木怎么会事
减肥期间能吃土豆	减肥期间能吃土豆
小孩不睡觉怎么办	小还不睡觉怎么办
肾阴虚与肾阳虚区别	肾阴虚于肾阳虚区别
减肥期间可以吃凉面	减肥期间可以吃凉面
脚爆皮是怎么回事	脚暴皮是怎么回事
你有收音机	你有收音机
产妇能吃菠萝蜜吗	产妇能吃波萝蜜吗
秦皇岛到塘沽火车时刻表	秦皇岛到塘沽火车时刻表
ups不间断电源改逆变器	ups不间断电源改逆变器
肚脐贴真的可以祛湿吗	肚脐贴真的可以祛湿吗
西安的西南方向有哪些城市	西安的西南方向有哪些城市
莜面窝窝头的做法大全窍门	莜面窝窝头的做法大全窍门
被蜜蜂蛰了怎么处理	被密蜂蛰了怎么处理
什么时候开学	甚么时候开学
足偏旁的字	足边旁的字
读完上海戏剧学院要多少钱	读完上海戏剧学院要多少钱
鲜胚移植后几天着床	鲜配移植后几天着床
转基因食品有哪些	转基因食品有那些
蒲公英能长期喝	蒲公英能长期喝
肠胃不好能喝蜂蜜吗	肠胃不好能和蜂蜜吗
痛风能喝白酒吗	痛风能喝百酒吗
胰腺炎的症状有哪些	胰腺炎的症状有那些
孕妇能不能涂红药水	孕妇能不能涂红药水
能组什么词	能组什么词
来大姨妈能喝咖啡	来大姨妈能喝咖啡
白带有血丝怎么回事	白代有血丝怎么回事
于震演过的电视剧	卞震演过的电视剧
林宥嘉邓紫棋为什么分手	伍宥嘉邓紫棋为什么分手
怎样去除妊娠纹	怎样去出妊娠纹
甲状腺球蛋白偏高	甲状腺求蛋白偏高
小孩脸上有白斑	小孩连上有白斑
中通北京到沈阳	中通北京到沈阳
生理期能喝茶	生理期能喝茶
如何去除体内的湿气	如何去处体内的湿气
新鲜百合怎么吃	新鲜白合怎么吃
小步你会bbox吗	小步你会bbox吗
湖北伤残补助金标准	湖北伤残补助金标准
那我可以娶你吗	那我可以娶你吗
乳腺癌是什么症状	乳线癌是什么症状
那种减肥药最好最有效	哪种减肥药最好最有效
孕妇可以喝维维豆奶粉吗	孕妇可以和维维豆奶粉吗
艾灸可以天天灸	艾灸可以天天灸
爱玛电动车放了两个月无法用	爱玛电动车放了两个月无法用
火龙果可以减肥吗	火笼果可以减肥吗
如何显示修改后的文档	如何显示修改后的文档
来月经可以吃梨	来月经可以吃梨
宫外孕早期有哪些症状	宫外孕早期有那些症状
信用卡哪个银行的最好	信用卡那个银行的最好
西山区第一中学升学率	西山区第一中学升学率
盐酸萄糖胶囊的危害	盐酸萄糖胶囊的危害
什么的小路	什么得小路
演唱会在哪个软件可以看	演唱会在哪个软件可以看
颈部淋巴结肿大	颈部淋巴节肿大
加速度传感器的	加速度传感器的
荨麻疹检查过敏源	寻麻疹检查过敏源
月经期间能运动	月经期间能运动
肾虚是什么症状	肾虚是什么证状
不允许横屏在哪设置	不允许横屏在哪设置
蕾拉的英文	萨拉的英文
散热风扇发热什么原因	散热风扇发热什么原因
电源键是哪一个	电源键是哪一个
什么叫其它事业单位	什么叫其他事业单位
黄连的功效与作用	黄连的功效于作用
尿潜血弱阳性是怎么回事	尿浅血弱阳性是怎么回事
原来自己什么也不是	原来自己什么也不是
小苏打怎么用	小苏达怎么用
杜甫的诗被称为什么	杜甫的是被称为什么
几除几等零	几除几等零
重庆高校分数线排名	重庆高校分数线排名
打狂犬育苗可以吃芒果吗	打狂犬预苗可以吃芒果吗
结肠炎有那些症状	结肠炎有那些正状
剪映怎么设置视频封面	剪影怎么设置视频封面
神经衰弱如何治疗	神精衰弱如何治疗
防蓝光眼镜哪个牌子最好	防蓝光眼镜哪个牌子最好
我没有钱吃饭了	我没有钱吃饭了
瓷器对欧洲的影响	瓷器对欧洲的影响
a五十七t手机怎么分屏	a五十七t手机怎么分屏
大众suv车型大全斯柯达十万	大众suv车型大全斯柯达十万
怎么在网上找人	怎么在网上招人
我的手机可以无线充电	我的手机可以无线充电
滴虫性阴道炎的症状	滴虫性阴道炎的证状
来月经能吃火龙果	来月经能吃火龙果
海康摄像头怎样重置密码	海康摄像头怎样重置密码
花呗账单怎么删除	花呗张单怎么删除
长安社保中心电话	长安社保中心电话
什么是节育环	什么事节育环
一男两女三人唯美网名	一男两女三人唯美网名
身上青一块紫一块怎么回事	身上清一块紫一块怎么回事
避孕药安全吗	比孕药安全吗
怎样在网上赚钱	怎样在往上赚钱
微信号怎么改	维信号怎么改
今天是什么天气啊	今天是什么天气啊
月经来了能吃芒果吗	月经来了能吃茫果吗
脚底脱皮怎么办	脚底脱皮怎么半
吃完药能喝牛奶吗	吃完药能和牛奶吗
今天有没有太阳	今天有没有太阳
oppo最好的手机是什么手机	oppo最好的手机是什么手机
荨麻疹可以吃海苔吗	寻麻疹可以吃海苔吗
市面上还有印尼菠萝格木吗	市面上还有印尼菠萝格木吗
肺热的症状	肺热的正状
对数字化加工公司的建议	对数字化加工公司的建议
怀孕可以吃当归吗	怀孕可以吃档归吗
孕妇吃橘子好	孕妇吃橘子好
景德镇枫树山林场领导	景德镇枫树山林场领导
奥美拉唑饭前吃还是饭后吃	奥美啦唑饭前吃还是饭后吃
巧影怎么扣图	巧影怎么抠图
了解的近义词是不是知道	了解的近义词是不是知道
三模八频的概念	三模八频的概念
中国女孩名子排行榜	中国女孩名字排行榜
蜂巢怎么吃	蜂巢怎麼吃
刺激性食物有哪些	刺激性食物有那些
怎样才能去除脸上的痘印	怎样才能祛除脸上的痘印
湿气重的症状有哪些	湿气重的症状有那些
怎样种植芹菜	怎样种值芹菜
支气管炎传染	支气管炎传染
舞蹈的种类	舞蹈得种类
现在几度	现在几度
这什么意思	这什么意思
六味地黄丸对备孕有影响吗	六味地黄丸对备孕有影响吗
拉肚子喝什么药	拉肚子和什么药
卵泡每天长多少	卵泡每天涨多少
支气管炎会传染	支气管炎会传染
豆芽的营养价值	豆芽得营养价值
布艺沙发哪个品牌好	布艺沙发那个品牌好
哺乳期可以洗牙	哺乳期可以洗牙
老放屁是怎么回事	老房屁是怎么回事
大疆灵眸电量持续多久	大疆灵眸电量持续多久
三百乘五十	三百乘五十
今天天气咋样	今天天气咋样
明天有没有风	明天有没有风
碘伏涂伤口疼吗	碘伏图伤口疼吗
渭南事业编制工资	渭南事业编制工资
三洋洗衣机出现e十一点排水管一直出水	三洋洗衣机出现e十一点排水管一直出水
崩坏学园两亲密度有什么用	崩坏学园两亲密度有什么用
乐曲名加书名号还是引号	乐曲名加书名号还是引号
乌鲁木齐到义乌的飞机几点到	乌鲁木齐到义乌的飞机几点到
你心目中的班干部是怎么样的	你心目中的班干部是怎么样的
脸上长螨虫怎么办	脸上长满虫怎么办
朱荣军是谁	朱国军是谁
虎皮鹦鹉能吃大米	虎皮鹦鹉能吃大米
孕妇可以吃板栗	孕妇可以吃板栗
眼睛进沙子怎么办	眼睛进砂子怎么办
世界上最小的国家	事界上最小的国家
肾虚脱发怎么治疗	肾虚脱发怎么治辽
甲亢不能吃什么	甲抗不能吃什么
前列腺炎吃什么药	前列线炎吃什么药
月经推迟的危害	月经推迟得危害
一世纪等多少个月	一世纪等多少个月
睡觉流口水是怎么回事	睡觉流口水是怎么回是
烫伤了怎么办	烫伤了怎么半
吃西瓜有什么好处	吃西瓜又什么好处
怀孕了能吃桂圆	怀孕了能吃桂圆
坐月子可以洗澡吗	昨月子可以洗澡吗
喝完酒能洗澡	喝完酒能洗澡
肝火旺盛吃什么药	肝火旺胜吃什么药
有什么赚钱的软件	有什么赚钱的软件
杨幂陈奕迅参加的综艺节目	杨幂陈奕迅参加的综艺节目
神经衰弱的症状	神经衰弱的整状
大连建筑工程项目招标	大连建筑工程项目招标
武警一个师有多少人	武警一个师有多少人
茄子怎样做好吃	茄子怎样作好吃
窦娥是怎么死的	刘娥是怎么死的
揉胸能变大	揉胸能变大
苹果手机通讯录怎么批量删除	苹果手机通迅录怎么批量删除
腰肌劳损有哪些症状	腰肌老损有哪些症状
怎么刷白皮鞋	怎么刷白布鞋
报名厨师学校学费	报名厨师学校学费
日照景点地图	日照景点地图
迁移动宽带要怎么办理流程	迁移动宽带要怎么办理流程
吃中药能吃橘子吗	吃中药能吃桔子吗
烂脚丫怎么治	滥脚丫怎么治
otg连接是什	otg连接是什
微信怎么群发	微信怎么裙发
糖尿病能喝无糖可乐	糖尿病能喝无糖可乐
怎样恢复眼睛视力	怎样回复眼睛视力
鱼肝油有什么作用	鱼肝油有什么作用
肾的生理功能是什么	肾的生里功能是什么
妇炎洁可以治脚气	妇炎洁可以治脚气
嗓子疼怎么回事	嗓子疼怎麼回事
避孕套有保质期	避孕套有保质期
做核磁共振要多少钱	做和磁共振要多少钱
牙疼怎么治	牙疼怎麼治
什么是发烧	什么事发烧
流鼻涕咳嗽	留鼻涕咳嗽
鼻子干痒一扣就流鼻血	鼻子干痒一扣就流鼻血
排球教练郎平多大岁数	排球教练郎平多大岁数
cubase如何设置midi键盘	cubase如何设置midi键盘
还能在长高吗	还能再长高吗
舌苔厚怎么办	舌太厚怎么办
宝宝腹泻怎么办	宝宝复泻怎么办
李牧是哪里人	秦牧是哪里人
大肠息肉严重	大肠息肉严重
尿潜血一个加号严重吗	尿浅血一个加号严重吗
打电话给琴琴	打电话给陈琴
痛风可以喝绿豆汤吗	痛风可以和绿豆汤吗
晚上咳嗽厉害怎么办	晚上咳嗽历害怎么办
减肥不能吃的水果	减肥不能吃得水果
颈椎病会引起头晕	颈椎病会引起头晕
脸上补水用什么牌子的好	脸上补水用什么牌子的好
如果岁月可回头是什么意思	如果岁月可回头是什么意思
文章和马伊琍离婚了	文章和马伊琍离婚了
肾虚吃什么药最好	肾虚吃什么要最好
结婚祝贺词	结婚祝合词
来月经可以吃西洋参	来月经可以吃西洋参
人参健脾丸和平胃丸可以一起吃吗	人参健脾丸和平胃丸可以一起吃吗
买理财产品有风险吗	卖理财产品有风险吗
心脏病人可以坐飞机吗	心脏病人可以做飞机吗
十和十五的公因数有几个	十和十五的公因数有几个
中暑了吃什么药	中署了吃什么药
从二百到二百一十五分针旋转了多少度	从二百到二百一十五分针旋转了多少度
孕妇可以吃料酒	孕妇可以吃料酒
宝宝老是揉眼睛是怎么回事	宝宝老是柔眼睛是怎么回事
八个月的宝宝发烧怎么办	八个月得宝宝发烧怎么办
眼睛里面有结石是怎么回事	眼睛里面有结石是怎么回事
a九十二s包装清单	a九十二s包装清单
乳腺增生能吃燕窝	乳腺增生能吃燕窝
癌症能治愈	癌症能治愈
新生儿打嗝怎么回事	新生儿打隔怎么回事
拉黑色大便怎么回事	拉黑色大变怎么回事
中信信用卡被系统锁定	中信信用卡被系统锁定
那一年深圳成为了经济特区	那一年深圳成为了经济特区
什么是皮肤病	什么事皮肤病
一次就会怀孕	一次就会怀孕
宫寒的症状有哪些	宫寒的症状有那些
孕妇可以吃鸭血	孕妇可以吃鸭血
指南针怎么看	指南针怎麼看
吃什么补气血	吃什么布气血
通辽的	通辽的
土地证上是谁的名字土地就是谁的吗	土地证上是谁的名字土地就是谁的吗
平均血小板体积偏低	评均血小板体积偏低
怎么制作多链接海报	怎么制作多链接海报
枸杞子的功效与作用	苟杞子的功效与作用
兰州有啥好玩的	兰州有啥好玩的
白切鸡肉怎么做好吃法大全	白切鸡肉怎么做好吃法大全
吃避孕药会出血	吃避孕药会出血
梦遗正常	梦遗正常
卖水果赚钱吗	卖水果转钱吗
罗浩是哪部电视剧	孟浩是哪部电视剧
研究发现字的顺序不影响阅读	研究发现字的顺序不影响阅读
什么样的阳光	什么样的日光
九周岁男孩标准身高体重对照表	九周岁男孩标准身高体重对照表
睡觉睡的腰疼	睡觉睡得腰疼
仰卧起坐能减肚子吗	仰卧起做能减肚子吗
时迟那时快是什么意思	时迟那时快是什么意思
打开计算器	打开计算器
五花肉炖豆腐土豆家常做法	五花肉炖豆腐土豆家常做法
麦克维尔中央空调哪里产的	麦克维尔中央空调哪里产的
男生叫什么网名最好听	男生叫什么网名最好听
abb词蓝	abb词蓝
乙肝吃什么药	亿肝吃什么药
激光祛斑疼	激光祛斑疼
糖尿病人能吃桃子吗	塘尿病人能吃桃子吗
今天有没有雨	今天有没有雨
四十二乘二	四十二乘二
小肚子胀怎么回事	小肚子帐怎么回事
甲状腺囊性结节是什么	甲状腺囊性节节是什么
妊娠糖尿病可以吃什么水果	妊娠唐尿病可以吃什么水果
生理期可以吃芒果	生理期可以吃芒果
狂犬病传播途径	狂犬病传播途经
玩成语接龙	玩成语接龙
牙龈老出血怎么回事	牙龈老出血怎么会事
我能抱你吗	我能抱你吗
九一年属什么	九壹年属什么
你会说滚吗	你会说滚吗
白花蛇舌草功效与作用	白花蛇蛇草功效与作用
中国著名产品	中国知名产品
杨宇轩名字怎么样	杨宇飞名字怎么样
龟头炎的症状有哪些	龟头炎的症状有那些
你喜欢什么	你喜欢什么
糖尿病可以吃核桃吗	唐尿病可以吃核桃吗
大公报大陆为什么停刊	大公报大陆为什么停刊
来玩猜谜语吧	来玩猜谜语吧
怎么看苹果手机真假	怎么看平果手机真假
骨癌的症状	骨癌的症壮
怀孕能吃醋	怀孕能吃醋
在其他平台借款买房有影响吗	在其他平台借款买房有影响吗
油性记号笔怎么清除	油性记号笔怎么清楚
慢性宫颈炎怎么治	曼性宫颈炎怎么治
六百一十八别墅聚会轰趴馆怎么样	六百一十八别墅聚会轰趴馆怎么样
孕妇能吃牛油果吗	孕妇能吃牛油果妈
年青有为的意思	年轻有为的意思
你现在多大了	你现在多大了
玫瑰代表着什么意思	玫瑰带表着什么意思
低血压吃什么可以补	滴血压吃什么可以补
张彬彬古装电视剧	钦彬彬古装电视剧
小孩缺乏生长激素必须要打吗	小孩缺乏生长激素必须要打吗
鼻子上的黑头怎么去掉	鼻子上得黑头怎么去掉
糖尿病人能吃大蒜	糖尿病人能吃大蒜
豆浆补羊水吗	豆浆补羊水妈
脚被磨破皮怎么办	脚背磨破皮怎么办
老人补钙哪个牌子好	老人补钙那个牌子好
如何改wifi密码	如何改wifi密码
军字开头的成语接龙	军子开头的成语接龙
等边三角形有三个锐角对吗	等边三角形有三个锐角对吗
电池会爆炸	电池会爆炸
儿童吹泡泡水简单配方比例	儿童吹泡泡水简单配方比例
痛风病人能吃海带	痛风病人能吃海带
大便墨绿色怎么回事	大便默绿色怎么回事
华山是哪个市	华山是那个市
坐月子能吃李子	坐月子能吃李子
玻尿酸一针多少钱	玻尿酸一阵多少钱
特百惠果醋的做法大全	特百惠果醋的做法大全
怀孕可以吃黄豆	怀孕可以吃黄豆
来月经可以喝红枣枸杞吗	来月经可以和红枣枸杞吗
完美同步的差速齿轮怎么制造	完美同步的差速齿轮怎么制造
视神经萎缩	视神精萎缩
洗衣机洗被套用多少水	洗衣机洗被套用多少水
尖锐湿疣的初期症状	尖锐湿尤的初期症状
验尿需要空腹	验尿需要空腹
纸船怎么折	纸船怎么哲
紫癜病能治好	紫癜病能治好
拨打小杨的电话	拨打杨杨的电话
甘油三酯偏高怎么办	甘油三指偏高怎么办
人流后可以吹空调	人流后可以吹空调
眼底出血第二天还有扩散	眼底出血第二天还有扩散
蒲公英泡水喝的功效	朴公英泡水喝的功效
怀孕初期可以吃火龙果	怀孕初期可以吃火龙果
联盟等级框过多少级变一下	联盟等级框过多少级变一下
删了前任他又加我啥意思	删了前任他又加我啥意思
说话结巴怎么办	说话结吧怎么办
荨麻疹可以吃桃子	荨麻疹可以吃桃子
黄体囊肿有什么危害	黄体囊肿有什么危害
晚上睡觉磨牙是什么原因	晚上睡觉模牙是什么原因
六味地黄丸有副作用吗	六位地黄丸有副作用吗
脸上皮肤痒是怎么回事	脸上皮肤庠是怎么回事
三十除五	三十除五
便血有哪些原因	便血有那些原因
春天来了校园里的花草树木有什么变化	春天来了校园里的花草树木有什么变化
铺开并向四周伸展成语	铺开并向四周伸展成语
喝阿莫西林能喝酒	喝阿莫西林能喝酒
三叉神经穿刺手术多久能恢复	三叉神经穿刺手术多久能恢复
小儿打呼噜是病吗	小二打呼噜是病吗
最具催眠效果的音乐	最具催眠效果的音乐
oppowatch充电的方法	oppowatch充电的方法
了解的英文	了解的英文
浙江事业单位什么时候报名	浙江事业单位什么时候报名
朱耷的字	朱熹的字
嘴唇上长泡怎么办	嘴唇上张泡怎么办
孕妇能吃橘子吗晚期	孕妇能吃桔子吗晚期
来月经腰痛	来月经要痛
成都有没有哥哥	成都有没有哥哥
类风湿早期症状	类风湿早起症状
我的oppo账号	我的oppo账号
林俊杰专辑为啥小十四	童俊杰专辑为啥小十四
孕妇能吃枸杞叶吗	孕妇能吃狗杞叶吗
没有插入会怀孕	没有插入会怀孕
荨麻疹一到晚上就痒	寻麻疹一到晚上就痒
来大姨妈可以喝咖啡吗	赖大姨妈可以喝咖啡吗
强迫症可以治疗	强迫症可以治疗
转钱显示对方账户异常	转钱显示对方账户异常
孕妇可以吃烧仙草	孕妇可以吃烧仙草
手上长水泡怎么办	手上张水泡怎么办
感冒嗓子哑	感冒桑子哑
内分泌失调是什么	内分必失调是什么
临沂货车通行证网上办理	临沂货车通行证网上办理
蒲公英的功效与作用	蒲公英的工效与作用
周口什么时候开学	周口什么时候开学
营养不良的症状	营养不良的证状
来例假可以吃榴莲吗	来历假可以吃榴莲吗
感冒喝什么汤	感冒呵什么汤
身体虚弱腰疼怎么调理	身体虚弱腰疼怎么调理
低血压的危害	低血压的为害
支原体感染是什么意思	支愿体感染是什么意思
什么是乙肝病毒携带者	什么事乙肝病毒携带者
迈凯伦汽车标志	迈凯轮汽车标志
登高中揭出前文所蕴含的比兴	登高中揭出前文所蕴含的比兴
怎么设置你	怎么设置你
小孩可以吃芒果	小孩可以吃芒果
程颖是什么朝代	戴颖是什么朝代
淋巴细胞偏低	琳巴细胞偏低
电影演员王志飞的妻子是谁	电影演员尚志飞的妻子是谁
怀孕的初期症状体重	怀孕的初期症状体重
小度今天的天气怎么样	小度今天的天气怎么样
妊娠糖尿病可以喝孕妇奶粉吗	妊娠糖尿病可以和孕妇奶粉吗
双眼皮做哪种好	双眼皮做那种好
甲沟炎用什么药膏	甲钩炎用什么药膏
旅游促销方案怎么写	旅游促销方案怎么写
开塞露有副作用吗	开赛露有副作用吗
回奶的食物有哪些	会奶的食物有哪些
芋头粉干的做法大全	芋头粉干的做法大全
做完人流多久复查	昨完人流多久复查
我女儿漂亮吗	我女儿漂亮吗
坐月子有湿疹怎么办	做月子有湿疹怎么办
是什么动物	似什么动物
来月经能喝酒吗	来月经能和酒吗
虾不能和什么一起吃	吓不能和什么一起吃
五十除十二	五十除十二
心梗先兆症状吃什么药	心梗先兆症状吃什么药
海星怎么吃	海星怎麼吃
小三阳和大三阳哪个严重	小三阳和大三阳那个严重
热感冒怎么办	热感冒怎么半
需要刷机	需要刷机
gta五麦克机场任务怎么做	gta五麦克机场任务怎么做
糖尿病可以吃鱿鱼	糖尿病可以吃鱿鱼
食物中毒的症状	食物中毒得症状
怀孕可以喝养乐多	怀孕可以喝养乐多
拉肚子怎么回事	拉肚子怎么会事
水稳里可以用粉煤灰吗	水稳里可以用粉煤灰吗
你长胡子了吗	你长胡子了吗
突然胸痛胸闷是什么原因	突然胸痛胸闷是什么原因
新生儿睡觉不踏实	新声儿睡觉不踏实
肖战喜欢王一博吗	肖战喜欢王一博吗
莓菌性阴炎怎么根冶	莓菌性阴炎怎么跟冶
来大姨妈能洗头	来大姨妈能洗头
霉菌阴道炎	霉菌阴到炎
尿道结石怎么治疗	尿道结实怎么治疗
前列腺增生吃什么药	前裂腺增生吃什么药
眼睛充血用什么眼药水	眼睛冲血用什么眼药水
刮痧多久刮一次	刮痧多久挂一次
梦见别人作手术	梦见别人做手术
下奶的食物有哪些	下奶的食物有那些
三角形的周长公式	三角形得周长公式
热敷消肿	热敷消肿
皮肤发痒怎么回事	皮夫发痒怎么回事
中美联合招考物理研究生项目	中美联合招考物理研究生项目
她怎么不说话	她怎么不说话
指甲长到肉里怎么办	指甲涨到肉里怎么办
制售假烟金额五百万以内什么罪	制售假烟金额五百万以内什么罪
拉肚子能喝酸奶	拉肚子能喝酸奶
耳朵后面长了个小疙瘩	耳朵后面涨了个小疙瘩
怎样快速去眼袋	怎样快速去眼带
江西农保怎么交费	江西农保怎么缴费
忧郁症的表现	忧郁症得表现
尿毒症的症状有哪些	尿毒症的症状有那些
如何查找淘宝的淘气值	如何查找淘宝的淘气值
明天有雨下吗	明天有雨下吗
充电宝要托运	充电宝要托运
发到微信群里的图片怎么撤回	发到微信群里的图片怎么撤回
聚鑫是什么意思	聚心是什么意思
健的大写字母怎么写	健的大写字母怎么写
白蛋白偏高	白蛋百偏高
孕妇可以吃兰花豆	孕妇可以吃兰花豆
oppo会员是干嘛的	oppo会员是干嘛的
决明子的功效与作用	决明子的工效与作用
甲状腺结节能吃海带	甲状腺结节能吃海带
国庆节在十月一日用英语怎么说	国庆节在十月一日用英语怎么说
孕妇能吃干贝	孕妇能吃干贝
脚后跟疼是怎么回事	脚侯跟疼是怎么回事
男朋友要读博作为女朋友怎么办	男朋友要读博作为女朋友怎么办
黑色衬衫下面配什么好看	黑色衬衫下面配什么好看
吴生的拼音	厉生的拼音
脚趾甲长到肉里怎么办	脚止甲长到肉里怎么办
带状泡疹最佳治疗方法	带状疱疹最佳治疗方法
生理期可以吃什么水果	生理期可以吃什麼水果
脑膜炎后遗症能治好吗	脑莫炎后遗症能治好吗
什么是附件炎	什么事附件炎
脚受伤了吃哪些食物恢复得快	脚受伤了吃那些食物恢复得快
金三顺作品	金叁顺作品
腰椎管狭窄的治疗方法	腰椎管侠窄的治疗方法
张钰琪在哪里	张子琪在哪里
眼睛里进东西了怎么办	眼睛里进动西了怎么办
什么内容	什么内容
二的十次方	二的十次方
安阳有那些县	安阳有哪些县
胃痛可以喝蜂蜜水吗	胃痛可以和蜂蜜水吗
之前得过肺结核用激素会复发吗	之前得过肺结核用激素会复发吗
cctv节目官网	cctv节目官网
感冒可以吃生蚝	感冒可以吃生蚝
防雾霾的n九十五口罩可以防病毒吗	防雾霾的n九十五口罩可以防病毒吗
零乘零	零乘零
来月经可以泡脚吗	来月经可以跑脚吗
腿上有红圈怎么回事	腿上有红圈怎么回事
郑开头成语	郭开头成语
淋巴细胞百分比偏高	琳巴细胞百分比偏高
小孩腹泻吃什么药好得快	小孩腹泻吃什么药好的快
为什么脖子上长小肉粒	为什么勃子上长小肉粒
泰州公积金查询电话	泰州公积金查询电话
板面汤怎么做	版面汤怎么做
四字人生哲理	四字人生哲理
水丸和蜜丸的区别	水丸和密丸的区别
耳朵流水怎么办	耳多流水怎么办
心脏早搏吃什么药	心藏早搏吃什么药
怀孕可以喝豆浆	怀孕可以喝豆浆
房管局备案夫妻都要去吗	房管局备案夫妻都要去吗
在项目启动期间一名关键相关方	在项目启动期间一名关键相关方
例假前白带会增多	例假前白带会增多
一百二十五乘八	一百二十五乘八
孕妇能喝椰子汁	孕妇能喝椰子汁
艾滋病有治愈的吗	爱滋病有治愈的吗
梦见被鬼追杀	梦见背鬼追杀
孕妇可以吃炒黄瓜	孕妇可以吃炒黄瓜
孕妇可以吃银耳	孕妇可以吃银耳
为什么吃了藠头肚子痛	为什么吃了藠头肚子痛
疱疹和湿疹	泡疹和湿疹
电脑坏了怎么修	电脑坏了怎么休
绿萝的营养液怎么配	绿箩的营养液怎么配
经期能喝柠檬水吗	经期能喝拧檬水吗
唐国强岁数	张国强岁数
没有反回键	没有返回键
右胸口疼是怎么回事	友胸口疼是怎么回事
糖尿病人能吃什么水果	糖尿病人能吃什么水果
烧心是怎么回事	烧心是怎么会事
什么的目光	什麼的目光
螃蟹死了还能吃吗	庞蟹死了还能吃吗
手哆嗦是什么原因	手多嗦是什么原因
骨头坏死能治好	骨头坏死能治好
工行北塘支行电话	工行北塘支行电话
骨质疏松的症状	骨质疏松的证状
豆浆机什么牌子的好	豆将机什么牌子的好
可拉伸的爱心怎么叠	可拉伸的爱心怎么叠
为什么不能生你的气	为什么不能生你的气
吴生的拼音	荣生的拼音
samuelmorse发明了什么	samuelmorse发明了什么
现在几点钟	现在几点钟
历史朝代表	历时朝代表
脚趾麻木是怎么回事	脚止麻木是怎么回事
哺乳期能吃薄荷糖	哺乳期能吃薄荷糖
脑出血前兆是什么反应	脑出血前兆是什么反应
带状疱疹严重	带状疱疹严重
施丽丽的老公叫什么	储丽丽的老公叫什么
宁河滨江锦园物业电话	宁河滨江锦园物业电话
没有网络	没有网络
你智力好	你智力好
甲状腺结节有哪些症状	甲状腺结结有哪些症状
怀孕能吃鹅蛋	怀孕能吃鹅蛋
手机听筒声音小怎么办	手机听桶声音小怎么办
哺乳期发烧可以打针	哺乳期发烧可以打针
朱熹是哪个朝代的	朱棣是哪个朝代的
石家庄四院上班时间	石家庄四院上班时间
低血糖是怎么回事	低血唐是怎么回事
抽烟喝酒对怀孕有影响	抽烟喝酒对怀孕有影响
不射进去会怀孕吗	不射进去回怀孕吗
真菌感染可以用碘伏	真菌感染可以用碘伏
腹泻可以喝蜂蜜水	腹泻可以喝蜂蜜水
怀集到三水高铁时间表	怀集到三水高铁时间表
重庆迈科唯待遇怎么样	重庆迈科唯待遇怎么样
张韶涵的音域有多宽	乔韶涵的音域有多宽
经期喝柠檬水好吗	经期和柠檬水好吗
六十四加六十四	六十四加六十四
生理期可以洗头发吗	生理期可以冼头发吗
怎么删除淘宝订单	怎么删除淘宝定单
什么是下午茶	什么事下午茶
慢性胃炎可以吃鱼子吗	慢性胃炎可以吃鱼籽吗
宝宝猛涨期的表现是什么	宝宝猛长期的表现是什么
哪里烧烤最好吃	那里烧烤最好吃
白玉菇有臭味能吃吗	白玉菇有臭味能吃吗
剖腹产后多久可以下床	破腹产后多久可以下床
处女膜没破会怀孕吗	初女膜没破会怀孕吗
如何治疗荨麻疹	如何治疗荨麻诊
二十年江门最低工资标准	二十年江门最低工资标准
来月经可以洗澡洗头	来月经可以洗澡洗头
跳绳能减肥	跳绳能减肥
中国前十大上市公司	中国前十大上市公司
昂科威倒车镜怎么拆	昂科威倒车镜怎么拆
腿为什么会抽筋	退为什么会抽筋
血氧饱和度正常值	血养饱和度正常值
经常口腔溃疡是什么原因	经常口腔溃阳是什么原因
怀孕为什么会流血	怀孕为什么会留血
他达拉非片是性药吗	他达拉菲片是性药吗
直面惨淡的人生什么意思	直面惨淡的人生什么意思
怀孕初期可以吃枣	怀孕初期可以吃枣
幽门螺旋杆菌传染吗	幽门螺旋杆菌转染吗
吃什么可以长胖	吃什么可以涨胖
月经后几天是排卵期	月经后几天是拍卵期
胃胀气怎么回事	胃帐气怎么回事
香蕉和牛奶可以一起吃	香蕉和牛奶可以一起吃
做蛋糕用什么面粉	坐蛋糕用什么面粉
吃完紧急避孕药可以喝酒	吃完紧急避孕药可以喝酒
孕妇能用沐浴露吗	孕妇能用沐浴乳吗
开封武夷路属于哪个区	开封武夷路属于哪个区
男性尿血是怎么回事	男姓尿血是怎么回事
东莞火车站在哪里	东莞火车站在那里
猪是家禽	猪是家禽
右边腰疼是怎么回事	有边腰疼是怎么回事
张大千是个怎样的人	张大力是个怎样的人
血栓怎么治疗	学栓怎么治疗
如何分辨零线和火线	如何分辨零线和火线
拔完牙多久可以喝水	把完牙多久可以喝水
流产后几天可以出门	留产后几天可以出门
甲状腺结节可以吃燕窝	甲状腺结节可以吃燕窝
外阴瘙痒用什么药好	外因瘙痒用什么药好
月经期间能拔牙吗	月经其间能拔牙吗
抓娃娃抓哪个部位好抓	抓娃娃抓哪个部位好抓
嘉兴哪里有好玩的地方	嘉兴那里有好玩的地方
湿疹可以吃西瓜	湿疹可以吃西瓜
大便不成型	大便不成性
芦荟胶的功效与作用	芦荟交的功效与作用
一百二十五乘八十	一百二十五乘八十
十五除七化成小数是多少	十五除七化成小数是多少
九乘九等几	九乘九等几
荨麻疹的原因	荨麻疹得原因
高锰酸钾能治脚气吗	高锰酸钾能治脚气马
长针眼怎么办	张针眼怎么办
你为什么不接话	你为什么不接话
换电话微信怎么恢复	换电话微信怎么恢复
舌吻会传染艾滋病	舌吻会传染艾滋病
为什么还没到账	为什么还没到账
怎么做好微商	怎么坐好微商
肝钙化是什么意思	肝丐化是什么意思
死亡率是逐年变化的且变化幅度在不同的年龄段不同较年轻年龄段与较年老年龄	死亡率是逐年变化的且变化幅度在不同的年龄段不同较年轻年龄段与较年老年龄
牛奶什么时候喝最好	牛奶什么时候和最好
什么是儿童抽动症	什么事儿童抽动症
我要咋样	我要咋样
失重条件下生长素可以横向	失重条件下生长素可以横向
杭州哪里看妇科好	杭州哪里看妇科好
苹果手机怎么删除id帐号	苹果手机怎么删除id帐号
月经期可以吃阿胶	月经期可以吃阿胶
阑尾炎手术后可以吃蛋糕	阑尾炎手术后可以吃蛋糕
张杰的老婆是谁	唐杰的老婆是谁
周公解梦梦见自己在捡钱	周公解梦梦见自己在捡钱
六味地黄丸的功效与作用适宜年龄	六位地黄丸的功效与作用适宜年龄
左胸疼是怎么回事	昨胸疼是怎么回事
左卵巢囊肿	做卵巢囊肿
拉肚子能吃什么	垃肚子能吃什么
尿液发红怎么办	尿夜发红怎么办
胃食管反流不能吃什么	胃食管返流不能吃什么
山东农村无人居住的危房怎么处理	山东农村无人居住的危房怎么处理
于震演过的电视剧	于波演过的电视剧
怀孕能涂口红	怀孕能涂口红
血糖低怎么办	血糖低怎么半
得了癌症怎么办	的了癌症怎么办
如何清除健康使用手机	如何清除健康使用手机
月经期可以吃乌鸡白凤丸	月经期可以吃乌鸡白凤丸
小儿多动症的表现	小二多动症的表现
发烧能吃橘子	发烧能吃橘子
经期能艾灸	经期能艾灸
手上长鸡眼怎么办	手上长几眼怎么办
膝盖痛是什么原因	希盖痛是什么原因
感冒发烧能吃橙子	感冒发烧能吃橙子
梦幻西游低等级五开	梦幻西游低等级五开
艾薇儿有哪些好听的歌	陈薇儿有哪些好听的歌
孕妇能吃生姜	孕妇能吃生姜
你知道我的生日吗	你知道我的生日吗
张欣的电视剧	葛欣的电视剧
腹泻能吃橙子	腹泻能吃橙子
机动车免上线年检流程	机动车免上线年检流程
什么是挂靠户口	什么事挂靠户口
惊天动地意思和造句	惊天动地意思和造句
四乘八	四乘八
老流鼻血怎么回事	老留鼻血怎么回事
心脏供血不足怎么治	心脏功血不足怎么治
二郎神属什么生肖	二朗神属什么生肖
来月经可以刮痧吗	来月经可以括痧吗
你是男的还是女的	你是男的还是女的
抗甲状腺过氧化物酶高	扛甲状腺过氧化物酶高
恶心是怀孕了	恶心是怀孕了
孕妇可以喝红糖水吗	孕妇可以和红糖水吗
银行一般几点上班	银行一搬几点上班
你是男还是女	你是男还是女
绍兴有哪些高中	绍兴有那些高中
九十五年大年三十是什么星座	九十五年大年三十是什么星座
拉的黑色的屎怎么回事	拉的黑色的是怎么回事
输尿管结石的症状	输尿管结石得症状
李一一这个名字好吗	李天一这个名字好吗
熊猫的脾气描写句子	熊猫的脾气描写句子
前庭神经炎	前厅神经炎
罗浩是哪部电视剧	林浩是哪部电视剧
痛风可以吃海鲜	痛风可以吃海鲜
使用微信时卡顿	使用微信时卡顿
端午节的习俗	端午节的习素
怎样注销支付宝账户	怎样注消支付宝账户
朴实的朴可以组什么词	朴素的朴可以组什么词
百度自媒体在哪里进入	百度自媒体在哪里进入
华为mate二十铃声渐强怎么设置	华为mate二十铃声渐强怎么设置
什么动物会变形	什么动物会变性
经期可以喝逍遥丸	经期可以喝逍遥丸
走之旁汉字	走之旁汉子
杨乐乐哪里人	仲乐乐哪里人
四十六除二	四十六除二
淋病梅毒早期症状	淋病梅毒早起症状
福州狗市场在哪里	福州狗市场在哪里
小便时尿道刺痛是怎么回事	小便是尿道刺痛是怎么回事
你的参数是多少	你的参数是多少
上古卷轴五黑暗兄弟会任务对直线有影响吗	上古卷轴五黑暗兄弟会任务对直线有影响吗
哺乳期乳房有硬块是怎么回事	补乳期乳房有硬块是怎么回事
生资驾校考试考场在哪	生资驾校考试考场在哪
你怎么这么聪明	你怎么这么聪明
无线路由器忘记密码怎么办	无限路由器忘记密码怎么办
孩子脸上有白斑是怎么回事	孩子脸上又白斑是怎么回事
息屏时间	熄屏时间
科枫壁挂炉厂家电话	科枫壁挂炉厂家电话
拉血怎么回事	啦血怎么回事
心率快吃什么药	心率块吃什么药
丰润区法院电话	丰润区法院电话
血糖高吃什么水果	血糖高吃什么水国
透析一次多少钱	透希一次多少钱
裁剪视频区域的软件	裁剪视频区域的软件
根据劳动法第十四条规定	根据劳动法第十四条规定
广州哪里买狗好	广州哪里买狗号
crv本田二千零一十九款导航怎么关闭	crv本田二千零一十九款导航怎么关闭
新生儿肺炎的症状有哪些	新生儿肺炎的症状有那些
工行卡异地注销流程	工行卡异地注销流程
罗志祥女友谁	宓志祥女友谁
红米五plus吃鸡灵敏度	红米五plus吃鸡灵敏度
虎林到鸡西火车时刻表	虎林到鸡西火车时刻表
篮球板到底线标准尺寸	篮球板到底线标准尺寸
你会不会打麻将	你会不会打麻将
跨国公司在经济全球化中的作用	跨过公司在经济全球化中的作用
试管婴儿的小孩是不是都是很健康的	试管婴儿的小孩是不是都是很健康的
手上起水泡是怎么回事	收上起水泡是怎么回事
重庆哪些是三甲医院	重庆哪些是三甲医院
哪个叫什么	那个叫什么
怀孕初期可以吃西瓜吗	怀孕出期可以吃西瓜吗
怀孕肚子硬	怀孕肚子硬
真的假的	真的假的
临汾规划四街在哪	临汾规划四街在哪
刚来完月经是安全期	刚来完月经是安全期
学前教育和学前教育学的概念	学前教育和学前教育学的概念
乳房疼痛怎么回事	乳房疼痛怎么会事
先有鸡还是先有蛋	先有鸡还是先有单
拉肚子可以吃橘子吗	拉肚子可以吃桔子吗
一直拉肚子是怎么回事	一只拉肚子是怎么回事
不射进去会怀孕	不射进去会怀孕
苏州浒墅关工商局电话	苏州浒墅关工商局电话
山西都有哪些县	陕西都有哪些县
三型防水是什么意思	三型防水是什么意思
来例假能喝茶吗	来历假能喝茶吗
荒野大镖客两线上线下哪个好玩	荒野大镖客两线上线下哪个好玩
农行卡网上怎么激活	农行卡网上怎么激活
李鸿章是谁	李鸿厍是谁
偏头痛是怎么引起的	偏头痛是怎么引起得
专心的看叫什么视	专心的看叫什么是
湿疹能吃红枣	湿疹能吃红枣
治高血压的水果	制高血压的水果
怀孕怎么分辨男女	怀孕怎么分变男女
哺乳期可以吃板蓝根颗粒	哺乳期可以吃板蓝根颗粒
国产奶粉三段哪个好	国产奶粉三段哪个好
我的心在哪里	我的心在哪里
月经推迟也没有怀孕的症状怎么回事	月经推迟也没有怀孕的症状怎么回事
网站攻击的常见方式	网站攻击的常见方式
幸运快三官方开奖结果	幸运快三官方开奖结果
求李白《行路难》背景简介	求李密《行路难》背景简介
建行的基金怎么赎回	建行的基金怎么赎回
桂林有蜂鸟众包	桂林有蜂鸟众包
民政局有哪些部门	民政局有那些部门
成都好玩的地方	成都好玩得地方
十五乘十五	十五乘十五
人工流产需要多少钱	人工流产许要多少钱
补血的药物有哪些	补血得药物有哪些
河南防疫部门电话	河南防疫部门电话
神经性耳聋的治疗方法	神精性耳聋的治疗方法
心情不好怎么办	心请不好怎么办
程咬金是什么生肖	许咬金是什么生肖
黑头怎么去掉	黑头怎么取掉
消逝的光芒怎么丢炸弹	消失的光芒怎么丢炸弹
女生月经推迟十天正常吗	女生月经推迟十天正常吗
汽车坐垫什么牌子好	汽车做垫什么牌子好
乳腺增生可以喝蜂蜜	乳腺增生可以喝蜂蜜
小番茄糖分多吗	小番茄糖份多吗
孙子涵致命的温柔歌词	牛子涵致命的温柔歌词
唐军叶龙是什么电视	唐军叶龙是什么电视
淋巴结肿大是什么原因	淋疤结肿大是什么原因
五百四十除九	五百四十除九
怀孕可以吃鸭肠	怀孕可以吃鸭肠
宝宝打喷嚏流鼻涕怎么办	宝宝打喷涕流鼻涕怎么办
筋断了吃什么好得快	筋断了吃什么好的快
月经期间可以吃薏米吗	月经期间可以吃苡米吗
诸葛亮的儿子是谁	诸葛月的儿子是谁
鼻窦炎能治	鼻窦炎能治
孕妇可以吃火腿肠	孕妇可以吃火腿肠
怎样消除打嗝	怎样消除打隔
高考之后报什么学校好	高考之后报什么学校好
来月经有血块是怎么回事	来月经又血块是怎么回事
脚上起小水泡是怎么回事	脚上气小水泡是怎么回事
脚后跟痛怎么办	脚后根痛怎么办
后颈部长痘痘用什么药好	后颈部长痘痘用什么药好
痛风能吃鲈鱼吗	痛风能吃芦鱼吗
我的妈妈结尾怎么写二百	我的妈妈结尾怎么写二百
怎么查车架号	怎么差车架号
孕四月不小心撞到肚子	孕四月不小心撞到肚子
燕麦回奶	燕麦回奶
哺乳期可以拔罐	哺乳期可以拔罐
与正和怀有关的成语	与正和怀有关的成语
今天是什么日子	今天是什么日子
酷暑难挡是什么意思	酷暑难当是什么意思
三百六十除九	三百六十除九
ipad无法卸载	ipad无法卸载
怀孕多久能测出来	还孕多久能测出来
湿气重怎么治疗	湿汽重怎么治疗
小腹坠胀怎么回事	小腹赘胀怎么回事
施丽丽的老公叫什么	匡丽丽的老公叫什么
甲亢的症状有哪些	甲亢的症状有那些
老是长口腔溃疡是什么原因	老是张口腔溃疡是什么原因
赵本山前妻	赵本丰前妻
心血管堵塞	新血管堵塞
你的妈妈是谁	你的妈妈是谁
湿热型体质如何调理	湿热性体质如何调理
支付宝可以买火车票	支付宝可以买火车票
没有工作党费怎么交	没有工作党费怎么交
尿血是怎么回事	尿血是怎么会事
你想对我说什么	你想对我说什么
邮政侯马中心在哪里	邮政侯马中心在哪里
哪些昆虫是害虫	那些昆虫是害虫
二十年农历三月出生是什么命	二十年农历三月出生是什么命
扁桃体肿大分度	扁桃体重大分度
你是不是人工智能	你是不是人工智能
脂肪肝可以吃生蚝	脂肪肝可以吃生蚝
包皮手术要拆线	包皮手术要拆线
颈椎病症状	颈椎病政状
散装酒可以快递	散装酒可以快递
拉黑屎怎么回事	拉黑是怎么回事
查乙肝五项需要空腹吗	差乙肝五项需要空腹吗
海鲜过敏怎么办	还鲜过敏怎么办
不管是什么都往嘴里添	不管是什么都往嘴里填
小腹坠胀怎么回事	小腹坠涨怎么回事
什么是腺样体面容	什么事腺样体面容
先进生产力的发展要求”是指	先进生产力的发展要求”是指
喝牛奶拉肚子怎么办	喝牛奶啦肚子怎么办
血糖高的人可以吃红薯	血糖高的人可以吃红薯
肺部结节怎么治疗	肺部结界怎么治疗
去肝火的食物	去干火的食物
吃头孢可以喝啤酒吗	吃头孢可以和啤酒吗
上个润四月是哪一年	上个润四月是哪一年
月经期间可以吃雪蛤	月经期间可以吃雪蛤
小朋友可以喝蜂蜜水吗	小朋友可以和蜂蜜水吗
密饯是什么	蜜饯是什么
什么生辰八字容易招鬼	什么生辰八字容易招鬼
你会嫌弃我吗	你会嫌弃我吗
甲状腺回声不均匀是什么意思	甲状腺回升不均匀是什么意思
人流后多久来月经	人流后多久莱月经
吃橙子会胖	吃橙子会胖
双侧肾盂未见明显分离是什么意思	双测肾盂未见明显分离是什么意思
天麻多少钱一斤药店	天麻多少钱一斤药店
缺少维生素c的症状	却少维生素c的症状
痛风可以吃花生	痛风可以吃花生
马达上面的齿轮怎么弄下来	马达上面的齿轮怎么弄下来
校花是男的女的	校花是男的女的
一寸等多少厘米	一寸等多少里米
吃榴莲上火	吃榴莲上火
怀孕几个月长妊娠纹	怀孕几个月长任娠纹
肠镜检查前应注意什么	肠境检查前应注意什么
肚子胀拉不出大便怎么回事	肚子帐拉不出大便怎么回事
返流性食道炎	返流行食道炎
你长什么样子	你长什么样子
川大哲学考研参考书目	川大哲学考研参考书目
有痰咳不出来怎么办	有谈咳不出来怎么办
设随机变量x服从二项分布bnp则ex等	设随机变量x服从二项分布bnp则ex等
嘴唇上长泡怎么办	嘴唇上长疱怎么办
电饼铛什么牌子好	电饼档什么牌子好
鸡眼长什么样	鸡眼涨什么样
你是女的还是男的	你是女的还是男的
拔火罐可以减肥	拔火罐可以减肥
做散瞳对眼睛有伤害吗	做散童对眼睛有伤害吗
现在考驾照难吗	现在靠驾照难吗
一什么浪花	一什麼浪花
a五是五g手机	a五是五g手机
小熊电砂锅出现eoo是何故障	小熊电砂锅出现eoo是何故障
神经性头痛怎么治疗	神精性头痛怎么治疗
气怎么样	气怎么样
贫血吃什么药好的快	贫血吃什么药好得快
猫能吃方便面	猫能吃方便面
脚底出汗是什么原因	脚底出汉是什么原因
师尊黑化的腹黑徒弟小说	师尊黑化的腹黑徒弟小说
咽喉滤泡增生怎么治疗	咽后滤泡增生怎么治疗
接吻能不能减肥	结吻能不能减肥
平行四边形的面积公式是什么	平行四边行的面积公式是什么
后背疼是怎么回事	后北疼是怎么回事
梅毒的症状	梅毒的政状
钟汉良的老婆是谁呀	曲汉良的老婆是谁呀
药流好还是人流好	药流好还是人留好
九字情侣网名	九字情侣网名
甲状腺结节伴钙化	甲状腺结界伴钙化
震楼器会影响楼下吗	振楼器会影响楼下吗
企业支付的货物运输保险可以税前扣除吗	企业支付的货物运输保险可以税前扣除吗
上海房产税如何征收	上海房产税如何征收
怀孕一定会孕吐	怀孕一定会孕吐
昌平区兴寿镇半壁店书记	昌平区兴寿镇半壁店书记
爱默生是哪国人	艾默生是哪国人
月经流了一点点褐色就没有了	月经流了一点点褐色就没有了
乙肝病毒携带者能生孩子	乙肝病毒携带者能生孩子
经常性尿黄味道大是什么原因	经常性尿黄味道大是什么原因
北京甲状腺最好的医院	北京甲状腺最好的医院
肝炎的早期症状	肝炎的早起症状
孔子的主张	曾子的主张
喝什么茶排毒	和什么茶排毒
赤峰有华夏	赤峰有华夏
危垣怎么读	板垣怎么读
江西中医院梁瑞宁怎么样	江西中医院梁瑞宁怎么样
三十二除八	三十二除八
怎样去除螨虫	怎样去出螨虫
割包皮需要多少钱	割包皮须要多少钱
多久能成为瑜伽教练	多久能成为瑜伽教练
多少价位的电脑能lol	多少价位的电脑能lol
孕妇可以吃鸭肉	孕妇可以吃鸭肉
来大姨妈可以吃西瓜	来大姨妈可以吃西瓜
描写少年意气风发的长篇诗词	描写少年意气风发的长篇诗词
橙子怎么吃	橙字怎么吃
怎样会怀孕	怎样回怀孕
成都就业服务管理局电话	成都就业服务管理局电话
你有爸爸吗	你有爸爸吗
不消化肚子胀怎么办	不消化肚子涨怎么办
举头三尺有神明	举头三尺有神名
现任文山市公安局局长	现任文山市公安局局长
诗句的颈联是哪几句	诗句的颈联是哪几句
宙斯是谁	洛斯是谁
在括号里填上合适的数	再括号里填上合适的数
账户密码	帐户密码
怎么变得高情商	怎么变的高情商
小孩补什么钙好	小孩补什么盖好
什么是定向流量	什麼是定向流量
有什么电影好看	有什么电影好看
戴牙套要多少费用	带牙套要多少费用
什么是硬下疳	什么是硬下甘
阿胶糕的功效与作用	阿胶高的功效与作用
权志龙的发型怎么剪	汤志龙的发型怎么剪
女孩子取什么名字好听	女孩子取什么名子好听
林心如有孩子吗	龚心如有孩子吗
海南住房公积金一年可以提取几次	海南住房公积金一年可以提取几次
oppo手环设置夜间模式	oppo手环设置夜间模式
怀孕多久可以药流	怀孕多久可以药留
全麦面包能减肥	全麦面包能减肥
那必须的	那必须的
