十二乘零点五十六	十二乘三
一千除二十八等几	一千除一等几
二十四乘六	二十四除六
六百零九除六等	十二除六等
七百五十除十五除十五相等多少	七百五十除五等几
二十四乘二十	九十六除八
五十三乘十七等多少	五十三乘一百等多少
四十乘九	四十乘四十
七除零点三五	零点七除零点三五
六十四除四等几	一点五乘七
四乘零点二	零点四乘二点四
二十五乘十	三点九四加六点八六
九十乘九	九十减七十二
一百除零等多少	一百除十一等多少
一百九十乘六	四千除八
孕囊二十四乘十四是男是女	孕囊二十四乘十二是男是女
十六加几等二十五	九加几等二十五
十五乘十怎么算	十五乘十五等
零点三百七十五除三除八等多少	一除三除八等多少
十四除二当十几	二十四除二等多少
五乘六等多少	十五除二十五
五十一乘八十七	五十一乘五十四
三除二	二除二
八点一乘一除九	五乘一除九
六十九除三等多少	一百减五十五等多少
七除五十六	七除三
六十六除六等多少	五乘一等几
二十五点十二乘一百二十	二十五点十二乘十六
十二乘二十八	十二乘十七
一点二五乘二点四	一点二五乘四
一十一乘二十二	十二乘二十等多少
二点五乘零点四	零点九四乘二点五
一百四十乘十二	零点五乘零点二
二加二等四	四点八除零点四等多少
零点一乘十	零点三乘十
二十五除零点五	一百减六十二点五
二十二乘四十三的竖式	二十二乘二十五的竖式
一百七十六加一百七十六等几	十四减三等几
一百二十五乘三	五十八除二等多少
四十四乘五十六的竖式	三十四乘五十六的竖式
六百加六百是稍加	六百加六百相等几百
十二除三分之二	十二除四分之三
八十六乘三	三点一四乘一点七
一千乘一千	一千除一千
二十三乘五	一百加五十
十八减六等几	十八点二七除零点七
二十八乘十五等	二十八乘十八等
十二分之七除二十一	十二分之七除十二
五十五乘十	十二乘十
三加九	九加九
一除八分之七	七点五乘零点四
四点五乘三百零二等多少	四点五乘十八等多少
一点五除九点九	九除一点五
八十六乘三	八十六除三
五百四十除九十的竖式	五百四十除四十五的竖式
二加六加六	六加二加几
十三乘三	十三乘十三
三十七除二十	七除二十
二乘六等多少	六乘十五等多少
三十五乘八	五百五十六减三百七十九
五十四乘四	四乘四乘四
五除十二乘六十	五除十二乘一
九百零六除四的竖式计算	九百零六除九的竖式计算
六十四除六	七十六乘五
四十五乘五十六竖式计算	四十五乘四十五竖式计算
二十六乘二十六	零点二五乘一百
九百一十除十四除小	九百一十除十四等多多少少
五十五除二	八乘五
三十三乘三	三十三乘三十
五十乘十七	十七乘十七
一百二十四乘八十五等多少	一点二乘五等多少
四十七除二	八乘一点五
三点四除零点一七	十五除二十五
二十一乘九	零点二七除九
四十九乘十三	十乘十三
十四亿乘二百五十	二百五十乘二百五十
六百四十八乘六	十二乘六
七十乘四	五十乘七十
六百三十除七等多少	七乘八等几
四十五乘二	四十五乘四
二十四点五七除七等多少	十二除零点四
三十二乘十一	十七乘十一
七十除二	七点二除一点六
五十六乘九十九加五十六的简便运算	五十六加九十九乘五十六的简便运算
二十五乘十五	五十除三
六十乘六	六十乘十二
四百二十乘三	二点七除零点九
四十一乘二	四十一乘八
奇怪的近义词是什么一千零一奇怪的近义词是什么减百度	惊奇的近义词是什么一千零一惊奇的近义词是什么减百度
四除十七	四除十六
一百二十除五	五除五等几
六除五等多少	六除十二等多少
血压一百三十除一百正常吗	血压一百六十除一百正常吗
一点二五除零点五	一点五除零点二五
四点八乘一点两等几	六十乘一点两等几
二十乘七等多少	二十乘二十等多少
二百零四乘五	三点六除二
剑与远征二十二减十一怎么过	剑与远征二十二减四十六怎么过
五乘三加五乘四加三乘四	五乘三加五乘三加三乘三
七除四减三除八等几分之几	七除四减一除八等几分之几
一点二五除零点八	十四乘八等多少
一百二十除五	二百五十除五
十二除五	十二除零点五
六百除八竖式计算	一除八竖式计算
二百四十除六十等多少	二百四十除六等多少
四十五乘四十五	四十五乘零点八
七十除五	七百除五
零点一百二十五除八等微	零点一百二十五除零点八埒几
二百五十乘三等多少	二百五十乘四十等多少
一点二五乘四	一点四乘一点四
八减三	八减四
一点五乘三	一除六
四十二乘四	五十除八
一百二十四除四	十八加十五
一除二	二除一
血压九十除六十正常吗	血压一百二十除六十正常吗
二十一除三	六十四乘二
一百减五十	一百减十五
二十四减六	二十四除六
八乘零点二十五等多少	八乘六等多少
四分之三乘五	四分之三乘九
二百二十五除二十五	六百七十五除二十五
九百除四十五	五十乘三十
十六除十	十六除十二
七十二乘三点十四	十六乘三点十四
一百三十四除六十七	六十七除二
四除七除两等几分之几	六除七除两等几分之几
九除四	四除九
三十乘五等几	三十乘十五等多少
二百一十乘二十	三十除二十
六百五十除五十	七除五
七点五乘二	三十加三十
三十除二点四	十乘八
三十八乘五	三十八乘四
三点六除十	三除十
九百八十除五等多少	一除五等多少
三十除二	三十除二点二
二十五乘二十五乘二十五等有些	二十五乘二等多少
三十乘零点六	六乘三十
一百五十除二十五	十五乘十四
七十除八等多少	九除八等多少
七十乘二	五点七除三
零点三乘零点三	五乘一
十一乘十一	十二乘十二
七十乘三点一四	三点一四乘三点一四
三点一四除三点一四	五十点二四除三点一四
三加五等多少	三加五加几等多少
三百二十加三百二十等多少	十六乘十六等多少
一百四十乘三十	一百减四十
一百五十除三	一百五十除五
一百乘二十怎么列竖式	十二乘二十怎么列竖式
二十九乘二	五十六乘十五
十乘四十	四十乘四十
七十八减十八	七十八减八十三
五十五乘五十五	五十五乘二
零点一六除零点四	零点六除零点一六
三千除六百等多少	一百除六百等多少
九十九乘九十九	四百除五等
三点五除七	八乘八等多少
一百八十乘三十一	三十一乘五
五除四十五	五除十二
二十七乘五	二十七乘十五
七十五乘一百零二	七十五乘十
零点零八乘零点两	零点一乘零点两
二十五乘二十五等多少	六除十一
小布一百乘一百	小布一百加一百
三十六加三十六等多少	八除八等多少
二百五十乘四	二百五十除四
十四乘六	十四乘十四
六除八化成带分数	三除八化成带分数
九十一除七	十五减六
r十一除零点六	六百除三十
血压九十五减一百三十六	血压九十减一百三十六
色膏零除四十三是什么颜色	色膏八除四十三是什么颜色
二百乘四	八百乘四
五十四乘二十三的竖式怎么写	十六乘二十三的竖式怎么写
五百五十乘三十	零乘三十
七百二十除八十	三百加四百等几
十四加七等多少	十四加十四等几
五点二除二	五点五除二
三十一除一百一十九	三十一除十二
一百二十五乘四等多少	八十四除七
六百一十九除五等多少	六除五等多少
九百减七百三十五	九百减七百
零点零五乘零点零四等多少	六乘零点零四等多少
二十一乘二十一	二十一乘四十
二十五乘八十	三十乘三
一百二十四乘三十二	一百二十四乘二
二百七十除五	二百七十除六
大乐透六加两中零加两多少钱奖金	大乐透六加两中三加两多少钱奖金
四十八乘三等多少	零乘零等几
一百六十除三十	一百六十除二十
三十除八	十六加七
四十除六十等多少	四十除零等多少
三十九乘二	零点三五除五
三百除四十等多少	三百除五等多少
五百四十六除七等多少	五除七等多少
九除零点三	零点九除零点三
九十六乘四	一百减七十二
一百六十除二	一百六十二除二
九点十乘十	九点八乘八
三十二除六	九十六除三十二
八十一除九	八十一除二
零点四五除九	零点四五除零点九
八乘十吧	十五乘十吧
一百乘三十二怎么列竖式	十二乘三十二怎么列竖式
十除六十	零点六乘一百
十除六	十除十
五除十二乘六十	五除十二乘十三
三百五十除五等多少	十八乘二
一减七除十二等几	一减十除十二等几
三点一四乘四除二	三点二乘四
十四乘二等几	零点八乘二点五
一点七乘零点五	五十乘二十四
八十八除九	八十八除四
七十二乘三点十四等多少	一乘三点十四等多少
三百七十乘四十的竖式	四乘四十的竖式
双色球六加一多少钱	双色球五加一多少钱
一点二十五乘八	七十乘四十
三乘八百等多少	三乘十一等多少
五乘四	四点五乘五
一百七十乘三	一百七十乘三十
零点二四除三	零点二四除四
三点六乘三	三点六乘六
八十乘八	八十乘八十
一除三乘七十五	一除三乘十
九十除七	九十除九
三乘三乘三点一四怎么算	三乘四点二三
二百七十五除二点五	二百七十五除五
一百除一百等几	十七减八等几
二点四除零点五	四除二点五
二十五乘二等几乘几	二十五乘二怎么算
七乘三等多少	三乘十八等多少
一百八十除四等多少	三乘十三
二十八乘一百	二十八乘二十二
二百四十乘三什么样算	二百四十除三怎算
三十二乘二十四乘几	三十二乘二十四怎么算
二除三	二除二
三点一四乘八	三点一四乘六
七点二除零点九等多少	二除九等多少
二百零五乘三	七十二除三等多少
一百乘二百	二百乘二百
九十除七	九十除六十
七十五除十	七十五除一百五十
四十五乘三	四十五乘二
七乘九	九乘九
五加八等多少	四十乘十
二十五乘三十六	二十五加三十六
十四乘十四等多少	一百乘一百等多少
二百除四十等多少	四十除二等多少
三百乘六	六百乘三
四十乘六	十乘六
十二乘二十四	四加一等几
三十六x两除三等多少	五除三等多少
三百乘六	六百乘六
二十五乘一百二十五	二十九乘四
二百四十除三的竖式计算怎么写	二百四十除五的竖式计算怎么写
一百六十九除十三	三十九乘八
三点一四乘八乘八	三点一四乘八等
三十六乘三	十二点五乘八等多少
五百四十除九	五百四十除九十
四除十三等几分之几	十三除四等几分之几
二里面有几个一除六	五里面有几个一除六
八减十四怎么过	十四减八怎么过
十二除十二	十二除四分之三
零除九等多少	零除十等多少
六十三除九	六十三除二
十六乘一千二百五十	十六乘六
八十加八	十八乘二
四百八十除八	十二乘二十五
七乘几等二十	五乘几等二十
四百八十除八	六百四十除八
二十五乘五	二十五乘四
双色球七加三中零加一多少钱	双色球七加三中五加一多少钱
七除一千的最简分数	六百二十除一千的最简分数
四十九乘六十二	六十乘六十二
六百零三除六约	六百零二除六约
一百二十五乘十二	六十八乘六
五百零七除七的竖式计算	七除七的竖式计算
五十乘五十	四乘五十
七十八乘九	五乘十七
十五除五	十五除零点五
一万加一	五除二十
一百二十五乘二十七的简便运算	一百二十五乘十二的简便运算
二十二乘二十二	四十五除九等多少
三十五乘四等多少	四乘四乘四等多少
一万加一亿等多少	零点七除一点四
一百零二乘十九简便计算	一百零二乘十六简便计算
四十八除二点三	二十乘二十
二加二十等几	二十加二十等几
十五乘三十	十五乘十三
三十九乘七	三点一四乘三十九
二百乘一百五十乘六的方管一米多少多重	二百乘二百乘六的方管一米多少多重
五十五乘五十五	五十五乘七
十二十乘十八等多少	十八乘十二怎算
四减十八什么星座	四减四什么星座
零点二十六乘零点五	零点二十六乘二十四
六十五乘六十五	六十五乘三十
二十五除一百	一百除二十五
一百二十五加五十x八的简便计算	一百二十五加九x八的简便计算
三十八乘五	三十八乘八
九十九乘九十九等多少	九十九乘九等多少
三点八乘十六	一千二百八十乘十六
零点六乘零点三	零点六乘零点六
五十七除三等多少	四点七除三点一四
三十六减八等多少	零减八等多少
三十乘三十等多少	三十乘六等多少
二十三乘五十等多少	二十三乘四等多少
六百除八竖式计算	六十除八竖式计算
九点八乘十五等多少	九点八乘一千等多少
四十七乘五	二乘八等多少
二十九乘三十五	二十五乘三十五
三十除十二	十二乘三十
二百四十除十二	十九乘五十等多少
一百五十除六	六十除二点五
二十六乘六	三点一四乘零点二五
一百五十八乘十二	一百五十八减六十
六百一十二除五列竖式计算	六百一十二除七竖式计算
一百二十五乘三	八十除六
九百加九百等几	九百除三等几
一百二十乘五	三乘四十
一百二十五加七十乘八简便运算	一百二十五加二十五乘八简便运算
八点二十五乘五点四	八点五乘四怎算
六十四除四十怎么列竖式	六十四除八怎么列竖式
五点二五除零点二五	四点五除零点二五
孕囊八乘八mm	孕囊五乘五mm
五十除十	一千除十
一百零二乘六	一百二十五乘六
七十二乘三	七十二乘二
零点五乘二	零点五乘零点二
八加一等多少	四点五乘一点二
五百加一千五百等多少	五百加二百五十等多少
三乘五等多少乘多少相当多少	五加三乘三等多少
一点二乘四点五	五除十一等多少
三十一除一百一十九	三十一除一百一十
三百零六除三	三百零六除九
五十除十	五十除四十
九百除八等几	六除八等几
三十二点五除二点五	三百除五十
二十六乘二	七百五十除五
一百三十二除二	一百三十二除六
二点四乘二点五	五十乘二十五
零点三乘零点三	零点三乘零点五
三十二乘八	一乘八
四十二除二十一	零点七除零点四
二千乘六十	二千乘七百
八点五十四乘十点一	十四乘十点一
三十七乘四	十五乘十五等多少
三十五乘五	七百除十四
七十乘四十	零点八乘七
七十二除五	七十二除十二
四十五乘四十五	四十五乘三
五十七乘五	五乘五乘五
六乘五等几乘五乘五等六等几	六乘五等几
二百一十除七	二百一十除三十
三十六乘二十四	二十四乘二十四
十三乘五等多少	十三乘十四等多少
五乘四等多少	五百乘四等多少
二百五十除二十五	四百五十除二十五
五十四乘八	五十四减二十八
十四除二点五	零点一五乘八
一百除六	三点一四乘二点五的平方
三十八乘九	六乘九
一点八乘一等多少	四乘一等多少
四十乘六等	一乘六等
二十七乘十五	六十三除七等多少
二百五十乘四等多少	三加一呢
四十六乘八	九乘四等几
十八乘二十七	十八乘十九
四百零六除七十八	一百减七十二等多少
五乘二点五	四十乘二点五
六十四乘八	六十四乘六
三十五乘三十五	六十加六十
五百三十二除七的竖式怎么列	五百三十三除七的竖式怎么列
五十除十	五十除五
十六乘五等几	零加一等多少
八点五乘六	八点四乘五
四十六乘八乘一百二十五的简便计算	二十五乘八乘一百二十五的简便计算
三十三乘三	三点一四乘三十三
一点八乘五	八乘一点五
五点四除六	六点四除四
十六乘一千二百五十	十六乘九
一点二乘零点六	零点二乘六
四十三乘五十二竖式计算	四十三乘三十八竖式计算
七十乘十二	五十乘七十
一百零五除十三	一百零五除四十
二乘几等六	二乘几等十四
二十五乘二十五	二十五乘十二
一百五十除十	一点七乘零点五
四点三乘三点四乘四点一四	三点一四乘六十四埒多少
一百七十五除二十五	一百七十五除七
四十九乘十三	十一乘十三
三点五乘四	四点五乘五
五减一	五减三
七除五十六	七除四
四十五加十九	四十五加十六
六十二乘三	六十二除三
四十二除零点七	四十乘九
一百除九十五	一百除四十
六十五乘二十一	六十五乘五十
八十乘一百二十	十除十五等多少
一百二十五乘十六乘七的简便运算	一百二十五乘十六乘二十五的简便运算
五除十二乘九	五除十二乘四
三点十四乘零点零六百二十五	三点十四乘十一
六百一十九除五等多少	二十除五等多少
五加二等	零点七乘零点九
七百五十除五列竖式计算	七百五十除六竖式计算
二百五十除五	五除五等几
三十二加三十二加三十二加三十二怎算	三十二加多少等三十二
四十五乘三等多少	九点零七减六点七等多少
十四乘八加五	五乘八加五
一百七十六除二	一百九十除二
三十一乘五	三十一点四乘二
三十四乘五十八列竖式计算	四十四乘五十八列竖式计算
一百六十除四十八等多少	十六除四十八等多少
小布一万加一万	小布一千加一千
八除三分之一	八除八分之一
三乘七	四乘七
九点六除四	六点四除四
四十七点一除二	四十七除二
五百除二	五百除六十
七十二除十五	七十二除十六
一百二十五乘八等多少	六乘八等多少
减一除两的五次方	减一除两的四次方
两点三乘九	两点三乘两点四
零乘零等多少	零点六除四
四百五十除九等多少	十六乘三等几
四百五十九除三等多少	零除三等多少
五乘八	八乘八
一乘六	三乘四
二十四乘三点一四等不怎么	二十四乘三点四等多少
六十除八	六十除四
二十三乘五	二加九等几
三十二加九	十一加九
五百五十乘三十	一乘三十
二百五十六除二	二十乘一点五
二十一乘二十八怎么算	二十八乘二十一等几乘几
四分之三乘五	四分之三乘一百
一百二十五除三十	一百二十五除二十五
四十二除十等	六除十等
二十五点三除零点八八	三乘四等多少
四十二乘二	四十二乘六
四除四	七点八除三
六百四十除四等多少	三除四等多少
一点四乘零点五	二点四乘零点五
三十二除五十	三十二除十六
一减二	五乘三
九十六乘二十	九十六乘十二
r十一除七	一点四除零点七
八十四除六等多少	零点九乘零点三
九百除八等几	九百除十等几
五百四十除五	五百四十除六
三十七乘六	五加五等几啊
七十二乘二	十六除六
三百六十八除七的竖式怎么列	四除七的竖式怎么列
一点二五乘零点八	八乘一点二五
三十二加九等	三十二加四十等
六十四乘三点一四等略	六十四乘三点三等几
四十一除一千化成最简分数	四十一除六十化成最简分数
四十七乘二	八十除十二
五除十二乘六十	五除十二乘八
五十一乘五十	五十一乘零
三点0七十二除六点四	四点八乘零点九
五十四克除九等	五十四克除六等
零点零八乘零点两	零点八十六乘零点两
一百二十除十六	七加一等多少
五十乘零点八	零点八乘零点八
九百三十六除十二	三乘九
七百五十除五列竖式计算	十除五列竖式计算
英文数字一减十二	英文数字一减六
一百七十乘五十	零点五除零点二
四十八除二	四十八除二点三
一百二十八除八等多少	一除八等多少
五十六乘四	十八加八
二十四除六十	六十乘二十四
大乐透七加三中四加一多少钱	大乐透七加四中三加一多少钱
三点五乘零点四	三点四乘零点五
三十二乘四十	六十九乘七
十一除三分之一等多少	零除三分之一等多少
二十四乘二等多少	二百六十乘四
十八乘十八等多少	四乘十八等多少
三点五乘四点四乘三点五乘四点一乘一些一	四乘三点二四乘四点三四
七十六乘五	五点六除零点七
二百四十乘八除五	十乘八除五
十六乘十四	十四除十六
四十五除五等多少	零点五乘零点五
十八除五分之三等多少	六除五分之三等多少
七十五除十二	七十五除四
三乘一	九加九
四十除六十等多少	四十除三等多少
六点九除零点五四	零点五四除六
五十七乘二	五十七除二
十乘十乘八当几	十十乘八等多少
双色球十一加一中奖概率	双色球十加一中奖概率
九加几等十七	九加十七等几
四十五除零点九	六十三除七等多少
二十五除十	四点八除四
三百七十八除六等几	十二除六等几
二十八点二十六乘三分之	二十八点二十六乘八
一百二十四乘六十五	一百二十四乘十二
五十乘六等多少	五十乘十五等多少
三点五乘零点四	三点六乘零点四
血压九十除六十正常吗	血压一百九十除六十正常吗
九十六除二	九十八除二
八点八除零点二	八点四除零点二
√一除一百七十九等多少	√一除二十五等多少
三十四除零点一七	零点一三除零点一七
五百二十除五的竖式怎么列	二百一十除五的竖式怎么列
七十八点六除十一	十一除六
一点五乘四	十六除二十五
四百八十除四十	三点一四乘九百
十三除六十的最简分数	五十除六十的最简分数
一百六十加一百六十	一百八十加一百八十
五十四除二等多少	三百加五百等几
二点四乘五	四乘二点五
四十六乘十三	九乘十三
一除零	零除零
三百二十五除五	一万乘一万
九乘十八	六百除六十
一百二十乘三	十二乘十八
二百五十乘三	二百五十乘六十
一百乘五	一百乘一
七百二十三除六等多少列竖式	七百二十三除八等多少列竖式
八十五除二	四十乘三
五十五乘三十八的竖式怎么列	五十五乘三十的竖式怎么列
三十六乘十一	三乘九等多少
九点六除八	六除九
一百乘一百等几	八加十二
四十五除五等多少	四十五除十五等多少
七分之四除三	七分之四除六
一点八乘零点六	七除八等几
四十五乘一点五	四十五除一点五
九十九除七	九十九除五
三点一四乘十六相当几	三点一四乘六十二怎算
五分之一乘四分之三	五分之一乘二分之三
六除多少等四	四除多少等六
二加三	二加二
九十除十五等多少	九十除五等多少
二加二十等几	二十加八十等几
三十九乘二	三十九除二
六乘十	六乘十一
三十四乘七	十五乘二十一
五点一除零点五	五除零点一
三十六乘五	三加三呢
四点五除零点九	四百加四百等多少
七十乘七十乘五十	七十乘五十相当于多少
三点一四乘一点二	十乘十
八十三乘五十五	七十乘五十五
一百除四十五等几分之几	一百除五等几分之几
三十二加二十	六十加二十
四十九乘多少埒七	四十九除七等不怎么
七十五乘一百零二	七十五乘四十
八十八除九	八十八除八
二十七点七千五百七十六乘七十	一百乘七十
二百乘二百	二百除四十
二点五乘零点零八	四十乘三点一四
二十五乘四十	二分之一减二等多少
六除一点五等九分之几	一除一点五等九分之几
三百六十五乘八	零乘八
二十三除二十四	二十三除十八
四十九乘三点二二乘四点三二	三点一四乘四十九等
一点四乘三点两	一点四乘十八
一百二十乘二十五怎算	一百二十除二十五怎列
五百一十五除三的竖式	四除三的竖式
三除五	九百除四
六十加六十	十一乘五十
七除七	零除零
三百二十乘二十五	零点九一除一点三
五十六乘四	七乘三点一四
五十二乘三十的竖式计算怎么写	三十乘三十的竖式计算怎么写
二十四除二十五	四十三乘七
三十二除五十	三十二除十五
九乘四等多少	零点三六除零点六
二百二十除四	六十四乘三
二百八十乘五十	二百八十乘十五
二十二乘八	零点四乘零点八
一百二十乘二十	一百二十乘六
十六除零点六四	零点六四除四
一百乘一千等多少	三除三等几
一百四十乘二十	一百四十除二十
十减一	十减十
十五除六	零点二五除四
十五乘五等多少	十五乘十五等多少
二十二除四	六点二八乘四
十六加几等二十五	十三加几等二十五
六十四乘九	十二乘五点五
八十加八十等几	八十除二等几
三十三乘九	十五除二十四
二十二乘四	五点六除一点四
二十四乘五十等多多少少	五十乘二十四怎样乘法
二百四十六点四除十三	三十六乘八
七百六十除八的竖式怎么写	七百六十除七的竖式怎么写
九十一除三	九十五乘三
六十八乘二	六十八除二
三十六乘二	三十六乘五
三百八十乘二	四百五十乘二
六百四十除十六等	六百四十除一百六十等
四除十五加一除十五	九除十五加一除十五
十一乘十八的竖式怎么写	十一乘七十的竖式怎么写
九十除八竖式	九十除五竖式
一百八十乘二十	四点三乘一点一
十二除一点五	十二除二点五
血压一百四十六除七十二正常吗	血压一百四十五除七十二正常吗
三分之一加二分之一	三分之一加三分之一
五百四十除八等多少	八除八等多少
八十四除二	十三乘六
九十三除五等几余几	九除五等几余几
五十七乘七	五十七除三
一加一等五什么意思	一加一等四什么意思
十八乘二十七	十一乘二十七
三点一四乘一百	八点八四除一点七
二百一十六除九等多少	六十八乘八
三万乘三万等多少	三乘三等多少
七点二除零点零八	五点六除零点零八
六十七乘六	十二点五乘零点八
七加三	七加八
二十八乘四十	五十乘四
一百二十五乘二十四	六十四减三十八
三点四乘零点五	四乘零点五
一点六除零点二五	一百减五十等多少
五除三分之四	四除三分之四
五除三百等多少	二百除三百等多少
八百二十四乘五等多少	五加五等几
五十二除三	五十二除十三
一除十一	八除十一
十二乘十三	十二乘十四
十五除七化成小数是多少	十五除七化成小数是加多少
一百五十乘三十	一百六十五除五
三百除四十	一百除四十
四十点五除零点五	四点五除零点五
一百二十除四	六点八乘四
二十四乘五分之二	十四乘五分之二
五十除二点二	五十除二点五
三百二十除八十	三乘九等多少
六百八十五除五等多少	八除五等多少
十乘零点零零一	十乘二十五
五十九乘六	六乘六乘六
八十三乘五十五	八十三乘八
六乘五	四除二
六十乘九	六十除九
二十四除六十	六百四十八除二十四
六十四除四	六加八加三加五
四十一乘二	五点零一减一点九
五加五等几	五加几等五
一点五乘三	一点五乘五
二十三乘三等多少	三十乘十二
二十三除四等几	四乘二十三怎算的
二十五乘二十五	四十五加十五
四除五乘五除四	五除五乘五除五
四十二除十四等多少	十四除三等多少
二百八十除十二等多少	二百八十除七等多少
一百二十八乘三	一百二十八乘二
一百二十除十五	一百二十除十八
六乘二等多少	零点三五除五
五除八	八点五除五
一百减五十怎么算	一百减五十等几百
四十二乘三十	四十二乘十五
六除三	三除六
三点二乘五	五点一除一点七
一百六十除四等多少	七减八等几
六分之一加三分之一等几分之几	六分之一加七分之一等几分之几
四乘三点一四	四乘四乘三点一四
七十五除二十	一千加一万
四除零点八	零点四除八
十加十六等几	十加六等几
杭州林内售后电话四百减一百一十八减一千零八十一	重庆林内售后电话四百减一百一十八减一千零八十一
七十乘五	七十乘五十
一百八十乘三	一百八十乘十
二十乘一点五	二十乘五
二百七十除十五等多少	七点二乘零点四
二除零点五	零点二除五
十八除四点五	十四除三点五
二十七乘五	八点一除九
一百二十七乘十二	十五乘十二
四千加四千等多少	一千加四千加四千等多少
七乘十七	八乘一点五
五十一乘八十七	五十一乘三十一
七十除八等多少	七除八等多少
三百二十乘五	三百二十乘四
一百除四	六百乘八
八十五乘八	一点八乘五
十五乘十五	十五乘四百
十五乘十六等多少	十六乘三等多少
一百八十乘六十	零点九除零点三
二百除六	五点六除零点零八
小布三加三	小布三加五
四点八乘零点三十五的竖式	四点八乘一点两的竖式
九千九百九十九乘九十九等多少	八乘九十九等多少
一百零四除二十六等多少	八除二十六等多少
三千加三千等多少	六点三除零点零九
二百五十乘三十	十除六十
五千乘五千等多少	八乘八等多少
四十五减三十五	三十五减四十五
一百一十三点零四除二	三点二除零点零四
七除三分之一	七除九分之一
三点四乘两点五	三点四乘三点四
三十八点六乘一百	八百乘一百
七加两中六加一多少钱	九加两中六加一多少钱
两百乘四	十八乘八
一百零八乘十二	一百零八除十二
三十三乘三	三十三乘二
八百四十除二	三十加三十
三百乘九	三百除九
四十五除五等几	六点五减五点六
二十四除十六	三百二十八除十六
六十四除三十二	六十四除三
六十八除八	六十八除十七
一百一十四除二	五点九八除零点二三
一点七乘三	一点七乘四
四十二除十	七十六除十
十除零点二五	十除零点五
五乘一等多少	十五除五等几
三除八	十乘九
五加一	五加九
二百一十六除六	三点一四乘十一
八十乘七十	五十乘七十
一百八十乘三	一百八十乘四
二十五乘八	十四乘十五
血压一百零五减七十五	血压一百三十减七十五
五加五加五加五等几	十二加八
四百八十除九十六	四百八十除四
一百二十除十六	二点一六除零点二七
十加二十等多少	十加十等多少
十六加十六等几	十六除二等几
二十二乘二	九十六除七
五除十二乘六十	五除十二乘四
一千加两百等几	一点零四除二
三乘十二	八点一除九
成都伊莱克斯空调售后网点四百减一百一十六减六千二百一十九	成都美的空调售后网点四百减一百一十六减六千二百一十九
四十八乘三十的竖式计算	四十八乘四十九的竖式计算
一千乘一千等几	一千除百除一千等几
四十五减三十	三十减三十
二百乘零点零一	二百乘一百四十
六十八除三列竖式	十除三列竖式
九十九乘四十九加九十九简便运算	四十九乘九十九加九十九简便运算
七点八除二点六	六百除四
九乘四等多少	九十乘四等多少
一百三十乘四	零乘零
二十八乘一百	八十乘一百
二十五乘九	三十除五
三点二除二点五	二除零点二五
四百八十除八	那二加二呢
三点八乘十六	一百六十乘十六
八乘二等多少	十二除二十
十五乘三点一四	十五乘十五乘三点一四
二百七十除五	十七乘三十
一百八十加一百八十减三十五怎么减	一百八十减三十五减三十五加三十五等些许
卵泡二十四乘二十三	卵泡二十四乘十九
十四乘二十八	十四乘十二
二十三乘二十三	二十三乘六十
八百除八	八百除八十
三点六四除二点六	六点六四除三点三
七十八点六除十一	六除十一
六十六点六除一点八	一点六除八
三十五除四十	三十五除二十五
六十三乘二十五列竖式怎么列	十四乘二十五列竖式怎么列
一百四十乘五十	七十乘一百四十
二十五乘六	二十五乘八
一点二五除二点五	二点二九除一点一
五点两乘十六	五点两乘十二
一百五十乘八	一百五十乘十二
四十八乘二十	五百除一百二十五
四十七除七	四十七除四
肾衰竭一千零二肾衰竭减百度	口角炎一千零二口角炎减百度
二十六点三七除三十一	三十一除二
七十九乘二	十二乘一百
十二乘三十六等多少	十二乘零等多少
三十四乘五十八列竖式计算	三十四乘三十五竖式计算
一点二五乘零点八	零点二五乘八
七减五分之三	一减五分之三
八乘二十	四乘二点五等多少
三十乘一百八十	零点四八除四
二十八乘二	二十八除二
一点二除零点五	零点二除零点五
二十七除四	二十七除四点五
一点二乘四	四乘二
三百除六十等多少	十除九
七除三等多少	六点三除七等多少
一点五乘三点一四	十加八等几
二十乘三十等多少	二十乘三等多少
三点一四乘五乘五	三点五乘三点五等多少
碧蓝航线五减四有什么船	碧蓝航线四减四有什么船
一百零一乘十一等多少	七乘十一等多少
六十四除三	一百加二十等几
九百除一百八十	四除四
三十六除二点五	七点五除零点一五
三百除四十等多少	八十除四十等多少
两百乘两百	十六乘二等多少
二十一乘六十约	二十一乘十八约
八百四十除六	五乘四等几
一百加二十等几	二除九
四百九十五除六等多少	六除六等多少
四十二乘十九约等多少	四十二乘三约等多少
六百四十乘二	六百四十除二
英文数字一减十二	英文数字一减五
十七加十九等几	十七加九等几
七十五除十五	十四加七等多少
一百三十二除六	一百三十二除十二
一百八十减三十五等多少	二十除八
三十二乘二等多少	四十加四十
五十六除三等多少	八十加六十四
四十二乘十九约	四十二乘四十二约
零点二七除九	零点二七除零点零三
六乘四十五	六乘三十
七十二乘九	七百五十除二
八减六	六减六
二十八乘一百	二十八乘十五
五乘一点五	十三点五乘一点五百七十五
二点一减二点零九	五百除三
五加七等多少	八十加八等几
九十除六等多少	八乘二点五
一百三十乘十等	五乘十等
三十二加二十等多少	九加二十等多少
三十乘六	四除十
三十一乘二等略为	三十一除二怎写
一百加两百等多少	百加一百等多少
一百零五除三	一乘零等多少
十五乘九等多少	十五乘十五等多少
二百一十六除二十四	二百一十六除二
三点一四乘一百九十六	二百乘二百等多少
十五乘十五	十五乘四十
四乘四乘三点十四乘一点两	三点十四乘四乘四乘一点两
一除零点七	八乘三点一四等多少
十五乘二	十除十二
二百五十乘三十	三百二十乘三十
三点一四乘零点七	零点一四乘零点三
三乘九	九乘九
零点二十五除一千	零点二十五乘一千
二百四十除六十等多少	六十除六等多少
两点三乘九	两点三乘一点五
五分之四除十	五分之四除十二
三十九乘二	三十九除二
二十四乘九	三十二除零点八
一百六十乘五十	一百六十乘八十
九点一二除三点八	十二加十二
十七乘四等多少	零点四二除七
二十八除四	一百点四八除三点一四
一百三十五除五	六十二乘三
一百六十除二	二十五乘六等多少
零点二十六乘零点五	一乘零点五
五十加六十	六十加六十
二十五加二十五	五十六乘十五
八分之五减八分之一	八分之五减三分之一
一百五十乘五十	三十二减八
九百除一点五	九百除五百
七十七除四等多少	七除四等多少
五十除四十	四十除五十
二十六乘十四	二十六乘十九
六百四十八乘六	十乘六
两百除五	两百除四
三千六百除二十五乘四	一除二十五乘四
七十二乘一千	七十二乘六十
一百除十八等多少	三加三等
七十除三十五等	五除三十五等
十三减三等十	二加七
二十四乘二十四	二十四乘十二
二十四除六十	六十减二十四
二十四乘二	二十七乘三十
六百一十九除五	六百一十九除三
二百六十乘三十等多少	八百除二
四十五乘九	四十五乘二
一百三十乘十等	十五乘十等
一百乘二百	二百加二百
一万乘一万等几	三点一四乘二十四
二十一乘三	二十一乘四
零点二五乘八	零点二五乘四
一百二十五除四十八的简便计算	四十八除一百二十五的简便计算
三乘六	三点一四乘六
三十六乘二等多少	四十五加四十五
三十乘二十四	五十乘二十四
一百四十乘七	一百四十乘二十
零点七乘零点五	零点五乘零点五
一点二乘五等多少	二乘五等
六百四十二除八≈	六百三十七除八≈
二十六除零点一三	零点一三除零点一七
三百六十乘二十五	四十七乘四
怎么把图片变成八十乘八十	怎么把图片变成二百乘二百
十乘八	十乘十
二十四乘六十二	二十四乘十
三十二乘三十二乘三十二怎算	十二乘三十二等多少
四点五乘三百零二	四点五乘一百
三点四乘两点五	三点四乘四
一点八乘零点六	三点一四乘一点二
两分之五减两分之一	两分之一减两分之一
一乘二	四加八
四百五十乘三十怎样算	四百五十除三十怎么算
十五乘六等	十五乘十五等
二百五十乘四十等多少	八乘八等多少
十二乘七怎算	十二乘十七等几
一百二十除二十四	十三乘六等多少
二十二除六	一点八除一点五
七十二除十二等多少	十七乘二
一百二十五加五十乘八简便计算	一百二十五加二十五乘八简便计算
六十三除二	二十乘十四
一百二十三乘三十二	四十乘三十二
二十三除二十四	二十三除二十五
四加二十八等几	四加一百等几
四十五减三十	十减三十
三百六十除九等几	一亿乘一等几
四十八乘二十五	九点六除四
十六减四等几	零除零等多少
二十一乘三	二十一乘四
七十除十四	十六乘一点五
八十八除四等几	一百减五十五等多少
十七减九	十七减八
九点五除五	十四乘七
十五减十八	十八减十五
一百除二等多少	一百除十五等多少
一除零点二	一除零点零二
三除七等多少	一百除七等多少
八乘四	十七乘二
一点五乘一点五乘一点五乘一点一	二乘一点五乘三点五等多少
一百加二百	二百加二百
二十五乘二十五	二十五乘四十
一点零四除二	三十乘五等多少
六十三除七等几	四点五除零点零九
二十一乘二十四的竖式计算	二十一乘二十五的竖式计算
三百乘四十	四点八除零点一六
一点八除十二	一除十二
三十二乘四	三十二除四
一除零等多少	一除十一等多少
八十乘八十	八十乘四十
二十五乘九除二十	四十乘九除二十
五十八除两x十六的竖式	五十八除六的竖式
三十八乘六	三十八乘四
六百二十五除一百二十五	十三乘八等多少
一百七十乘二十	十六除零点六四
四除七等多少小数	一除七等多少小数
十六除十	十八除十
一百一十五除四等多少	一百一十五除十二等多少
血压一百四十六除七十二正常吗	血压九十除七十二正常吗
二千四百除五	十二除十三
十二点二十五除六点二	十五点六除十二点四等多少
二十二乘四十等	二十二乘三等
十二乘十二等多少	零点二七除零点三
九十一点二除三点八	一百乘六
五乘四等多少	四乘四乘四等多少
一加八pro有nfc吗	一加七有nfc吗
三百乘五	四百乘五
四十五乘八	三十除二点四
二十四乘二十四	四乘二十四
十二除四等多少	零点二乘零点二
二千八百除十二	十二除十二
零点十五加零点六等多少	零点九加零点六等多少
八十四乘三	九点六除一点五
三十一点四除三点一四	一点八乘二
血压一百二十八除八十正常吗	血压九十除八十正常吗
一点六乘四	四除十
三十六除四等多少	十六加十六等几
五百五十除六的竖式	五除六的竖式
四十五乘四十五	五十五乘五十五
八乘零点二十五等多少	八乘七十六等多少
八十四除七等多少	零除一等几
两千除五	五点五除五
二百除五等多少	四十除二点四
一百零五乘八	六百除三
十五乘二等多少	十五乘十五等多少
四百二十除六等多少	九乘九等几
七百八十除三十	十二加十二等几
五十点二四除四	零点二四除零点四
十五乘三点一四	十八乘三点一四
八除零点四	零点四除零点八
一百二十六除三	一百二十六除六
一乘七等几	五十乘三点一四
四十二乘三十	一百加一
十四乘九	十四乘十四
一百乘一万等多少	三乘二等几
四十五除十五	十五除四十五
三十六乘三十八	三十三乘三十八
二十五乘二十等多少	二十五乘五等多少
十七乘四	十七除四
六十一减十五	十八减十五
七十二乘一千	八百乘一千
九除四等几分之几	九除十八等几分之几
四百五十五除五	三点一四乘十八
四十五除七的竖式	十三除七的竖式
十二乘八十是稍微	十八乘十八等多少
二十一乘四	七百除十四
四乘二十三	四十乘十五等多少
十一个一乘十一个一等多少	十一乘十一等多少
四百八十乘二十	四百八十除二十
二百四十除三	四十七乘三
十五乘零点六	零点六乘零点六
十乘二十五	二十除十五
二百五十乘八	八点四除零点二
五十乘三	五十乘五十
三点0七十二除六点四	三点六除四
一乘零等多少	小布零乘零等多少
十加十六等几	十加一千等几
三点五乘零点四	五十除六
二十五点五除二点五	嘿小布零除零等多少
七加二等几	三点二减零点八
十乘十	十二乘十
三十一除一百一十九	三十一除三十五
二十一乘二十一	二十八乘二十一
二加九分之五	九加九分之五
五百二十六除七等多少	四除七等多少
一点八除六	八除一点六
二十五x四加八的简便计算	二十五x八加四的简便计算
六十二乘三	六十二除四
三十加三十	四十加四十
五十七除三	五十七除十九
六十四除二	六十四除四
五十四除九等几	请问零除零等多少
十五乘多少等十	十五乘多少等五
三十四除六	零点四乘八
一百八十除四十五	四百零五除四十五
二百七十除三等多少	四百乘三
八点五乘一千等多少	八点五乘六等多少
零点六乘一点三	零点六乘三
十一除七	零点四除五
一百七十乘五	十六除二等多少
三千五百八十八除四	六十四乘九
一百二十乘五十	二百四十乘五十
三百三十六除三	十三减五分之三
八分之七乘四等多少	五乘四等多少
二十点八除四	四乘十八等多少
二百四十乘二等多少	六十四乘二等多少
十五除二十最简分数	五除二十最简分数
二十一乘四	四百五十五除三点五
四百五十乘二	四百五十除二
四十五除十五	零除二
四百七十除五	五除六等几
零点六乘零点三	零点六乘零点六
两点三乘九	十六乘九
四十五乘九	九十乘十二
r十一乘七	r十一乘九
四十二乘三等多少	三点一四乘三十
三十六乘十一	十二乘十一
七十乘一百四十	七十除一百四十
二百五十乘八	四除三十七
九除九百六十三的商是多少	九除九的商是多少
六十四乘九	六十四乘六
三十九除二	三十九除四
三十七除二十	三十七除一百
十七加十九	十七加十二
十三乘十五乘十五	十三乘十五等多少
一千六百乘三	一千六百乘一千六百
三百五十除一千等多少	三百五十除二十五等多少
七十八减十八	十减十八
九除四等几分之几	九除十二等几分之几
四十除八等	三除八等
五十三乘十七	十六乘十七
三十二乘三等几	三乘几等十八
一百零八除六	二十乘四等多少
五十六乘二十一的竖式怎么列	二十二乘二十一的竖式怎么列
七点零九除零点五二等多少	十三乘八等几
六百除三竖式	六百除七竖式
四百乘三	四除二点五
一百一十三点零四除二	一点零四除二
一百八十除九	二点五除二
三乘十三	十二点四除二
一百五十除五十	六除二点四
零点五四除六	零点五四除零点六
一百二十除四等几	三点二加零点一二
九十六减七等几	五减七等几
五乘十三	十三乘十三
体彩大乐透九加四多少钱一注	体彩大乐透九加五多少钱一注
四十二乘九十九加四十二简便计算	一百乘九十九加一百简便计算
三点四除十七	十七除四
一百一十加一百一十等几	六除三
十七乘三十八的竖式	十七乘十三的竖式
四十五乘十五	四十点六除十四
二十七乘九	二十七除九如何算
三点四乘五等多少	三点一五乘五点一二加三点二四等多少
二十乘五等多少	零点八乘零点七
七十二乘一百零一减七十二用简便方法计算	六十二乘一百零一减六十二用简便方法计算
三乘几等十八	十八除三等几
三百二十五除十三等多少	三百二十五除五等多少
二十四除零点八	五百乘十
十一除一点五	十二除一点五
血压一百三十除一百正常吗	血压一百二十除一百正常吗
四百除五	四百除八
五十四除六等多少	九加五等多少
四点三十九乘十	十五乘十
七除五十六	七除一
十五乘四百	四百加四百
八除九加一除九	一除九加一除九
二十一乘三十四	二十一乘十
r十一除二	九点六除三
二十五除二十五	二十五除五
二十五乘二	六百除四
三点五乘零点二	九乘四等多少
八减八等几	十四减八等几
一百五十除二十	十八乘十六
五千乘五千等多少	六乘六等多少
三十六乘三十六乘三十六等几	三十六乘十二的简便方
三点八乘十六	三点八乘六
八百六十除八竖式计算	一除八竖式计算
一点七五除二	零点七五除二点五
一加八的尺寸	一加五的尺寸
三十二乘零点二十五乘一点二十五简便运算	零点二十五乘三十二乘一点二十五简便运算
一百八十八除二	二百四十八除二
三十八乘五十怎么列竖式	三十八乘四十怎么列竖式
二百五十一点二除三点一四	一点二乘五
四点零点一四除一些二二	零点一二除零点四等多少
二十乘五十	十一乘三十
二十四乘二十	十九乘五十
六乘五	六点五乘五
三分之一加二分之一	三分之一加五分之一
十二除x等四十八解方程	四十八除x等十二解方程
六十三乘八	一点五除九点九
七十五除三	一点五乘六
二十五乘四十	四百零八乘二十五
三百二十六乘八等几	三百二十六乘三百二十等几
二百三十六除八等多少	二百三十六除四十等多少
六十四除八	二十乘四
十二乘十二等多少	十二乘四等多少
二十乘八十	四乘八十
一除两除三减两除三除	一除一除三减一除三除
三十一除一百一十九	三十一除三
三除七等多少	三除三十等多少
二十除四十	四十除二十
r十一乘五	r十一乘四十
十三乘三	十三除三
一百八十乘四十	一百八十乘一百六十
八十三减十九	十九减八十三
五十五乘二	十八乘五
五乘三点八	四除三
四除零点二五	零点二五除四
三十六乘一点一四	三点四乘三十六等多少
二十八乘十五等	二十八乘九等
四十五乘五	三除零点四
二十四乘四	十四乘三
七十八乘六等	七十八乘多少等六
十七乘十七	十五乘十七
三十八乘六	三十八乘四
四点七十五乘九十九加四点七十五的简便运算怎么写	九十九乘九十九加九十九的简便运算怎么写
一百五十乘五十等多少	二百零八除二
八乘三点一四等	十二乘十二
四十五乘八	四十五乘六
三十六乘四等多少	四乘八等
三百六十除六等几	零除零等多少呀
二百四十倍二百四十乘十五	二百四十乘五等多少
三点八除一百等多少	五十除一百等多少
三十乘十四	十二乘三十二
三百六十除五	一乘五等多少
三点六除零点零九	五乘一点五
三点五乘二点四	二点五乘四
一百二十五乘七	八乘一百二十五
六十五乘三	一点五乘六十
一百二十五乘八	一百二十五乘六
五除零点三六	零点三六除零点九
二十四乘二	二十四除二
九十除六十	二乘十四
一减根号三的平方	一减根号二的平方
二十三乘三	二十三除三点三
六点二八乘三	六点二八乘二十
三点五乘五点四	三点五乘三点五
二十二除二	五十乘十二
五百五十除六的竖式	八除六的竖式
三乘十五等多少	十五乘十五等多少
八乘五	八乘八
五点二除十三	十三除五
一百四十乘五十	一百四十乘六
十五除八	四加四呢
禁忌五除美国禁忌五	禁忌六除美国禁忌六
二十五乘五	二乘六等几
二百五十乘十五	七乘九等几
一百二十乘九	三点二除四
三点一四乘九等几	九乘三点四加九乘四点三
六十除六等多少	六除一
三分之二除七分之四	七分之四除三分之二
十四乘五十	零点七百五十六除零点一八
七十乘一百四十等小	七十除一百四十怎算
五除十二乘九	一除十二乘九
一百零二点五除零点五	十四乘三等多少
三分之一加五分之两	四分之一加五分之两
三百六十除九等多少	四减三等几
五十除六除二十	五十除六等多少
六除五	六除七
八十八乘一百二十五	五百乘六
二百九十乘四	三十六加九
四十四乘五十六的竖式	四十四乘三十四的竖式
一百六十除四十八等多少	一百六十除四等多少
二乘五等几	十二乘三十二
九百减七百三十五等几	一减七百三十五等几
五加几等十三怎么	七加几等十三怎么
小布一百乘一百	小布一百加一百
一百二十五乘八十	三十除二十四
五十四除三等多少	零点四乘五
七除三分之一	七除十三
二百四十乘十五等多少	六万乘六万等多少
二十六乘十二乘略略	十二乘二十六等几
八十三乘五十五	八十三乘零
九十二除三	九十二除四
十五除三十二等多少	三除三十二等多少
四十六乘二十三	四十六乘十二
四十五除二	七除三等多少
四十五加十九	四十五加十三
六十四除七	十四乘五十等多少
六十乘九	四百加四百等几
一百二十乘六十等	一百二十乘三十等
二十四除十八	十八除二十四
七十二乘一千	七十二乘一百零二
三点一四乘二十五等多少	四千加四千等几
三百六十五乘零点六	三百六十五乘四
十五乘三	十五乘四
零点四八除六	零点四八除四
一百零四除二十六	一百零四除六十
五十五乘十二	五加一等多少
八百四十除六十	九百六十除六十
七十六减六十七	七十六减九十九
四百四十八除四	二点四除零点零四
四十五乘九	四十五乘二十
二十四除十五	十五除二十四
六除十化成小数	五除十化成小数
二十三乘三等几	四百除七十五
一千减八等多少	五减八等多少
八加八加八加八等几	八加八等多少
七十六除二	八点四除零点四
零点四五乘零点四五	零点四五除零点九
二十二乘三	四加七等多少
九点零七减六点七等多少	八十乘一百二十
一百五十除十	十一乘五十
二百一十乘三十	二百一十乘五
八百四十五除六十五	八百四十五除十三
五十乘十二	十二乘十二
二点五乘二点五乘三点一四	二点五乘二点五乘三点五
二乘四等几	四乘二等几乘几
一加六怎么换电池	一加三怎么换电池
一百二十八加一百二十八等几	十加十等几
七十除十五	八点四除零点二
十四乘五等多少	十四乘十四等多少
十四乘十四等多少	三乘三等多少
一千除一百	一百乘一千
四百五十乘三十	四百五十除三十
十五乘二十	十六乘二十
二乘零点五	四点二乘零点五
三点一四乘一百四十四等多少	八加八等
三十二乘十二的验算怎么写	二十四乘十二的验算怎么写
一点二乘八	一点八乘二
一百三十八除六	一百四十四除六
一百八十除九等多少	三十三乘三
五除零点三六	零点三六除九
五十一乘五十	五十一乘三十一
二点八乘二	六点二八乘一点二
四十除四的竖式计算	八除四的竖式计算
血压一百三十除一百正常吗	血压九十除一百正常吗
六百三十除七十	七十除十四
八十二乘三十二	八十二乘五
十三除七等多少	九加八
六十二除五	六十二除三
五加五加五加五等几	五加五等几啊
八十七乘三	八十七除三
一百零二乘十九简便计算	二十五乘十九简便计算
零点五乘零点五	零点八乘零点五
二十六除三	九千九百九十九减八千八百八十八
零点二七除三	零点二七除零点三
三除四	四除三
二十乘一点五	五乘一点五
三点二乘一点五	十三乘二等几
十九乘三百	十五乘四百
一百二十乘三	六十乘一百二十
r十一乘九	r十一乘五
一百二十五乘八十八	八十八乘八
一除二	二除一
八十七乘四十三	八十七乘八十
三十六乘十一	十五乘十一
六十乘一百二十cm是什么意思	八十乘一百二十cm是什么意思
八加七等几	四十乘七十五
二十一乘二十四的竖式计算	三十乘二十四的竖式计算
三十二除零点八	一点七乘零点五
二十七乘九	二十七除九
二十五乘四十四的简便方法	二十五乘六十五的简便方法
一百五十七除二	一千除一百五十七
七除零点五	三点五除零点七
八十八除六的竖式怎么列	八十八除五的竖式怎么列
五十六乘三	四天加四天
三十乘四	二十加二十等多少
五十乘六等多少	五十乘一百等多少
三点一四乘四乘四	四乘三
二百七十除九十	一点二乘五
二百五十乘二	二百五十乘六十
五十乘四十当	五十除四十怎算
十一点四除三	十二点四除四
一亿乘一亿	一亿加一亿
一百乘五	六十除二十五
三百零六除三	一百除三
三百九十除五	六十乘十八
二十五乘三十二加四	二十五乘五加四
十九乘三	十九乘十九
七十五除一百	小布三加一
一点二乘一点二	五十乘五
一加七是什么字	一加八是什么字
七十二除四	四乘十三
大乐透十二加五复式多少钱	大乐透十二加六多少钱
一百三十二加六十八等多少	十八加六十八等多少
一百零五除三	一百零五除五
一除八的通分	六除八的通分
六十一减十五等多少	六减十五等多少
六乘七等多少	零点零二乘零点五
一百一十一除零点三等多少	一万六千加一万六千
七十七除四等多少	八除四等多少
三百加五百等多少	四十乘三
九时三六除零点三六除九	零点三六除零点九等小
三十九乘四十一	四十三乘四十一
三点二除零点零四	六乘八等多少
十二加二等几	十二加十二等几
三十七乘四	七十七除七
一百零五除二	一百零五除五
零点七五乘四	零点七五乘零点四
六除六是什么星座	三除三是什么星座
一百四十四除三点六	五零除零等多少
十除六十等几分之几	十除二十等几分之几
四十三除二	五减七分之三等多少
六十四加十九	十四加六十四
一百四十四除八	一百四十四除十八
四十五点八除十等多少	十二除十等多少
九点九除三点三	二加十等几
四除五是什么拍子	八除五是什么拍子
九除四点五	四点五除九
四十六乘十三	三十四乘十三
十八除三写作	六除三写作
一除七	十四除十六
四十五乘三	四十五乘二十
五乘十二加五乘多少等多少	十二乘五等多少
三点一四乘十六对	十六点一四乘十六
七十六乘五十四	七十六乘八十
一百一十九除三	四十二除二等多少
三分之一加二分之一	三分之一加二分之五
二乘几等六	二乘几等三十
四百五十除九等多少	五十一乘八
零点九除零点九除零十二	七点九除零点二等多少怎么计算
二点五乘零点四等多少	六乘三十
四十五除五	八除五
三除六怎么约分	八除六怎么约分
一百五十乘三十等多少	五十四乘七
二十五点二除六	十加二十等多少
零点一百七十五除零点二十五庸算	两点一百七十五除零点二五等几
二千八百除十二	三点六除四
三百一十二除十三等多少	三百一十二除六等多少
十六乘十七	十六加十七
四十五加十九等几	四十五加八等几
三十八乘五	两千加两千等多少
三十四乘三	十五乘八
二百乘四	五乘一点二
一百乘八十	零点二五乘四十
四十七乘七十九	四十七乘八
二十七除四	八十一除二十七
三除十	十点五除三
一百六十除三十	七百四十五减六百七十九
十二点二除零点八	三十六减九
八除四	四点八除四
r十一乘三等几	三十乘五
孕三十九加四分泌物增多	孕四十加四分泌物增多
血压一百三十除一百正常吗	血压一百三十一除一百正常吗
八分之三乘三分之一	八分之三乘八分之一
二十三乘五十	二十三乘十
三点九除十三	十三除三
肾衰竭一千零二肾衰竭减百度	败血症一千零二败血症减百度
一百九十二除二十四	十八乘十二
五除四十五等多少	五除七等多少
二十一乘四十四用竖式计算	二十一乘十五用竖式计算
六十除三十当	六十除三十除三十相等多少
三点一四乘四十四	十八除五十
六十一减十五	十五减十五
七百二十除五	三点一四乘二点五
三点二除二点五	三除零点二五
四十二乘七	三除五
十加十六	十加二十四
五百五十除六的竖式	一除六的竖式
二百零四乘三十	七十五乘六
二十九乘九	一亿乘一
一百四十四除二十四	一除一点二五
五十乘二	五十乘五十
二十四乘十	三加一等多少
一百八十加一百八十加一百八十是稍微	一百八十加一百八十等几
二十五乘八十	二十五乘十六
七点五乘四	四点五乘五
四乘二百八十等多少	四乘二十等多少
三点六除四	十八加五
一点五乘四	六百除十
一百零八乘二十五	四十七除四
八除十五加一除六等几分之几	八除十二加一除六等几分之几
四十四加四十四加四十四加四十五加四十四的简便算法	四十四加四十四等多少
五百三十六除四的竖式	五百三十四除四的竖式
一乘四等几	三十乘二十五
六百五十除五十	三点一四乘八乘八
六百除二十	六百除四
cad填充三百乘六百地砖	cad填充三百乘三百地砖
六除十八	十八除六
七十八乘九	六点五除一点三
两点一除三等多少	两点一除一点两等多少
二点七乘四	二点五乘四
三十乘八十等多少	三十八乘十八乘三十
二十五除一百	十二除四等几
二十四乘二十四等多少	二十五除三
五十七点六除十八	一点六除零点零四
十三乘十三等多少	十三乘四等多少
二十八乘一百	二十八乘零点一
十八乘二	十八乘十八
把三又七除八化成假分数	把七又七除八化成假分数
三十五除五读作	三除五读作
二点五乘二点五	二点五乘五
四十九乘三点三四	三点四乘四十九的竖式是啊
一千除一百五十七	九十乘五
四减二十毫安是什么意思	四减三是什么意思
一点二乘三点一四	二分之一乘三点一四
八十四除四列竖式计算	八百四十四除四列竖式计算
三减八什么意思	八减三什么意思
三点六除零点九	六点三除零点九
九百零七除四的竖式	十除四的竖式
一百四十四减六十四等多少	三十乘二等多少
二十九乘七	三十二除四十二
零点二五乘三	零点二五乘十二
二十五乘三十等多少	五百四十除十二
四百二十除六等多少	十减四等几
二十四乘七	三百五十乘六
二百零一乘八约	二百零一乘四约
六十乘二十五	零点七五除五
九十六除三	九十六除四
六十六乘三	六十六除三
一百五十除二十五	四百五十除二十五
七乘五表示什么	零乘五表示什么
一点二乘四点五	四除六等多少
五十一乘五十	四十一乘五十
七十八除二	二点五乘六
零加九等多少	十六加九等多少
五十五乘十等多少	九乘十等多少
一点二除零点三	十五乘十六
二百八十八除三	二百八十八除十二
三百乘九	三百加三百
二百九十四除十四	二百九十四除二十八
二十四乘二十四	五百零六乘二十四
三减减六	零减减六
十二点五乘六	零除一百等几
三除十的通分	四除十的通分
七除五十六	七除二十
三乘十八等多少	十八乘十八等多少
五除八化成百分数	一除八化成百分数
八分之五减八分之一	八分之五减八分之三
四十七乘五	四百八十除三
一点零八乘零点八	四十除二十四
六十四乘八	六十四乘四
九百一十除十四	十四除七
二百零四乘三十	二百零四乘五
八百一十七除九约等多少	十一除九约等多少
八加三专项整治是什么	一加三专项整治是什么
五乘零点八	零点七八除六
四十五减三十等多少	一百二十减三十等多少
五十一点三除零点二七	零点二七除三
三十九乘四十一	三十九乘十九
七百二十除五十的竖式和验算	七百二十除七十的竖式和验算
二十乘四十的竖式计算	二十乘四的竖式计算
二百五十乘四等几	二乘八等几
二百五十乘五	三百二十除八
一除二点五	二点一除二
六十乘三	六十乘十五
三十六乘八	四十九除四
九十减四十八	五十减四十八
十二乘十二列竖式怎么列	十二乘三十竖式怎么列
九乘六等几乘六	六乘九等多少
四十七乘十五当几	四十七除五等多少
四百除二十五	四百除六
五十五乘十等多少	六乘十等多少
三百六十除十五	一百除五等几
二十七乘二十七	二十七乘十五
一点四除七	一点四除零点七
二十五乘三百九十九的简便算法	二十五乘六的简便算法
三百除六十	四乘零点二五
五十四除六	六十八乘二
五十八乘二	五十八乘四
三乘几等十二	十二乘三等几
五十除十	六除十
零点一乘零点七	一百乘零点七
二百二十四乘三十	二点五乘二点五等多少
六十八乘六除三	四乘六除三
九十除三十	九十除十八
三乘七等几	八点七除三
四十五乘四十五	十二乘四十五
九十六除六等多少	四点八乘三点五
八十除二十	四点六除二点三
二十九加七	十一加七
四十九乘二	五除十一
四十八乘七	十乘四十
三点十四乘零点零六百二十五	三点十四乘六
三十二乘十五乘多少	十五乘三十二等几
一百九十六除七	六除零点二
三十八乘九	一乘三等几
r十一乘九	九乘九乘九
六十四乘四十五竖式	六十四乘八十竖式
五十八乘六	七十五除四
二百一十乘四十	二百三十乘四十
三十二除五十	三十二除十
四点一乘一百	四点一乘四点一
十加二十等多少	十加五等多少
五除二十四	二十四除五
九除四等几分之几	九除六等几分之几
一百八十乘三	八除二等几
四百八十加三十等多少	六十加三十等多少
一点二六除二十八	四百除五等
一百二十八除八等多少	一千二百五十除五十等多少
五百零六乘二十四等多少	二十乘二
十一乘十八的竖式怎么写	十一乘十一的竖式怎么写
十五乘三等多少	十五乘十五等多少
二十一乘二十一	二十一乘十八
一百零二除十二	一百零二除四
四点五乘三百零二等多少	四点五乘五十等多少
二百八十除十二	二百六十除十二
二十四乘六十	四天加四天
十六除十	十六除二十四
一百除五	十九加十四
五除五	五除六
一点八除三	四乘三等几
二十五乘二十五的竖式是什么	十三乘十三的竖式是什么
三百五十除五等几	九点六除零点四
血压九十除五十正常吗	血压一百三十除五十正常吗
三十二乘三	三十二乘八
二百一十除十等多少	七除十等多少
十一乘四十	四十乘四十
五十一除三等多少	四点五除零点三
一百九十八除二	二十四点六四除十三
二十五乘六十四	八十五乘六十四
七十九乘三	十乘三
六十八乘八	零点三四乘五
二点五乘三点一四	十除零点二
七十一减十七	七十一减六十五
两点五乘十的负二次方	一乘十的负二次方
大乐透十二加五复式多少钱	大乐透十加五复式多少钱
三除一	五百除三十
四点八乘一点两	二百乘一点两
八十五点五除三点三	七十乘五
四十九点二除四点一	十七除二等多少
六十九乘九十八	四百乘五等多少
十六乘十六等	零除二
三十乘十三	十三乘十三
两万乘三	两万乘一万
二十除三十	二十除十二
七乘十五等多少	零点八除零点五
四乘三点四乘四点四	三点一四乘三点一四怎算
二十六乘八	四点九除七
九减三	九减六
三加四等几	四加三等多少四加四等几
五百四十六除七等多少	二十除七等多少
三点八乘四	零点七二除零点零六
三点一四乘十八	零点九乘零点三
十二减六加五	十二减六加七
十八乘九十等几	十八乘九等几
三加三等七加二	三加七等几
二十三乘五十等多少	二十四乘九
二百五十乘八十	十乘八等多少
五十乘二	十五乘二
一百二十除二十四等多少	一百二十除四等多少
二分之一减三分之一	十五乘五等多少
一百七十除二	三点八四除零点八
三百六十乘二十五	三百六十乘二十
一点二五除五	一点二五除八
二百八十乘七	十五乘五十六
六十二乘六	六乘六乘六
十九乘五等多少	十九乘十九等多少
五十五乘三十八的竖式怎么列	五十五乘二十五的竖式怎么列
五乘十二	十二点五乘四
六点五乘零点四	四乘零点五
六点四除一点六	零点六四除一点六
四十五乘十二抵多少	十二乘四十五加十二
二十二乘四十三的竖式	四十三乘四十三的竖式
六百三十除四十二	零点三二除十六
四十八乘三十	一点二五除八
二十一乘二十四的竖式计算	二十三乘二十四的竖式计算
三十六乘三十	三十六乘四十
一百五十乘六十五等多少	五乘六十五等多少
三百五十除七十	十二除四分之三
六十六乘三	十四乘二十五等多少
二十四除二等多少	五乘六等几
二十四乘二等几	十五除十五
六十二点八除三点一四除二	十四乘十四等多少
一百二十乘二	一百二十除二
一百除十五	十五除一百
八分之三乘三分之一	八分之三乘三分之八
五十乘六	四乘四十五
二十二加三十三	二十二加二十二
六乘七等多少	十二除零点七五
四十九乘七	九百乘六
三点一四乘三十	三点一四乘十二
二十六乘四除三十九	二十六乘两除三十九
九百六十除七	一百除七
一点七乘三等多少	一点七乘零点五等多少
五十加六十	六十加六十
三百二十除五	八十五除十七
一点五除零点零五	三乘七
五十加六十等几	零加零等多少
十七乘三十八的竖式	十七乘二十四的竖式
四除十七等多少	十一除十七等多少
零点四乘五	零点四乘零点五
五十五乘二十七	五十五乘二十二
一百二十乘六十等	六乘六十等
五十一乘八十七	八十乘八十七
二百六十除四	二百六十除五
八除三等几	小布一千加一千等多少
双色球六加一多少钱	双色球三加一多少钱
十四乘十四	十乘十
二点八除零点二	十四乘十四
六除一点五	六除二点五
六十三除多少除九	六十三除九等几
三十六点八乘一千	三百乘一千
八十二乘五	八十二除二
八十五除一百	八十五除二
一百乘二十	五百乘二十
三点一四乘六十四等	八除九等多少
四十五乘七的竖式	四十五除七侔几
一点五除三十	六十乘三
九百五十一除五的竖式怎么列	零除五的竖式怎么列
二十乘八	二十乘六
二百一十除七等多少	一除三
零点八百六十四除零点二七等多少	零点二七除三
八十三乘五十五	八十三乘八十
二里面有几个一除六	三里面有几个一除六
十加十六	十加二十一
五除十二乘九等多少	五除十二乘十六等多少
七百八十乘二十	二十乘二十
六除六是什么星座	七除七是什么星座
一百三十一点二除二	八十八点二除九
一百二十五除二十五	二十四乘十八
六乘四十五等几	四十乘四十五等几
一百二十乘三	三点一四乘一百二十
三百九十除三	四十五乘二十
五百一十除七列竖式计算	五百一十除三竖式计算
九百一十除十四等多少	十四除三等多少
七乘十二	十七乘五
三点五乘一点五	一百五十乘一点五
五十四除三	五十四除四
一点八除六	一点六除八
十一乘十二	十九加十九
六十四乘八	六十四除八
九点七百二十八除三点二	四百乘六
十二乘三十六	十二乘二十四
五乘九等多少	零点六四除四
九十三除四	三点一四乘七的平方
十七乘四相当十七	十七除四等多少
三乘三加二	四点二乘三
一千加百分之十怎么算	一加百分之十怎么算
二十六除五用竖式计算	三十六除五用竖式计算
三十乘三点一四	二十乘二十乘三点一四
一百乘二	十八乘七
一百五十六除四	二十七乘七
四乘十八	四十乘五
二除零点五	零点二除零点五
一除零等多少	一除五十等多少
一点二五乘四	零点四乘一点二五
十二除四	零点四乘零点三
八十五乘二	八十五除二
四点五除零点一五	零点一五除五
二十五乘四十对等几	四乘二十五等多少
三十六乘十一	十一乘十一
三百五十乘二	四百五十乘二
一点六除零点八	四加四呢
三除四	十万乘十万等多少
十九除三	十五除九
八除十一	十二点一除十一
十五乘四	十五乘三
十五乘十三等	十五乘十二等
二百一十除七	二百一十除三
一点二五乘三点二	二点二五乘三点一四
九百九十九加九十九等几	九十九乘九十九等几
一百一十九除三	零点一二除四
六百四十加六百四十等几	七十五乘八
二十二乘二十	八十五除十七
三十乘十二怎算	十二乘三十二怎乘
一百乘五十	十八乘五等多少
八百除五	八百除八十
六点四除三点二	十六乘十六
十九点六百二十五除二	十九除二
四百一十七除三的竖式计算	九除三的竖式计算
三十点一除三十三	零点六除零点三
三十二除十六	十六乘三十二
九十减八等多少	六减八等多少
二百二十五乘三点一四	八十乘十二
二百零六除二	六百零六除六
十二分之七乘三	十二分之七乘十四
四十五除六十	四十五除十五
五百四十除二十	五百四十除五
三点十四乘七点八	三点十四乘五
五十点二十除三点一四	十七乘四
一点五乘零点六	一点六乘零点五
一百除七	五除七
十二除三除些许	十二除三等几
三十二乘三点一四	三点二五除五
十一点二除四	十一除四
一百二十五乘八等多少	九十一除二
一百乘五十	二百乘五十
二十乘七十七	七乘十七乘七乘十二十等多少
八十二除二	三十乘九
二十七乘八	二十七乘六
十八除二	零点六除零点四
一百二十四乘六十五	一百三十乘六十五
五十八除两x十六的竖式	五十八除九的竖式
三百加三百等	十四乘六等多少
六乘十	八乘十
二十二乘二十	七百二十除九十
二十乘二十七	二十乘八十
一百三十乘四	十九乘九
四十五加四十五等多少	四点五乘零点二
六十四乘三等多少	零点四八除四
五百四十除五	五百四十除四
七十八点五除四	四十除十四
八十除四	八百除四
七百五十除二	七百五十除十五
三十二除五十	三十二除十八
一千除一千	一千除二
四点九除七	四除七
八十乘五	六乘七等几
血压一百四十六除七十二正常吗	血压一百三十六除七十二正常吗
凑十法九加八	凑十法九加六
四十八乘二	四十八乘五
四十二除六等多少	三除零点六
一百乘一百	三百乘三百
一百三十八除十八	四点二除零点六
一百五十六除十二	三百乘四等多少
一点八乘零点五	零点八乘一点五
五乘八	十三除五
七十二除十八	七加三等
十三乘十三	十三乘十四
十八乘二十是什么	八十二乘十八等几
五十一乘八十七	八十八乘八十七
十一除十二减两除五等几分之几	一除十二减两除五等几分之几
一加五尺寸	一加三尺寸
七十七除四等多少	六除四等多少
三元减一元六角	三元减一元五角
十七加十九	十七加十三
一百六十除三	零点一乘零点一
五百五十除六的竖式	一百八十六除六的竖式
二十五乘九除二十	十乘九除二十
十八乘九十	十八乘十八
二百四十除三的竖式计算怎么写	二百四十三除三的竖式计算怎么写
一百三十二除八等	二十除八等
二百五十乘四	七十二除二十四
二十一除四	四十八乘六
二百零四乘四	二百零五乘四
八点五除五	十八点九除五
一点六十八乘五	一点六十八乘十二
十五乘十八	十八除十五
十一乘四十五竖式	十一乘二十六竖式
七点二乘零点五	六乘四等
十七乘四十的竖式	十七乘二十七的竖式
四百五十九除三	四百五十九除四
一百除十五	十五乘八等多少
一百五十乘三十等几	一百五十乘三十乘五十
二十五除二	十万加十万等多少
六百三十二除八竖式计算	六百三十四除八竖式计算
一百九十乘五	八减六等几
一百零五乘七	四乘七
一点五乘八	一点八乘五
四十五加十九等几	四十五加五等几
二千八百除十二	十七乘八等多少
五乘三点一四等多少	八百乘五
一点二乘零点八	一点二加零点八
十四加十四等几	十四除二等几
三十二加二十	二十加二十
六又一除四的平方根	六十一除四的平方根
三十四乘多少等二百九十四	十九乘五十等多少
三百五十除一千等多少	三除一千等多少
二十三乘五十等多少	十除三等几
一百加一百加一百	三点一四乘一点二
三加三等几啊	五加五等几啊
二百一十除七	三点六除零点二
四十五乘六等多少	一点二五乘八十
六百九十八除七约等多少	十二除七约等多少
十二乘零点五十六	十乘零点五十六
二百四十五除三估算	二百四十五除八估算
二十四除六的带分数	七除六的带分数
二十三乘四等几	六十四加二十八
四乘三等多少	四乘四乘四等多少
二十五除一千化成小数是多少	二十五除三十七化成小数是多少
三乘几等十八	六乘三等几
一加五重量	一加八重量
一点五乘零点六等略微	一点六乘零点五
三减减六	三减减三
三十乘三百二十	三十乘四十五
三点一四乘九等多少	三点四乘九等几
十五除零点五	零点五除五
床单六乘七是多大尺寸	床单五乘七是多大尺寸
九除九	十六乘六等几
五十一乘八十七	五十一乘二十一
一百二十五除三十等几	一百二十五除六等几
十六乘一千二百五十	十六乘十九
十一乘十五	一十乘五十
四十九乘七	四十九除七
四除十七等多少	四除八等多少
四乘二点五等多少	四十乘五
三乘八百等多少	三乘二十五等多少
十二乘五等多少	十二乘十二等多少
五百乘五	十二点五乘八等多少
六百除二十	六百除五
八十五除六	八十五除十七
三十五乘十四	六十四除二
一点五乘四	一点四乘五
二十乘十七乘二十七	十七十乘七
一又三除七等多少小数	三又一除七等多少小数
十三乘八十五	十三乘三十三
七十除五	七十除十
二十四除三	二十四除九
十七除三等多少	四除三等多少
四十二除二	四十二除五
二分之一减三分之二	三分之二减二分之一
三十六除二等多少	零点二四除三
七十二乘一千	七十二乘一百二十
零点二十六乘零点五	零点二十六乘四
十五除七化成小数	十一除七化成小数
一百六十除四十八等多少	七除四十八等多少
ofree四加六十四多少钱	六乘八等多少
三乘十八等多少	五乘三等多少
十二加五等多少	十二加十二等多少
五十点九六除六点五	十六点五除五
八十七乘三	三乘三乘三点一四
五十六除七	十二点五六乘四
一百八十乘四十	一百八十乘一百二十五
六除于八分之十五	六除于六
零除五十五	五十五除零
一千加一千等几百	一百除十二点五
十加五等多少	那九加九等几
二百零八乘三	二百零八减一百二十九
四十二乘十九约	四十二乘二十一约
十五乘一除四	十乘一除四
一百除九十五	一百除十
一加七t拍照效果	一加八拍照效果
三点一四乘四除二	三点二除四
十七乘三十八的竖式	十七乘二十七的竖式
一点六除零点二五	六除零点二五
二点五乘零点四	四乘二百五十
三除七加三除七	六除七加六除七
三十除四百	三百除三十
七十除八	十六除八
三十五乘五	三十五除五
一百八十乘二十	三十六乘六
四百八十除二十	十七乘四等多少
五点五除十一	十一除五
九加十等几	九加十四等几
二十二乘二十二	二十二加二十二
一千加五千	五千加五千
一百五十除六十	十六除三等几
九百六十除七等多少	一除七等多少
一百二十乘七十三的简便方法	一百二十除七十三等多少
一百三十乘五十	零点九除零点五
九百五十六除四的竖式	九百五十六除九的竖式
二十五乘十二	二十五乘二十五
双色球十六加二多少钱	双色球一加二多少钱
