小孩补什么钙好	小孩补什么盖好
单字名字女	单子名字女
怀孕流褐色血	怀孕留褐色血
台湾著名大学世界排名	台湾知名大学世界排名
水浒传作者	水浒转作者
月经不调吃什么药	月经不调吃什么要
额头长痘痘是什么原因	额头张痘痘是什么原因
被猫咬了要打针吗	背猫咬了要打针吗
猕猴桃能和酸奶一起吃吗	弥猴桃能和酸奶一起吃吗
月经期可以艾灸吗	月经期可以爱灸吗
甲醛有气味吗	甲荃有气味吗
来例假能喝茶吗	来历假能喝茶吗
腰骶部酸痛怎么回事	腰底部酸痛怎么回事
心率快吃什么药	心率块吃什么药
脱发挂什么科	脱发挂什么课
文言文翻译器	文言文翻译其
经期能喝茶吗	经期能喝茶马
哺乳期能贴膏药吗	哺乳期能帖膏药吗
肺结节是什么	肺接节是什么
甲状腺结节伴钙化	甲状腺结界伴钙化
腰肌劳损怎么办	腰肌劳损怎么半
血糖高的症状	血糖高德症状
脚后跟疼是什么原因	脚后跟疼是什么愿因
指甲上有竖纹是怎么回事	指甲上有竖文是怎么回事
慢性肠胃炎吃什么药	漫性肠胃炎吃什么药
胃不好能喝红茶吗	胃不好能和红茶吗
草珊瑚的功效与作用	草珊湖的功效与作用
肠梗阻怎么治疗	肠耿阻怎么治疗
哪里有免费电影	那里有免费电影
一直拉肚子是怎么回事	一只拉肚子是怎么回事
戴避孕套会怀孕吗	待避孕套会怀孕吗
橘子吃了有什么好处	桔子吃了有什么好处
哪种猫好养	那种猫好养
经期可以吃什么水果	经期可以吃什麼水果
肾癌的症状	肾癌得症状
企业帐户怎么开通	企业账户怎么开通
阑尾炎手术后吃什么好	兰尾炎手术后吃什么好
被蜜蜂蛰了怎么处理	被密蜂蛰了怎么处理
公积金可以取吗	公基金可以取吗
心率慢是什么原因	心律慢是什么原因
先兆流产的症状	先找流产的症状
胰腺是什么	遗腺是什么
怎样剪腿上的肉	怎样减腿上的肉
甲状腺结节有什么症状	甲状腺结节有什么证状
尖锐湿疣如何治疗	尖锐湿尤如何治疗
尖锐湿疣传播途径	尖锐湿疣传播途经
感冒吃什么药	敢冒吃什么药
黄瓜片敷脸有什么好处	黄瓜片肤脸有什么好处
梦见被蛇咬	梦见备蛇咬
心血管堵塞	心学管堵塞
大便出血怎么办	大便初血怎么办
孕妇可以做足疗吗	孕妇可以作足疗吗
颈椎病会引起嘴唇麻吗	颈椎病会引起嘴唇麻麻
眼睛胀疼怎么办	眼睛帐疼怎么办
什么牌子的行车记录仪好	什么牌子的行车记录仪号
脚上起水泡怎么办	脚上气水泡怎么办
梦见鞋跟断了	梦见鞋根断了
喝蜂蜜水减肥吗	和蜂蜜水减肥吗
月经期间可以喝绿茶吗	月经期间可以和绿茶吗
经期能喝菊花茶吗	经期能和菊花茶吗
脚趾甲有瘀血怎么办	脚趾甲有淤血怎么办
百家姓有姓未的吗	百家姓有姓唯的吗
减肥能喝牛奶吗	减肥能和牛奶吗
植物神经功能紊乱有哪些症状	植物神精功能紊乱有哪些症状
大便不成形是怎么回事	大便不成行是怎么回事
法令纹怎么去除	法令纹怎么祛除
小腿酸胀是怎么回事	小腿酸帐是怎么回事
后背疼挂什么科	后备疼挂什么科
孕妇能吃牛油果吗	孕妇能吃牛油果妈
大便次数多怎么回事	大便此数多怎么回事
胸部胀痛是不是怀孕了	胸不胀痛是不是怀孕了
猪脚闷莲藕的做法大全家常	猪脚焖莲藕的做法大全家常
眼睛下面骨头疼	眼镜下面骨头疼
输尿管结石的症状	输尿管结石得症状
打耳洞疼吗	打儿洞疼吗
地板砖什么样的好	底板砖什么样的好
含人体器官的成语	含人体器关的成语
蜂蜜的功效与作用	蜂密的功效与作用
脚痒脱皮是什么原因	脚痒拖皮是什么原因
如何检查燃气是否泄漏	如何检查燃气是否泄露
马克思和恩格斯是哪国人	马克思和恩格斯是那国人
唐筛多久可以拿结果	糖筛多久可以拿结果
大便拉不出来怎么办	打便拉不出来怎么办
高血压有什么症状	高血压又什么症状
过敏性鼻炎怎么治	过敏星鼻炎怎么治
甲状腺手术后多久恢复	甲状腺手术后多久回复
现在做什么行业最挣钱	现在做什么行也最挣钱
治疗腰间盘突出	治疗腰间盘凸出
来月经可以喝红枣水吗	来月经可以和红枣水吗
带状疱疹的症状	带壮疱疹的症状
如何提高心理素质	如何提高心里素质
怎么去除黑眼圈	怎么去出黑眼圈
婴儿流黄鼻涕	婴儿留黄鼻涕
你他妈是什么意思	你她妈是什么意思
小孩长湿疹怎么办	小孩张湿疹怎么办
电热水器哪个牌子好	店热水器哪个牌子好
糖尿病人能吃花生吗	塘尿病人能吃花生吗
甲状腺结节	甲妆腺结节
眼皮肿了怎么办	眼皮肿了怎么半
右肋骨下方疼痛是什么原因	有肋骨下方疼痛是什么原因
脂肪肝有什么症状	脂肪肝有什么正状
排列五复式价格	排列五复试价格
胃溃疡能吃什么	为溃疡能吃什么
山西应急厅厅长	陕西应急厅厅长
芦荟胶的功效与作用	芦荟交的功效与作用
买二手车用缴税吗	买二手车用交税吗
咽喉炎怎么治疗	咽候炎怎么治疗
哪里批发服装最便宜	那里批发服装最便宜
中暑会拉肚子吗	中暑会啦肚子吗
糖尿病可以吃核桃吗	唐尿病可以吃核桃吗
什么是注册资本	什么事注册资本
腿为什么会抽筋	退为什么会抽筋
嘴巴周围长痘	嘴巴周围张痘
膝盖痛是什么原因	希盖痛是什么原因
怀孕初期可以喝茶吗	怀孕初期可以和茶吗
如何降尿酸	如何将尿酸
姐姐的女儿叫什么	姐姐得女儿叫什么
脖子上有结节怎么办	脖子上有结界怎么办
颈椎病症状	颈椎病政状
孩子上火流鼻血怎么办	孩子上火留鼻血怎么办
参麦注射液的作用	参麦注射夜的作用
没有户口本怎么迁户口	没有户口本怎么签户口
人工授精的孩子健康吗	人工受精的孩子健康吗
怎么去水肿	怎么取水肿
拉肚子能不能吃橘子	拉肚子能不能吃桔子
尖锐湿疣怎么得的	尖锐湿疣怎么得得
打嗝放屁是怎么回事	大嗝放屁是怎么回事
举头三尺有神明	举头三尺有神名
吃降压药能喝酒吗	吃将压药能喝酒吗
急性白血病有哪些症状	急性白血病有那些症状
乙肝吃什么药	亿肝吃什么药
怎么绑鱼钩子线	怎么邦鱼钩子线
拉黑屎怎么回事	拉黑是怎么回事
我在马路边捡到一分钱	我在吗路边捡到一分钱
安阳有那些县	安阳有哪些县
慢性血热型荨麻疹	慢性血热性荨麻疹
双相情感障碍的患病率	双向情感障碍的患病率
那种减肥药最好最有效	哪种减肥药最好最有效
武大郎那里人	武大郎哪里人
王子怡是谁	汪子怡是谁
回来吧大叔结局	回来把大叔结局
月经推迟二十天正常吗	月经退迟二十天正常吗
右脚大拇指发麻	右脚大母指发麻
怎么网上订机票	怎么网上定机票
尿道炎吃什么药	尿到炎吃什么药
乳房疼痛怎么回事	乳房疼痛怎么会事
吃头孢喝白酒	吃头孢和白酒
来月经可以喝咖啡吗	来月经可以何咖啡吗
霍金得的是什么病	霍金的的是什么病
脸上毛孔大怎么办	脸上毛空大怎么办
分数怎么化成小数	分数怎么划成小数
怎样消除打嗝	怎样消除打隔
芒果湿热吗	芒果是热吗
眼睛进沙子怎么办	眼睛进砂子怎么办
胃下垂的症状	胃下垂的症壮
甲亢不能吃什么	甲抗不能吃什么
血小板偏高	血小版偏高
浩在五行中属什么	昊在五行中属什么
网上怎么选车牌号	往上怎么选车牌号
大拇指甲上有黑色竖纹是怎么回事	大姆指甲上有黑色竖纹是怎么回事
打嗝怎么治	打嗝怎么制
药流好还是人流好	药流好还是人留好
鸡肉痛风可以吃吗	鸡肉通风可以吃吗
新生儿脑缺氧	新生儿恼缺氧
如何去痘坑	如何去逗坑
脚后跟疼怎么治疗	脚后跟疼怎么制疗
如何有效祛除蟑螂	如何有效去除蟑螂
怎样去除螨虫	怎样去出螨虫
元曲四大家之首是谁	元曲四大家之手是谁
右腹部疼痛	又腹部疼痛
排卵期有几天	排卵期又几天
关节积液怎么治疗	关节积夜怎么治疗
什么情况下需要根管治疗	什么情况下需要跟管治疗
用手机怎么批照片	用手机怎么劈照片
月经期间可以喝蜂蜜吗	月经期间可以和蜂蜜吗
双色球什么时候开奖	双色球什么时候开讲
右下腹是什么器官	又下腹是什么器官
肩周炎怎么治疗	见周炎怎么治疗
指南针是哪个国家发明的	指南针是那个国家发明的
脸上长了脂肪粒怎么办	脸上张了脂肪粒怎么办
带状疱疹看什么科	带状疱诊看什么科
女性尿道口长好多肉芽	女性尿道口长好多肉牙
心脏供血不足怎么治	心脏功血不足怎么治
禁止空挡滑行	禁止空档滑行
哺乳期可以吃薏米吗	哺乳期可以吃薏米马
痔疮脱出怎么办	痔疮拖出怎么办
荨麻疹能吃橙子吗	寻麻疹能吃橙子吗
怎样勾鱼夫帽	怎样钩鱼夫帽
账户密码	帐户密码
长水豆能洗澡吗	长水逗能洗澡吗
妊娠糖尿病可以喝孕妇奶粉吗	妊娠糖尿病可以和孕妇奶粉吗
有痰咳不出来吃什么药	有谈咳不出来吃什么药
糖尿病的前期症状	唐尿病的前期症状
九连籽的功效	九连子的功效
下眼眶疼是怎么回事	下眼框疼是怎么回事
地中海贫血	地种海贫血
怀孕可以吃螺丝粉吗	怀孕可以吃罗丝粉吗
震动环怎么用	振动环怎么用
嗓子哑了怎么办	嗓子哑了怎么半
胃肠感冒吃什么药	胃肠感冒吃什么要
怎样注销支付宝账户	怎样注消支付宝账户
花生的功效与作用	花生的工效与作用
感冒了鼻子不通气怎么办	感冒了鼻子不痛气怎么办
带状疱疹的症状	带状疱疹的正状
左手发麻怎么回事	左手发麻怎么会事
眼睛有红血丝怎么办	眼精有红血丝怎么办
牙龈老出血怎么回事	牙龈老出血怎么会事
四氧化三铁与盐酸反应	四氧化三铁于盐酸反应
乌兰图雅的老公是谁	乌蓝图雅的老公是谁
肺里有结节	肺里有结结
乳房疼是怎么回事	乳房疼是怎么回是
为什么老是拉肚子	为什么老是啦肚子
脚掌脱皮是什么原因	脚长脱皮是什么原因
腿为什么会抽筋	腿为什么回抽筋
心堵的慌是怎么回事	心堵得慌是怎么回事
三围是哪三围	三位是哪三围
隔离的做用	隔离的作用
神经性头痛怎么治疗	神精性头痛怎么治疗
来大姨妈可以吃香蕉吗	来大姨吗可以吃香蕉吗
什么是下午茶	什么事下午茶
乙肝e抗体阳性	已肝e抗体阳性
脚跟痛是什么原因	脚根痛是什么原因
月经后几天是安全期	月经后几天事安全期
伊可尔治疗扁平疣	伊可儿治疗扁平疣
孕酮低吃什么	孕酮滴吃什么
坐月子能不能吃燕窝	做月子能不能吃燕窝
喝红豆水有什么好处	和红豆水有什么好处
怎样去除眼袋	怎样取除眼袋
身上长猴子是什么原因	身上张猴子是什么原因
治高血压的水果	制高血压的水果
怀孕为什么会流血	怀孕为什么会留血
身上长猴子怎么去掉	身上长瘊子怎么去掉
胃恶心想吐	为恶心想吐
电脑怎么登陆微信	电脑怎么登入微信
电脑怎么登陆微信	电脑怎么登入微信
电脑怎么登陆微信	电脑怎么登入微信
电脑怎么登陆微信	电脑怎么登入微信
电脑怎么登陆微信	电脑怎么登入微信
电脑怎么登陆微信	电脑怎么登入微信
电脑怎么登陆微信	电脑怎么登入微信
电脑怎么登陆微信	电脑怎么登入微信
电脑怎么登陆微信	电脑怎么登入微信
止痛药的副作用	止痛药得副作用
在括号里填上合适的数	再括号里填上合适的数
房事后有血怎么回事	房是后有血怎么回事
怀孕多久可以测出来	怀孕多久可以侧出来
解脲支原体阳性好治吗	解尿支原体阳性好治吗
为什么会长痤疮	为什么会张痤疮
怀不了孕做哪些检查	怀不了孕做那些检查
宝宝换奶粉拉肚子怎么办	宝宝换奶粉啦肚子怎么办
大乐透六种口诀	大乐透六种口决
孕妇喝什么牛奶好	孕妇和什么牛奶好
脚底长水疱很痒怎么办	脚底长水泡很痒怎么办
鬼压床是怎么回事	鬼押床是怎么回事
慢性胃炎怎么调理	漫性胃炎怎么调理
缺氧怎么办	缺氧怎么半
营养不良的症状	营养不良的证状
什么叫中型糖尿病	什么叫重型糖尿病
如何去除法令纹	如何去除法另纹
腰压迫神经怎么治疗	腰压破神经怎么治疗
贫血吃什么药好的快	贫血吃什么药好得快
神经性耳聋的治疗方法	神精性耳聋的治疗方法
缺少维生素c的症状	却少维生素c的症状
腰椎间盘突出症的锻炼方法	腰椎间盘突出症的锻练方法
菠萝蜜上火吗	菠萝密上火吗
为什么手机收不到验证码	为什么手机收不到验正码
主动的动字怎么写	自动的动字怎么写
怀孕可以吃莴笋吗	怀孕可以吃窝笋吗
黄连的功效与作用	黄连的功效于作用
中兴通讯怎么样	中兴通迅怎么样
牛奶和桔子可以一起吃吗	牛奶和橘子可以一起吃吗
鱿鱼怎么做	鱿鱼怎么作
得了湿疹可以吃橘子吗	得了湿疹可以吃桔子吗
大便带血是怎么回事	大变带血是怎么回事
长针眼怎么办	张针眼怎么办
胃胀气怎么回事	胃长气怎么回事
封闭针是什么	封毕针是什么
怎样快速长高	怎样快速张高
头发干枯毛躁怎么办	头发干枯毛燥怎么办
男性性病怎么治	男性姓病怎么治
结婚戒指戴哪个手指	结婚戒指戴那个手指
aabb式成语	aabb是成语
为什么会得白血病	为什么会德白血病
喝牛奶腹泻	和牛奶腹泻
平均血小板体积偏低	评均血小板体积偏低
耳朵后面长了个小疙瘩	耳朵后面涨了个小疙瘩
嗓子有痰怎么办	嗓子又痰怎么办
孕妇可以喝蜂蜜柚子茶吗	孕妇可以喝蜂密柚子茶吗
广州哪里买狗好	广州哪里买狗号
尿毒症有什么症状	尿毒症有什么证状
哪些食物含维生素d	哪些食物含微生素d
孕妇能吃韭菜吗	孕夫能吃韭菜吗
苹果手机怎么定位	苹果手机怎么订位
如何用黏土自制起泡胶	如何用粘土自制起泡胶
来月经可以泡脚吗	来月经可以跑脚吗
苹果手机的录音在哪里	苹果手机的录音在那里
妊娠纹是什么	妊深纹是什么
经期可以喝红酒吗	经期可以何红酒吗
花儿为什么那么红	花儿未什么那么红
达克宁治龟头炎吗	达克宁治鬼头炎吗
早餐卖什么赚钱	早餐买什么赚钱
包皮红肿怎么回事	包皮红重怎么回事
他达拉非片是性药吗	他达拉菲片是性药吗
眼睛变形怎么恢复	眼睛变型怎么恢复
糖尿病能吃苹果吗	塘尿病能吃苹果吗
肾结石要注意什么	肾结石要主意什么
甲亢的症状有哪些	甲亢的症状有那些
个人简历自我评价怎么写	个人简力自我评价怎么写
杜甫的诗被称为什么	杜甫的是被称为什么
查艾滋病挂什么科	查爱滋病挂什么科
血压过低是什么原因	血压过第是什么原因
结婚祝贺词	结婚祝合词
关节响是怎么回事	关结响是怎么回事
西葫芦怎么做好吃	西胡芦怎么做好吃
功能固着和思维定式的区别	功能固着和思维定势的区别
坐月子拉肚子怎么办	座月子拉肚子怎么办
咳嗽吃什么药好的快	咳嗽吃什么药好得快
怀孕能不能泡温泉	怀孕能不能跑温泉
平行四边形的面积公式是什么	平行四边行的面积公式是什么
糖尿病能治好吗	糖尿病能知好吗
痔疮一般长在哪里	痔疮一般长在那里
白细胞高怎么回事	白细胞高怎么会事
月经有血块怎么回事	月精有血块怎么回事
坐骨结节滑囊炎的症状	坐股结节滑囊炎的症状
四肢麻木是什么病	四只麻木是什么病
水浒传作者	水浒穿作者
怎么去除狐臭	怎麼去除狐臭
初至天目双清庄记	处至天目双清庄记
必须犯规的游戏	必须范规的游戏
孩子感冒流鼻涕怎么办	孩子感冒留鼻涕怎么办
绿豆解药吗	绿豆接药吗
人参归脾丸和归脾丸有什么区别	人参鬼脾丸和归脾丸有什么区别
舌头有裂纹是怎么回事	舌头有列纹是怎么回事
甲状腺的症状有哪些	甲状腺的症状有那些
脚趾麻木是怎么回事	脚趾麻目是怎么回事
玩游戏怎么赚钱	玩游戏怎么钻钱
玩游戏怎么赚钱	玩游戏怎么钻钱
玩游戏怎么赚钱	玩游戏怎么钻钱
玩游戏怎么赚钱	玩游戏怎么钻钱
玩游戏怎么赚钱	玩游戏怎么钻钱
玩游戏怎么赚钱	玩游戏怎么钻钱
玩游戏怎么赚钱	玩游戏怎么钻钱
玩游戏怎么赚钱	玩游戏怎么钻钱
玩游戏怎么赚钱	玩游戏怎么钻钱
玩游戏怎么赚钱	玩游戏怎么钻钱
玩游戏怎么赚钱	玩游戏怎么钻钱
玩游戏怎么赚钱	玩游戏怎么钻钱
来月经喝姜糖水好吗	来月经喝姜汤水好吗
湿疹和痱子的区别	湿疹和痱子得区别
身上青一块紫一块怎么回事	身上清一块紫一块怎么回事
拉肚子怎么回事	拉肚子怎么会事
甲减是什么病	胛减是什么病
下巴长粉刺的原因	下巴张粉刺的原因
活血化瘀的食物有哪些	活血化瘀的食物有那些
经常打嗝是什么病	经常打隔是什么病
艾滋病的传播途径有哪些	艾滋病的传播途径有那些
糖尿病能吃水果吗	唐尿病能吃水果吗
甲状腺癌能吃豆制品吗	甲壮腺癌能吃豆制品吗
走之旁汉字	走之旁汉子
什么运动可以瘦肚子	什么运动可以收肚子
牙疼怎么治	牙疼怎麼治
取环后要注意什么	取环后要主意什么
宝宝发烧能吹风扇吗	宝宝发烧能吹凤扇吗
肾虚吃什么药最好	肾虚吃什么要最好
师傅的师傅叫什么	师傅得师傅叫什么
无花果糖尿病人能吃吗	无花果糖尿并人能吃吗
带状疱疹怎么治疗	带装疱疹怎么治疗
肺热的症状	肺热的正状
肺结核有什么症状	肺结核有什么症壮
一边乳房痛	一遍乳房痛
为什么会长智齿	为什么会章智齿
骶一隐性脊椎裂	骶一隐形脊椎裂
吃什么能降血糖	吃什么能将血糖
肝不好吃什么食物	干不好吃什么食物
微信密码忘记了怎么办	微信蜜码忘记了怎么办
最近有什么好电影	最近又什么好电影
来月经可以喝蜂蜜水吗	来月经可以喝峰蜜水吗
经常做梦是什么原因	经常坐梦是什么原因
月经期间可以洗澡吗	月经其间可以洗澡吗
怀孕初期出血	怀孕出期出血
乳腺有结节怎么办	乳腺有结界怎么办
豆浆补羊水吗	豆浆补羊水妈
股票买的人多好还是卖的人多好	股票卖的人多好还是买的人多好
得了破伤风能治好吗	的了破伤风能治好吗
哺乳期可以吃巧克力吗	补乳期可以吃巧克力吗
胃糜烂有哪些症状	胃糜烂有那些症状
艾滋病红点会痒吗	爱滋病红点会痒吗
耳朵里长痘痘是怎么回事	耳朵里张痘痘是怎么回事
补缴住房公积金可以贷款吗	补交住房公积金可以贷款吗
霍尔元件能够测量哪些物理参数	霍尔原件能够测量哪些物理参数
脑动脉硬化	脑动脉硬花
秦始皇为什么要建兵马俑	秦始皇为什么要见兵马俑
心率快的原因	心律快的原因
菠萝上火吗	菠罗上火吗
白癜风会传染吗	白癜风会传然吗
乙肝的症状有哪些	已肝的症状有哪些
甲亢会遗传吗	甲亢回遗传吗
脑供血不足怎么办	脑供血不足怎么半
隐形矫正牙齿多少钱	隐性矫正牙齿多少钱
膀胱炎有什么症状	膀胱炎有什么症壮
心肌受损怎么治疗	心机受损怎么治疗
无线路由器怎么设置	无线露由器怎么设置
嗓子发炎吃什么药	桑子发炎吃什么药
白癜风会遗传吗	白店风会遗传吗
吃火龙果会拉肚子吗	吃火龙果回拉肚子吗
怎样调节内分泌失调	怎样调解内分泌失调
怀孕可以吃当归吗	怀孕可以吃档归吗
碘伏涂伤口疼吗	碘伏图伤口疼吗
什么是半月板损伤	什么是半月半损伤
扁桃体发炎挂哪个科	扁桃体发炎挂那个科
脚后跟痛怎么办	脚后根痛怎么办
机器人怎么做	机气人怎么做
霉菌阴道炎	霉菌阴到炎
晚上喝牛奶会长高吗	晚上和牛奶会长高吗
如何预防青春痘	如何预防青春豆
心脏二尖瓣轻度返流	心脏二尖瓣轻度反流
心脏早搏如何治疗	心脏早博如何治疗
腿酸是怎么回事	腿酸是怎么会事
来大姨妈可以喝咖啡吗	赖大姨妈可以喝咖啡吗
尿潜血弱阳性是怎么回事	尿浅血弱阳性是怎么回事
小狗拉稀带血	小狗拉西带血
低回声是什么意思	低回升是什么意思
牙齿疼怎么办	芽齿疼怎么办
蛔虫药什么时候吃	蛔虫要什么时候吃
怎么炼劈叉	怎么练劈叉
什么东西补肾	什么东西布肾
燃气灶打不着火是什么原因	然气灶打不着火是什么原因
哺乳期可以吃茄子吗	哺乳起可以吃茄子吗
尿道炎吃什么药	尿导炎吃什么药
白癜风怎么治疗	白电风怎么治疗
做什么生意最赚钱	作什么生意最赚钱
蜜蜂蛰了怎么处理	蜜峰蛰了怎么处理
高血糖可以吃什么水果	高雪糖可以吃什么水果
心脏供血不足吃什么药	心赃供血不足吃什么药
痛风病人能吃菠菜吗	痛风病人能吃波菜吗
什么是激烈的运动	什么是剧烈的运动
来月经时腰疼	来月经是腰疼
内分泌失调怎么调理	内分秘失调怎么调理
忧郁症的表现	忧郁症得表现
吃什么可以长胖	吃什么可以涨胖
怎么使胸变大	怎么是胸变大
英语日常用语	英语日常用于
经期可以泡脚吗	经期可以跑脚吗
怎样才能长胖	怎杨才能长胖
食物中毒的症状	食物中毒得症状
来大姨妈能喝酒吗	来大姨吗能喝酒吗
胃胀气怎么回事	胃帐气怎么回事
髋关节积液的治疗方法	宽关节积液的治疗方法
微信聊天记录怎么备份	威信聊天记录怎么备份
怎么取消淘宝待付款	怎么取消淘宝带付款
翻山越岭什么生肖	翻山越领什么生肖
肾的生理功能是什么	肾的生里功能是什么
怎么治疗驼背	怎么治疗驮背
美容养颜喝什么茶	美蓉养颜喝什么茶
成龙带的什么眼镜	成龙戴的什么眼镜
被蜜蜂蛰了有后遗症吗	被蜜蜂蜇了有后遗症吗
慢性浅表性胃炎的症状	慢性浅表性胃炎的政状
臀部疼痛是什么原因	屯部疼痛是什么原因
幽门螺旋杆菌的三联疗法	幽门螺旋杆菌的三连疗法
大乐透什么时候开奖	大乐头什么时候开奖
如何恢复视力	如何会复视力
电子烟对身体有害吗	电子烟队身体有害吗
孕妇可以喝蒲地蓝消炎口服液吗	孕妇可以喝蒲地兰消炎口服液吗
白癜风能治愈吗	白店风能治愈吗
咳嗽的原因有哪些	咳嗽的原因有那些
性刘的女明星有哪些人	姓刘的女明星有哪些人
打狂犬育苗可以吃芒果吗	打狂犬预苗可以吃芒果吗
梅毒的症状有哪些	梅毒的症状有那些
拔智齿后多久可以吃东西	把智齿后多久可以吃东西
肝不好的症状有哪些	干不好的症状有哪些
右边腰疼是什么原因	右边要疼是什么原因
颈椎病的治疗	颈椎病得治疗
咸鱼退款卖家拒绝	闲鱼退款卖家拒绝
晚上做恶梦是什么原因	晚上坐恶梦是什么原因
后背疼是怎么回事	后背腾是怎么回事
左腹部隐痛的原因	做腹部隐痛的原因
经常用开塞露有什么副作用	经常用开赛露有什么副作用
妊娠糖尿病能吃玉米吗	妊娠唐尿病能吃玉米吗
神经官能症吃什么药	神经官能证吃什么药
甲沟炎用什么药膏	甲钩炎用什么药膏
眼睛变形怎么恢复	眼睛变性怎么恢复
宁波属于哪个市	宁波属于那个市
家长意见和建议	家长意见和建意
无花果的功效	无花果的公效
心脏供血不足怎么调理	心脏共血不足怎么调理
宝宝打喷嚏流鼻涕怎么办	宝宝打喷涕流鼻涕怎么办
海星怎么吃	海星怎麼吃
韩币兑人民币的汇率	韩币对人民币的汇率
乙肝有哪些症状	艺肝有哪些症状
肾功能检查有哪些项目	肾公能检查有哪些项目
脸上的螨虫怎么去除	脸上得螨虫怎么去除
最难写的汉字	最难写的汉子
汗蒸完多久可以洗澡	汉蒸完多久可以洗澡
烂脚丫怎么治	滥脚丫怎么治
大便解不出来怎么办	打便解不出来怎么办
一什么浪花	一什麼浪花
脚浮肿怎么办	脚俘肿怎么办
咽喉滤泡增生怎么治疗	咽后滤泡增生怎么治疗
惊惶的惶的拼音	惊慌的惶的拼音
感冒了吃什么药	感冒了吃什么要
茄子怎样做好吃	茄子怎样作好吃
菊花的功效与作用	菊花得功效与作用
吃果导片有什么副作用	吃果倒片有什么副作用
甲状腺结节是怎么回事	甲状腺结结是怎么回事
慢性咽炎的症状	慢性咽炎的证状
人流后可以吃水果吗	人流厚可以吃水果吗
宫颈癌前期有什么症状	宫颈癌前期有什么证状
坐月子能吃甜瓜吗	坐月子能吃田瓜吗
微信零钱通和支付宝余额宝哪个收益高	微信零钱痛和支付宝余额宝哪个收益高
糖尿病的症状有哪些	糖尿病的证状有哪些
湿气重的食物有哪些	湿气重的食物有那些
淋巴瘤有什么症状	淋巴瘤有什么证状
减肥每天喝多少水	减肥每天和多少水
背上长痘痘的原因	背上张痘痘的原因
脚心疼怎么回事	脚心疼怎么会事
腿部肌肉酸痛	腿不肌肉酸痛
手脱皮是什么原因	手拖皮是什么原因
浙江会在哪里	浙江会在那里
皮肤发痒怎么回事	皮夫发痒怎么回事
人有多少颗牙齿	人有多少克牙齿
烂脚丫怎么治	烂脚丫怎么制
神经炎是什么症状	神精炎是什么症状
治口腔溃疡的药	制口腔溃疡的药
打完百白破胳膊红肿	打完白白破胳膊红肿
小儿急性喉炎吃什么药	小二急性喉炎吃什么药
怎么变得高情商	怎么变的高情商
海带吃了有什么好处	还带吃了有什么好处
汗疱疹怎样根治	汗泡疹怎样根治
上吐下泻是怎么回事	上吐下泻事怎么回事
怎样在网上赚钱	怎样在往上赚钱
脸上长斑怎么办	脸上长办怎么办
痛风能喝白酒吗	痛风能喝百酒吗
熏艾条的功效与作用	薰艾条的功效与作用
艾滋病多久可以查出来	爱滋病多久可以查出来
黑枸杞的功效与作用	黑枸杞得功效与作用
孕妇感冒能喝板蓝根吗	孕妇感冒能和板蓝根吗
宝宝几个月翻身	宝宝几个月反身
葫芦的功效与作用	葫芦的工效与作用
世界上最小的国家	事界上最小的国家
吃什么补维生素c	吃什么不维生素c
新生儿黄疸怎么退得快	新生儿黄疸怎么退的快
哮喘能根治吗	哮喘能跟治吗
吃中药能吃橘子吗	吃中药能吃桔子吗
戴cb锁的危害	带cb锁的危害
老是放臭屁是怎么回事	老是防臭屁是怎么回事
搪瓷锅可以熬中药吗	唐瓷锅可以熬中药吗
0六年是闰哪个月	0六年是润哪个月
六味地黄丸哪个牌子好	六味地黄丸那个牌子好
玻璃体混浊会导致失明吗	玻璃体浑浊会导致失明吗
结节性痤疮是什么	结节型痤疮是什么
足跟滑囊炎怎么治疗	足根滑囊炎怎么治疗
双氯芬酸钠栓的作用与功效	双氯芬酸纳栓的作用与功效
孕妇能吃泡椒凤爪吗	孕妇能吃泡椒风爪吗
板面汤怎么做	版面汤怎么做
澳元兑人民币汇率趋势	澳元对人民币汇率趋势
坐骨神经痛吃什么药	坐骨神精痛吃什么药
怀孕能喝茶水吗	怀孕能和茶水吗
打开付款吗	打开付款码
怎样除口臭	怎样处口臭
脚底板痒是什么原因	脚地板痒是什么原因
妊娠糖尿病能吃什么水果	任娠糖尿病能吃什么水果
苹果手机怎么设置来电铃声	平果手机怎么设置来电铃声
大人咳嗽吃什么好的快	大人咳嗽吃什么好得快
早上喝蜂蜜水有什么好处	早上和蜂蜜水有什么好处
感冒喉咙痛怎么办	感冒候咙痛怎么办
实用新型和外观设计专利权的期限	使用新型和外观设计专利权的期限
长辈过生日送什么花	长背过生日送什么花
如何取消分隔符	如何取消分格符
艺伎线条多少钱	艺妓线条多少钱
净水器那个牌子好	净水气那个牌子好
虾不能和什么一起吃	吓不能和什么一起吃
支付宝可以转账到信用卡吗	支付宝可以转帐到信用卡吗
手上长鸡眼怎么办	手上长几眼怎么办
来月经能喝茶水吗	来月经能和茶水吗
白内障怎么治疗	百内障怎么治疗
酸奶什么时候喝最好	酸奶什么时侯喝最好
公主连接母猪石怎么得	公主连结母猪石怎么得
杭州哪里有摩托车卖	杭州哪里有摩托车买
肚脐眼痛是怎么回事	肚齐眼痛是怎么回事
脉搏一分钟九十下正常吗	脉博一分钟九十下正常吗
小孩咳嗽吃什么好的快	小孩咳嗽吃什么好得快
哪里治疗鼻炎好	那里治疗鼻炎好
宝宝缺钙的表现	宝宝确钙的表现
怎么教孩子画画	怎么教孩子画花
考瓷牙多少钱一颗	烤瓷牙多少钱一颗
系统性红斑狼疮	系统性红斑琅疮
长痘痘的原因是什么	张痘痘的原因是什么
头皮糠疹治疗方法	头皮康疹治疗方法
蛋白质高的食物有哪些	蛋白质高的实物有哪些
怎样才能戒烟	怎样才能介烟
莹石设备不在线	萤石设备不在线
萝卜樱怎么做好吃	萝卜婴怎么做好吃
透析一次多少钱	透希一次多少钱
小腹坠胀怎么回事	小腹赘胀怎么回事
胳膊麻木怎么回事	胳膊麻木怎么会事
关于书的名言	关于书的明言
橙子怎么吃	橙字怎么吃
梅毒的症状	梅毒的证状
荨麻疹吃什么药	寻麻疹吃什么药
喉咙有痰怎么办	侯咙有痰怎么办
同型半胱氨酸偏高	同性半胱氨酸偏高
眼肌型重症肌无力治疗	眼肌形重症肌无力治疗
舌头起泡怎么办	舌头气泡怎么办
刘亚的拼音	刘娅的拼音
粽子怎么做的	棕子怎么做的
几何体是什么	几和体是什么
肚子饿了怎么办	度子饿了怎么办
神经性头痛怎么治疗	神经性头通怎么治疗
嗓子哑怎么办	嗓子哑怎么班
睡觉老做梦是什么原因	睡觉老作梦是什么原因
肝火旺盛吃什么药	肝火旺胜吃什么药
端午节的习俗	端午节的习素
感冒药饭前吃还是饭后吃	感冒药饭钱吃还是饭后吃
哺乳期能吃茄子吗	补乳期能吃茄子吗
耳朵里面有耳结怎么办	耳朵里面有耳节怎么办
宝宝感冒鼻塞怎么办	宝宝感冒鼻赛怎么办
怀孕初期症状	怀孕初七症状
馒头怎么做	馒头怎麼做
带状泡疹最佳治疗方法	带状疱疹最佳治疗方法
胃炎可以喝红糖水吗	胃炎可以和红糖水吗
下划线昵称	下滑线昵称
经期能艾灸吗	经期能爱灸吗
拔智齿危险吗	把智齿危险吗
炉石传说哪些牌可以分解	炉石传说那些牌可以分解
母亲节什么时候	母亲杰什么时候
阿苯达唑片吃了拉虫吗	阿苯达唑片吃了拉虫嘛
减肥期间可以吃核桃吗	减肥期间可一吃核桃吗
心脏造影副作用	心脏照影副作用
心脏造影副作用	心脏照影副作用
心脏造影副作用	心脏照影副作用
心脏造影副作用	心脏照影副作用
心脏造影副作用	心脏照影副作用
心脏造影副作用	心脏照影副作用
心脏造影副作用	心脏照影副作用
心脏造影副作用	心脏照影副作用
心脏造影副作用	心脏照影副作用
心脏造影副作用	心脏照影副作用
心脏造影副作用	心脏照影副作用
心脏造影副作用	心脏照影副作用
哪个网站买书便宜	哪个网站卖书便宜
女性更年期年龄	女姓更年期年龄
大便不成形次数多是什么原因	大便不成型次数多是什么原因
怎么在网上找人	怎么在网上招人
艾灸后多久可以洗澡	艾灸厚多久可以洗澡
柠檬蜂蜜水的功效	拧檬蜂蜜水的功效
什么是唇炎	什么事唇炎
修正带坏了怎么修	修整带坏了怎么修
降血糖食物	降血糖事物
关于汉字的广告	关于汉子的广告
女生做什么工作比较好	女生坐什么工作比较好
喝什么粥养胃	喝什么州养胃
助理工程师有什么用	助力工程师有什么用
毒品的危害	毒品的为害
玻尿酸一针多少钱	玻尿酸一阵多少钱
血氧饱和度低怎么办	血养饱和度低怎么办
痛风能吃冰淇淋吗	通风能吃冰淇淋吗
精神分裂症吃什么药好	精神分列症吃什么药好
怎么治疗静脉曲张	怎么制疗静脉曲张
手麻木怎么回事	手麻木怎么会事
盆腔积液是怎么引起的	喷腔积液是怎么引起的
在哪里学宠物美容	在那里学宠物美容
怎样预防新生儿黄疸	怎样预防新生儿黄胆
甲硝唑栓的作用与用途	甲硝坐栓的作用与用途
哪个牌子的奶油好	那个牌子的奶油好
海鲜过敏怎么办	还鲜过敏怎么办
白花蛇舌草功效与作用	白花蛇蛇草功效与作用
颗粒剂首选的黏合剂是	颗粒剂首选的粘合剂是
多久会怀孕	多久回怀孕
支气管哮喘	支气官哮喘
白癜风能根治吗	白癜风能跟治吗
下巴上长痘痘是什么原因	下吧上长痘痘是什么原因
dc家居是品牌吗	dc家具是品牌吗
冀州在哪个省	蓟州在哪个省
吃太胀了怎么办	吃太涨了怎么办
双肺纹理增多增粗是什么意思	双肺文理增多增粗是什么意思
盆腔炎吃什么药	盆腔严吃什么药
荨麻疹能吃鸡肉吗	荨麻诊能吃鸡肉吗
喉咙滤泡增生怎么办	喉咙虑泡增生怎么办
来月经可以喝酸奶吗	来月经可以和酸奶吗
如何治疗抑郁症	如何治疗抑郁证
外阴瘙痒用什么药	外阴瘙痒用什么要
种植牙多少钱一颗	种植牙多少钱一科
肌肝高是什么意思	几肝高是什么意思
减肥不能吃的水果	减肥不能吃得水果
怎样快速去眼袋	怎样快速去眼带
怎样在网上赚钱	怎样再网上赚钱
咽喉癌的早期症状	咽喉癌的早起症状
功能性消化不良怎么治	功能性销化不良怎么治
阑尾炎在哪个位置	兰尾炎在哪个位置
肝功能挂什么科	肝工能挂什么科
蓝光眼镜有必要带吗	蓝光眼镜有必要戴吗
微信号怎么注销	微信号怎么注消
月经推迟吃什么药	月经退迟吃什么药
胃肠功能紊乱的症状	胃肠功能稳乱的症状
如何培养孩子的自信	如何陪养孩子的自信
新生儿肺炎的症状有哪些	新生儿肺炎的症状有那些
维生素b是什么	卫生素b是什么
阴虚火旺吃什么药	阴虚火望吃什么药
a七十二支持面容解锁吗	a七十二支持面容解锁码
开水烫伤会留疤吗	开水烫伤回留疤吗
孕妇可以吃料酒吗	孕妇可以吃料酒马
月经期能喝柠檬水吗	月经期能喝宁檬水吗
什么东西越洗越脏	什么东西越西越脏
肚子痛拉肚子怎么办	肚子痛啦肚子怎么办
精索静脉曲张	精索静脉曲掌
生姜蜂蜜水能减肥吗	生姜蜂密水能减肥吗
甲状腺结节有什么症状	甲状腺结接有什么症状
烧心反酸怎么办	烧心返酸怎么办
鸡蛋能和菠萝一起吃吗	鸡蛋能和波萝一起吃吗
天麻的功效与作用	天麻的功效与做用
我当阴阳先生的那几年	我当阴阳先生的哪几年
做肠镜需要多长时间	做肠境需要多长时间
微信号怎么改	微信号怎麼改
手机听筒声音小怎么办	手机听桶声音小怎么办
东南西北怎么折	动南西北怎么折
苹果手机怎么设置来电铃声	苹果手机怎么设置来点铃声
血氧饱和度低	血样饱和度低
尿酸高有什么危害	尿酸高又什么危害
尿道炎吃什么药	尿道炎吃什麼药
急性心肌梗死的治疗方法	急性心机梗死的治疗方法
消费者有哪些权益	消费者有那些权益
微信把好友删了对方知道吗	微信吧好友删了对方知道吗
大便拉不出来怎么办	大便垃不出来怎么办
哺乳期可以烫发吗	哺乳期可以汤发吗
类风湿早期症状	类风湿早起症状
经常流鼻血是什么原因	经常留鼻血是什么原因
正常视力	正常视里
现在什么行业好做	现在什麼行业好做
脸上长斑的原因	脸上长斑得原因
蒲公英泡水喝的功效	朴公英泡水喝的功效
苦瓜的功效有哪些	苦瓜的功效有那些
拉血怎么回事	啦血怎么回事
左下腹痛怎么回事	左下复痛怎么回事
扁平疣的治疗方法	扁平尤的治疗方法
膝盖痛是什么原因	息盖痛是什么原因
被油烫伤起泡怎么处理	被油烫伤气泡怎么处理
胃癌都有哪些症状	胃癌都有那些症状
指南针怎么看	指南针怎麼看
水痘症状图片	水逗症状图片
腹泻能吃什么水果	腹泄能吃什么水果
慢性非萎缩性胃炎伴糜烂	慢行非萎缩性胃炎伴糜烂
早上起来头晕是怎么回事	早上起来头晕是怎么会事
小孩流口水是什么原因	小孩留口水是什么原因
胸闷胸痛怎么办	胸闷熊痛怎么办
大便排不出来怎么办	大便拍不出来怎么办
卵巢囊肿会影响怀孕吗	卵巢囊种会影响怀孕吗
长水痘打针能好的快吗	长水痘打针能好得快吗
宝宝喉咙有痰怎么办	宝宝吼咙有痰怎么办
荨麻疹的有效治疗方法	寻麻疹的有效治疗方法
在阳光下屏幕太暗	在阳光下屏幕泰安
郑州是属于哪个省	郑州是属于那个省
喜帖街的歌词	喜贴街的歌词
二十年七月七日属什么	二十年七月七日是什么
孕妇吃哪些食物容易流产	孕妇吃那些食物容易流产
怎么注册微信公众号	怎么注册威信公众号
吃海鲜荨麻疹	吃海鲜寻麻疹
怀孕几个月长妊娠纹	怀孕几个月长任娠纹
痛风可以喝绿豆汤吗	痛风可以和绿豆汤吗
房性早搏是怎么回事	房行早搏是怎么回事
脸上长痘痘怎么调理	脸上涨痘痘怎么调理
坐骨神经痛症状	坐骨神经痛症壮
脚扭伤肿了怎么办	脚纽伤肿了怎么办
龟头炎的症状	龟头炎的证状
猫能吃橘子么	猫能吃桔子么
什么是疱疹	什么事疱疹
怎么查车架号	怎么差车架号
脚趾脱皮是怎么回事	脚指脱皮是怎么回事
禁止标志英语	禁止标识英语
吃坏肚子怎么办	吃坏肚子怎么半
词藻华丽的近义词	辞藻华丽的近义词
无痛胃镜是怎么麻醉的	无痛胃经是怎么麻醉的
女生来大姨妈怎么办	女生来打姨妈怎么办
西瓜的功效与作用	西瓜得功效与作用
高血糖吃什么水果	高雪糖吃什么水果
怎么去除痘印	怎么去处痘印
种植牙能用多久	种值牙能用多久
电饼铛什么牌子好	电饼档什么牌子好
胃溃疡什么症状	胃溃阳什么症状
干眼症如何治疗	干眼证如何治疗
如何绑定银行卡	如和绑定银行卡
什么叫定向流量	什么教定向流量
世界又变得大了起来是什么歌	世界又变的大了起来是什么歌
孕妇可以喝苏打水吗	孕妇可以喝苏达水吗
蒲地蓝口服液小孩用量	铺地蓝口服液小孩用量
莲耦怎么做才好吃	莲藕怎么做才好吃
哪里烧烤最好吃	那里烧烤最好吃
苏打水有什么作用	苏大水有什么作用
我国的四大发明是什么	我国的四大发名是什么
扣肚脐眼有什么坏处	抠肚脐眼有什么坏处
柠檬泡水功效	宁檬泡水功效
小米粥糖分高吗	小米粥糖份高吗
偏头痛是怎么引起的	遍头痛是怎么引起的
偏头痛是怎么引起的	遍头痛是怎么引起的
偏头痛是怎么引起的	遍头痛是怎么引起的
偏头痛是怎么引起的	遍头痛是怎么引起的
偏头痛是怎么引起的	遍头痛是怎么引起的
偏头痛是怎么引起的	遍头痛是怎么引起的
偏头痛是怎么引起的	遍头痛是怎么引起的
偏头痛是怎么引起的	遍头痛是怎么引起的
偏头痛是怎么引起的	遍头痛是怎么引起的
偏头痛是怎么引起的	遍头痛是怎么引起的
偏头痛是怎么引起的	遍头痛是怎么引起的
偏头痛是怎么引起的	遍头痛是怎么引起的
偏头痛是怎么引起的	遍头痛是怎么引起的
偏头痛是怎么引起的	遍头痛是怎么引起的
肚子胀气怎么办	肚子胀气怎么半
明星人气榜投票	名星人气榜投票
喉咙痛喝什么好	喉咙痛和什么好
滴虫性阴道炎的症状	滴虫性阴道炎的证状
双眼皮做哪种好	双眼皮做那种好
什么软件充话费最便宜	什么软件冲话费最便宜
脑供血不足怎么治疗	脑功血不足怎么治疗
乙肝喝什么茶好	已肝喝什么茶好
六味地黄丸的功效与作用适宜年龄	六位地黄丸的功效与作用适宜年龄
频发房性早搏严重吗	频发房性早博严重吗
多囊卵巢综合症	多馕卵巢综合症
糖尿病人能吃桃子吗	塘尿病人能吃桃子吗
高烧是多少度	高烧事多少度
肠炎的症状有哪些	肠炎的症状有那些
重庆哪些是三甲医院	重庆那些是三甲医院
浅滋暗长的意思	潜滋暗长的意思
孕早期尿黄	孕早起尿黄
吃完榴莲可以喝牛奶吗	吃完榴连可以喝牛奶吗
读书读的多的成语	读书读得多的成语
苹果手机怎么格式化	苹果手机怎么各式化
嘴唇上长泡怎么办	嘴唇上张泡怎么办
打完瘦脸针可以喝酒吗	大完瘦脸针可以喝酒吗
降尿酸的药有哪些	降尿酸的药有那些
淋巴细胞百分比偏高	琳巴细胞百分比偏高
扁桃体发炎怎么办	扁桃体发炎怎么半
吃橘子上火吗	吃桔子上火吗
中国女孩名子排行榜	中国女孩名字排行榜
脚踝骨疼是怎么回事	脚怀骨疼是怎么回事
坐月子吃什么好	座月子吃什么好
小儿肠胃炎	小儿常胃炎
嗓子哑了怎么办	嗓子哑了怎么班
怎么教小孩学算术	怎么教小孩学算数
什么叫其它事业单位	什么叫其他事业单位
喉咙长息肉有什么症状	喉咙张息肉有什么症状
治疗白癜风的药物有哪些	治疗白殿风的药物有哪些
拔一颗牙多少钱	拔一棵牙多少钱
社保卡怎么激活	社宝卡怎么激活
女孩子取什么名字好听	女孩子娶什么名字好听
颈部淋巴结肿大	颈不淋巴结肿大
怎么在微店上买东西	怎么在微店上卖东西
身份证到期怎么坐飞机	身份证到期怎么做飞机
如何治疗荨麻疹	如何治疗寻麻疹
民政局有哪些部门	民政局有那些部门
冰箱为什么不制冷	冰箱为什么不治冷
交强险需要补交吗	交强险需要补缴吗
长智齿疼怎么办	张智齿疼怎么办
舌苔白是怎么回事	舌台白是怎么回事
人为什么会梦游	认为什么会梦游
无锡站在哪里	无锡站在那里
水泡型脚气怎么办	水泡性脚气怎么办
治咳嗽的水果	治咳嗽得水果
保护环境的标语	报护环境的标语
血肌酐正常值	雪肌酐正常值
牙齿有裂痕是什么原因	牙齿有列痕是什么原因
坐骨神经痛看什么科	座骨神经痛看什么科
包皮过长手术要多少钱	保皮过长手术要多少钱
军字开头的成语接龙	军子开头的成语接龙
带状疱疹会自愈吗	带状疱疹回自愈吗
霉菌性阴道炎	霉菌行阴道炎
甘油三酯偏高怎么办	甘油三指偏高怎么办
湿气重吃什么药	湿汽重吃什么药
二甲双胍可以减肥吗	二家双胍可以减肥吗
如何让胸变小	如何让凶变小
苹果手机通讯录怎么批量删除	苹果手机通迅录怎么批量删除
逍遥丸能治黄褐斑吗	消遥丸能治黄褐斑吗
怀孕会犯困吗	怀孕会范困吗
怎么做好微商	怎么坐好微商
秋葵的功效与作用	秋葵的功效与做用
绿萝的营养液怎么配	绿箩的营养液怎么配
心率正常范围	心律正常范围
六味地黄丸有副作用吗	六位地黄丸有副作用吗
灰黄霉素的副作用	灰黄梅素的副作用
眼睛有红血丝怎么回事	眼精有红血丝怎么回事
不管是什么都往嘴里添	不管是什么都往嘴里填
前列腺增生有什么症状	前列腺增生有什么症壮
王健林哪里人	王健林那里人
尿毒症能治好吗	尿毒症能知好吗
脸上长斑是什么原因	脸上张斑是什么原因
电饼铛哪个牌子好	电饼挡哪个牌子好
芒果吃了会上火吗	芒果吃了回上火吗
香蕉和酸奶可以一起吃吗	香焦和酸奶可以一起吃吗
好玩的网页游戏	好玩的网页有戏
经常放屁是什么原因	经常放屁是什么愿因
龟头炎的症状有哪些	龟头炎的症状有那些
什么玛丽亚	什么玛利亚
怎么删除淘宝订单	怎么删除淘宝定单
哮喘有哪些症状	哮喘有那些症状
三角形的周长怎么求	三角型的周长怎么求
肝火旺怎么治	肝火望怎么治
强直性脊椎炎的症状	强直性脊椎严的症状
减肥期间不能吃什么	减肥其间不能吃什么
喝什么茶排毒	和什么茶排毒
怎么在淘宝上开网店	怎么在陶宝上开网店
枸杞怎么保存	苟杞怎么保存
狂犬病传播途径	狂犬病传播途经
输卵管积液是怎么回事	输卵管积液是怎么会事
红细胞计数偏高是什么原因	红细胞记数偏高是什么原因
荨麻疹注意事项	荨麻诊注意事项
怎么查看自己的手机号码	怎么察看自己的手机号码
晒伤了怎么办	晒伤了怎么半
眼睛结膜炎怎么办	眼镜结膜炎怎么办
新生儿黄疸高怎么办	新声儿黄疸高怎么办
测血糖需要空腹吗	侧血糖需要空腹吗
小孩什么时候会走路	小孩什么时候回走路
肝钙化是什么意思	肝丐化是什么意思
我的世界怎么去天堂	我的世界怎麼去天堂
肛肠息肉怎么治	刚肠息肉怎么治
西瓜工会排名	西瓜公会排名
多西他赛副作用	多西他塞副作用
淋巴结肿大是什么原因	淋疤结肿大是什么原因
脉搏八十五正常吗	脉博八十五正常吗
怎样在手机上挣钱	怎样再手机上挣钱
恐龙怎么折	恐龙怎麼折
作信封的方法	做信封的方法
拉肚子能喝咖啡吗	拉肚子能和咖啡吗
什么是乙肝病毒携带者	什么事乙肝病毒携带者
做血管造影要多少钱	作血管造影要多少钱
肝不好有哪些症状	肝不好有哪些症壮
脸上一直长痘痘是什么原因	脸上一直张痘痘是什么原因
咽炎吃什么药效果最好	咽严吃什么药效果最好
揉腹部的正确方法	揉腹补的正确方法
精索静脉曲张怎么治疗	精缩静脉曲张怎么治疗
吸烟有哪些危害	吸烟有那些危害
如何申请微信号	如和申请微信号
胳膊扭伤怎么办	胳膊纽伤怎么办
半月板损伤怎么治疗	板月板损伤怎么治疗
佛山到桂林货车	佛山到桂林火车
哪一种减肥药效果好	那一种减肥药效果好
水痘和疱疹的区别	水逗和疱疹的区别
哪个叫什么	那个叫什么
流产后几天可以出门	留产后几天可以出门
怎么查询个人档案	怎么查寻个人档案
怎样申请低保	怎样伸请低保
阳虚怎么治疗	阳需怎么治疗
月经来了可以喝啤酒吗	月经来了可以和啤酒吗
乌鸡白凤丸的功效与作用	乌鸡白凤丸的工效与作用
水丸和蜜丸的区别	水丸和密丸的区别
脚趾甲变黑怎么办	脚指甲变黑怎么办
年青有为的意思	年轻有为的意思
小孩流鼻涕打喷嚏怎么办	小孩留鼻涕打喷嚏怎么办
湿气重怎么治疗	湿汽重怎么治疗
熬夜喝什么好	敖夜喝什么好
眼睛黄是什么原因	眼镜黄是什么原因
低血压吃什么好得快	低血压吃什么好的快
毛囊炎症状	毛囊炎证状
阜阳属于哪里	阜阳属于那里
脚痒脱皮怎么办	脚氧脱皮怎么办
慢性咽炎有哪些症状	慢性咽炎有那些症状
黄体酮和地屈孕酮片的区别	黄体酮和地区孕酮片的区别
尖锐湿疣的初期症状	尖锐湿尤的初期症状
戴牙套要多少费用	带牙套要多少费用
胰腺炎的症状有哪些	胰腺炎的症状有那些
尿血是怎么回事	尿血是怎么会事
负数是整数吗	负数是正数吗
脸上的痣可以去掉吗	脸上得痣可以去掉吗
乳腺看什么科	乳线看什么科
人的正常体温	人的正尝体温
左卵巢囊肿	做卵巢囊肿
胆囊炎的症状	胆囊研的症状
结节是肿瘤吗	结节事肿瘤吗
怎样制作圆锥	怎样制做圆锥
洛阳晚上哪里好玩	洛阳晚上那里好玩
来月经可以喝姜糖水吗	来月经可以和姜糖水吗
微信如何升级	微信如何生级
甲状腺囊性结节是什么	甲状腺囊性节节是什么
肺上有结节	肺上又结节
荨麻疹该怎么治疗	荨麻疹改怎么治疗
岔气怎么办	岔气怎么版
赵云出反甲还是不详	赵云出反甲还是不祥
雷克萨斯产自哪个国家	雷克萨斯产自那个国家
额头下巴长痘痘是什么原因	额头下巴涨痘痘是什么原因
人流要做多久的月子	人流要坐多久的月子
补血的药物有哪些	补血的药物有那些
荨麻疹不能吃什么	寻麻疹不能吃什么
一岁宝宝呕吐	一岁宝宝欧吐
糖尿病人能吃南瓜吗	唐尿病人能吃南瓜吗
黑豆的功效与作用	黑豆的功效与做用
小三阳能治好吗	小三阳能只好吗
根据词语的不同意思造句	跟据词语的不同意思造句
带清的昵称	带青的昵称
咽炎会咳嗽吗	咽炎会咳嗽妈
脚底疼怎么回事	脚底疼怎么会事
带状疱疹会自愈吗	带状泡疹会自愈吗
梦到掉牙齿	梦到掉牙吃
大雁为什么要飞到南方过冬	大眼为什么要飞到南方过冬
换个充点口多少钱	换个充电口多少钱
玫瑰代表着什么意思	玫瑰带表着什么意思
贴膏药过敏怎么办	贴糕药过敏怎么办
转基因食品有哪些	转基因食品有那些
上火吃什么水果好	上活吃什么水果好
支气管炎吃什么药好	直气管炎吃什么药好
小猫的名字	小猫得名字
体温计要量多久	体温计要两多久
脸上长小疙瘩怎么办	脸上张小疙瘩怎么办
不射进去会怀孕吗	不射进去回怀孕吗
放疗和化疗有什么区别	方疗和化疗有什么区别
蒸生蚝多长时间	整生蚝多长时间
白带有血丝怎么回事	白代有血丝怎么回事
绝经前的症状	绝经前的证状
中联重科董事长是谁	中联重科懂事长是谁
什么是功能性	什么事功能性
怎么改无线网密码	怎么改无限网密码
什么是肠胃炎	什么事肠胃炎
正常血压范围	正常学压范围
腋下黑怎么办	腋下黑怎么半
白带异常怎么办	百带异常怎么办
大脑供血不足的症状	打脑供血不足的症状
电烤箱能烤什么	电烤箱能考什么
心肌缺血的症状	心肌缺血的证状
产妇能吃菠萝蜜吗	产妇能吃波萝蜜吗
糖尿病人能喝牛奶吗	糖脲病人能喝牛奶吗
奥美拉唑饭前吃还是饭后吃	奥美垃唑饭前吃还是饭后吃
右边腰疼是怎么回事	有边腰疼是怎么回事
脚长水泡怎么办	脚涨水泡怎么办
小番茄糖分多吗	小番茄糖份多吗
包皮龟头炎	包皮鬼头炎
艾滋病的前期症状	爱滋病的前期症状
荨麻疹能吹空调吗	寻麻疹能吹空调吗
耳朵痒是怎么回事	儿朵痒是怎么回事
湖面像什么一样平静	湖面想什么一样平静
哺乳期能喝大麦茶吗	哺乳期能和大麦茶吗
华为什么手机实用	华为什么手机适用
坐月子吃什么好	坐月子吃什麼好
支付宝限制登入淘宝	支付宝限制登陆淘宝
支付宝限制登入淘宝	支付宝限制登陆淘宝
支付宝限制登入淘宝	支付宝限制登陆淘宝
支付宝限制登入淘宝	支付宝限制登陆淘宝
支付宝限制登入淘宝	支付宝限制登陆淘宝
支付宝限制登入淘宝	支付宝限制登陆淘宝
支付宝限制登入淘宝	支付宝限制登陆淘宝
支付宝限制登入淘宝	支付宝限制登陆淘宝
支付宝限制登入淘宝	支付宝限制登陆淘宝
佳木斯是哪个省的	佳木斯是那个省的
胸口闷怎么回事	胸口闷怎么会事
猪肝怎么炒好吃	猪肝怎么抄好吃
怎么注册微信账号	怎么注册微信帐号
石英砂用途	石英沙用途
艾滋病的症状有哪些	爱滋病的症状有哪些
脸上长脂肪粒怎么回事	脸上张脂肪粒怎么回事
铁皮石斛的功效与作用	铁皮石胡的功效与作用
怎么还原魔方	怎么还原摩方
今天是什么节日	今天是什麼节日
膝盖内侧疼是怎么回事	膝盖内测疼是怎么回事
今天属什么生肖	今天数什么生肖
老板扣押工资怎么办	老板扣压工资怎么办
肝右叶小囊肿	肝右叶小囊中
一岁宝宝能吃桑椹吗	一岁宝宝能吃桑葚吗
坐月子可以吃银耳莲子汤吗	做月子可以吃银耳莲子汤吗
头晕恶心是怎么回事	头晕恶心是怎么会事
射手女和水瓶男的配对指数	射手女和水平男的配对指数
经常拉肚子是什么原因	经常垃肚子是什么原因
宫颈炎症状	宫颈炎正状
小苏打怎么用	小苏达怎么用
心率过缓是怎么回事	心律过缓是怎么回事
经常流鼻血是怎么回事	经常留鼻血是怎么回事
甲状腺结节	甲状线结节
慢性咽炎的治疗方法	慢性咽炎得治疗方法
新生儿体温多少正常	新生二体温多少正常
怎么买电影票	怎么卖电影票
前列腺炎的治疗方法	前列腺炎得治疗方法
淋巴细胞偏低	琳巴细胞偏低
感冒吃什么水果好	感帽吃什么水果好
低血压的危害	低血压得危害
被辣椒辣到手怎么办	被辣椒拉到手怎么办
配件英语	备件英语
配件英语	备件英语
配件英语	备件英语
配件英语	备件英语
配件英语	备件英语
配件英语	备件英语
配件英语	备件英语
配件英语	备件英语
配件英语	备件英语
配件英语	备件英语
配件英语	备件英语
配件英语	备件英语
配件英语	备件英语
配件英语	备件英语
怎样重启路由器	怎样重起路由器
甲状腺旁腺瘤严重吗	甲状腺旁线瘤严重吗
什么是节育环	什么事节育环
宝宝咳嗽流鼻涕怎么办	宝宝咳嗽留鼻涕怎么办
怀孕初期吃什么好	坏孕初期吃什么好
脚趾头痒是怎么回事	脚指头痒是怎么回事
新生儿打嗝怎么办	新生儿打嗝怎么半
经期能吃菠萝蜜吗	经期能吃菠萝密吗
灰指甲传染吗	灰之甲传染吗
盐酸普萘洛尔片的作用	盐酸普奈洛尔片的作用
拉肚子喝什么药	拉肚子和什么药
流鼻血怎么办	留鼻血怎么办
针灸的原理是什么	针灸得原理是什么
薏米的功效与作用	苡米的功效与作用
怎样会怀孕	怎样回怀孕
抑郁症怎么治疗	抑郁症怎么治辽
胚胎生化有那些前兆	胚胎生化有哪些前兆
肠梗阻怎么治疗	肠梗组怎么治疗
智能手机怎么用	知能手机怎么用
温州有哪些区	温州有那些区
金三顺作品	金叁顺作品
哺乳期能吃大蒜吗	补乳期能吃大蒜吗
减肥可以吃葡萄吗	减肥可以吃葡萄妈
益母草的功效与作用	一母草的功效与作用
小腹胀痛是怎么回事	小腹长痛是怎么回事
慢性萎缩性胃炎症状	慢性萎缩性胃炎证状
哮喘病的症状	哮喘病的证状
下奶的食物有哪些	下奶的食物有那些
胃痛可以喝蜂蜜水吗	胃痛可以和蜂蜜水吗
肺部有结节严重吗	肺不有结节严重吗
肾阴虚与肾阳虚区别	肾阴虚于肾阳虚区别
不停打嗝怎么办	不挺打嗝怎么办
小脑萎缩的症状	小闹萎缩的症状
眼睛充血用什么眼药水	眼睛冲血用什么眼药水
肚子咕噜咕噜响	肚子咕噜咕噜想
火锅鸡的做法	活锅鸡的做法
结肠炎有那些症状	结肠炎有那些正状
别人欠钱不还怎么办	别人歉钱不还怎么办
骨髓移植活得最长的人	骨髓移植活的最长的人
孕妇可以吃冰激凌吗	孕妇可以吃冰激凌马
空腹血糖正常值范围	空服血糖正常值范围
成都好玩的地方	成都好玩得地方
嘉兴是哪个省的	嘉兴是那个省的
什么时候开学	甚么时候开学
难以想象的意思	难以想像的意思
精囊炎有哪些症状	精囊炎有那些症状
蜂巢怎么吃	蜂巢怎麼吃
药流后多久来月经	药留后多久来月经
八个月的宝宝发烧怎么办	八个月得宝宝发烧怎么办
什么的锦缎	什么的锦锻
哺乳期可以吃阿莫西林胶囊吗	哺乳期可以吃啊莫西林胶囊吗
心率低的原因	心律低的原因
荨麻疹的原因	荨麻疹得原因
牛奶什么时候喝最好	牛奶什么时候和最好
有痰咳不出来怎么办	有谈咳不出来怎么办
左上腹疼痛	左上复疼痛
舌苔发黑是什么原因	舌苔发嘿是什么原因
麦哲伦做出的贡献	麦哲伦作出的贡献
什么是儿童抽动症	什么事儿童抽动症
感冒喝什么汤	感冒呵什么汤
朱元漳为什么要大杀功臣	朱元璋为什么要大杀功臣
怎么去除黑眼圈	怎么去处黑眼圈
足偏旁的字	足边旁的字
足偏旁的字	足边旁的字
足偏旁的字	足边旁的字
足偏旁的字	足边旁的字
足偏旁的字	足边旁的字
足偏旁的字	足边旁的字
足偏旁的字	足边旁的字
足偏旁的字	足边旁的字
足偏旁的字	足边旁的字
足偏旁的字	足边旁的字
足偏旁的字	足边旁的字
足偏旁的字	足边旁的字
足偏旁的字	足边旁的字
足偏旁的字	足边旁的字
睡觉磨牙是什么原因	谁觉磨牙是什么原因
海竿一般用什么线	海杆一般用什么线
腿疼是什么原因	腿疼是什么愿因
滴虫性阴道炎治疗	滴虫性阴到炎治疗
骨裂和骨折的区别	股裂和骨折的区别
鸡蛋橘子能一起吃吗	鸡蛋桔子能一起吃吗
中暑的症状	种暑的症状
什么的翅膀	什么的翅胖
什么的翅膀	什么的翅胖
什么的翅膀	什么的翅胖
什么的翅膀	什么的翅胖
什么的翅膀	什么的翅胖
什么的翅膀	什么的翅胖
什么的翅膀	什么的翅胖
什么的翅膀	什么的翅胖
什么的翅膀	什么的翅胖
什么的翅膀	什么的翅胖
什么的翅膀	什么的翅胖
什么的翅膀	什么的翅胖
什么的翅膀	什么的翅胖
什么的翅膀	什么的翅胖
脚上起小水泡是怎么回事	脚上气小水泡是怎么回事
干咳吃什么食物好得快	干咳吃什么食物好的快
长智齿疼怎么办	涨智齿疼怎么办
痛风不能吃哪些食物	痛风不能吃那些食物
股骨头坏死怎么治	股骨头坏死怎么制
水浒传作者	谁浒传作者
脑部核磁共振多少钱	脑步核磁共振多少钱
宝宝脸上长湿疹怎么办	宝宝脸上涨湿疹怎么办
最近老放屁怎么回事	最近老放屁怎么会事
脚趾甲往肉里长怎么办	脚止甲往肉里长怎么办
西红柿首富在哪拍的	西红柿首富在那拍的
唐嫣哪里人	唐嫣那里人
湿疣怎么治疗	湿尤怎么治疗
怎么去除痘印	怎么去除逗印
人体有多少根肋骨	人体有多少跟肋骨
浙江是哪个省的	浙江是那个省的
学习英语的软件	学习英语得软件
怎么下载手机银行	怎么下栽手机银行
人流后多久来月经	人流后多久莱月经
百多邦可以擦肛门吗	百多邦可以搽肛门吗
百多邦可以擦肛门吗	百多邦可以搽肛门吗
百多邦可以擦肛门吗	百多邦可以搽肛门吗
百多邦可以擦肛门吗	百多邦可以搽肛门吗
百多邦可以擦肛门吗	百多邦可以搽肛门吗
百多邦可以擦肛门吗	百多邦可以搽肛门吗
百多邦可以擦肛门吗	百多邦可以搽肛门吗
百多邦可以擦肛门吗	百多邦可以搽肛门吗
百多邦可以擦肛门吗	百多邦可以搽肛门吗
百多邦可以擦肛门吗	百多邦可以搽肛门吗
百多邦可以擦肛门吗	百多邦可以搽肛门吗
拉肚子可以打预防针吗	啦肚子可以打预防针吗
心率不齐怎么办	心律不齐怎么办
脸上长斑怎么处理	脸上长班怎么处理
来月经腰酸怎么回事	来月经要酸怎么回事
好听的男孩名字	好听的男孩名子
湿疹能吃橘子吗	湿疹能吃桔子吗
打呼噜是怎么回事	打呼噜事怎么回事
螃蟹死了还能吃吗	庞蟹死了还能吃吗
沉香的功效与作用	沉香得功效与作用
如何制定公司制度	如何制订公司制度
孩子拉不出来屎怎么办	孩子拉不出来是怎么办
孕妇可以喝维维豆奶粉吗	孕妇可以和维维豆奶粉吗
大便不成形是什么原因	打便不成形是什么原因
阿胶糕的功效与作用	阿胶糕得功效与作用
正确佩戴口罩的方式	正确配戴口罩的方式
脖子后面长痘	脖子后面张痘
感冒咳嗽晚上咳得厉害	感冒咳嗽晚上咳的厉害
哪些人不适合吃蜂蜜	那些人不适合吃蜂蜜
荷叶的功效与作用	荷叶得功效与作用
膏药贴多久	膏药铁多久
月经期间可以吃山竹吗	月经其间可以吃山竹吗
喝牛奶拉肚子怎么办	喝牛奶啦肚子怎么办
肾虚脱发怎么治疗	肾虚脱发怎么治辽
尿液混浊是怎么回事	尿夜混浊是怎么回事
什么是神经性尿频	什么是神精性尿频
坐月子可以洗澡吗	昨月子可以洗澡吗
人流挂哪个科	人流挂那个科
卫星锅分辨率	卫星锅分辩率
南通在哪个省	南通在那个省
支付宝可以买充值卡吗	支付宝可以卖充值卡吗
羊汤的做法	羊汤的作法
艾灸的时间	艾灸得时间
吃什么补肾虚	吃什么不肾虚
什么是挂靠户口	什么事挂靠户口
吃榴莲能喝酒吗	吃榴连能喝酒吗
什么是腔梗	什么是呛梗
宝宝一直流鼻涕怎么办	宝宝一直留鼻涕怎么办
如何治疗打呼噜	如何治疗大呼噜
怀孕第一个月有什么反应	怀孕第一个月有什么反映
慢性胃炎怎么调理	慢行胃炎怎么调理
脚底长鸡眼	脚底张鸡眼
什么是更年期	什麼是更年期
手被油烫了怎么办	手背油烫了怎么办
活血化瘀中成药有哪些	活血化瘀中成药有那些
买房子上什么网	卖房子上什么网
便血有哪些原因	便血有那些原因
西瓜和桃子能一起吃吗	西瓜合桃子能一起吃吗
手腕酸痛是怎么回事	手湾酸痛是怎么回事
来大姨妈吃什么水果	来大姨妈吃什麼水果
如何注册微信号	如和注册微信号
历史朝代表	历时朝代表
经常放屁是怎么回事	经常方屁是怎么回事
焦虑症的症状	焦虑症的症壮
查乙肝五项需要空腹吗	差乙肝五项需要空腹吗
食物中毒症状	食物种毒症状
打饱嗝是什么原因	打饱隔是什么原因
葡萄的功效	葡萄的公效
罗密欧与茱莉叶钢琴曲教程	罗密欧与朱丽叶钢琴曲教程
大便解不出来怎么办	大便接不出来怎么办
喝红茶上火吗	和红茶上火吗
来例假可以拔牙吗	来历假可以拔牙吗
慢性胃炎可以吃苹果吗	漫性胃炎可以吃苹果吗
双侧肾盂未见明显分离是什么意思	双测肾盂未见明显分离是什么意思
手爆皮是怎么回事	手报皮是怎么回事
喝酒就拉肚子是怎么回事	喝酒酒拉肚子是怎么回事
仰卧起坐能减肚子吗	仰卧起做能减肚子吗
白矾的功效与作用	百矾的功效与作用
肉苁蓉怎么泡酒	肉苁蓉怎么炮酒
肺炎吃什么药	费炎吃什么药
照片改背景颜色	照片该背景颜色
招行信用卡怎么样	招行信用卡怎么养
大便时出血是怎么回事	大便是出血是怎么回事
绝味鸭脖加盟费多少	决味鸭脖加盟费多少
戴避孕套会怀孕吗	带避孕套会怀孕吗
小鸟叼生日	小鸟刁生日
家常菜都有哪些	家常菜都有那些
孕晚期能吃方便面吗	孕晚期能吃放便面吗
月亮的别称	月亮得别称
回首掏出处	回手掏出处
三视图怎么画	三视图怎么花
孕妇能吃蒲地蓝消炎口服液吗	孕妇能吃蒲地兰消炎口服液吗
早上空腹喝蜂蜜水好吗	早上空腹和蜂蜜水好吗
公民应怎样依法行使权力	公民应怎样依法行使权利
女人吃榴莲有什么好处	女人吃榴莲又什么好处
肌肉腿怎么瘦	肌肉腿怎么收
补脾胃的食物有哪些	补脾胃的食物有那些
糜烂型脚气	糜烂形脚气
月经来了能吃芒果吗	月经来了能吃茫果吗
拔火罐可以去湿气吗	把火罐可以去湿气吗
交通罚款网上怎么缴费	交通罚款网上怎么交费
老是拉肚子是怎么回事	老是垃肚子是怎么回事
打耳洞疼吗	大耳洞疼吗
含植物的成语	喊植物的成语
肚子大怎么减肥	肚子打怎么减肥
怎样提高免疫力	怎样题高免疫力
湿气重的症状有哪些	湿气重的症状有那些
被马蜂蛰了怎么处理	被马蜂折了怎么处理
晚上咳的厉害是怎么回事	晚上咳得厉害是怎么回事
古代四大美女那几个	古代四大美女哪几个
拉的屎是黑色的	啦的屎是黑色的
脚被磨破皮怎么办	脚背磨破皮怎么办
孕妇可以吃泡面吗	孕妇可以吃泡面妈
心血管堵塞	新血管堵塞
专心的看叫什么视	专心的看叫什么是
烤瓷牙一颗多少钱	考瓷牙一颗多少钱
坐月子能不能吃方便面	做月子能不能吃方便面
玫瑰糠疹怎么治疗	玫瑰康疹怎么治疗
供血不足吃什么	公血不足吃什么
膝盖疼是怎么回事	膝盖疼是怎么会事
哺乳期可以喝酸奶吗	哺乳期可以和酸奶吗
怎么种白萝卜	怎么种白罗卜
吃什么长卵泡	吃什么张卵泡
感冒喝什么汤好	感冒和什么汤好
cad如何调线型	cad如何调线形
常州是属于哪个省	常州是属于那个省
拔罐拔出水泡怎么办	拔管拔出水泡怎么办
尖锐湿疣症状	尖锐湿尤症状
手被辣椒辣了怎么办	手被辣椒辣了怎么半
还能在长高吗	还能再长高吗
暑湿感冒吃什么药	署湿感冒吃什么药
肾结石可以喝红茶吗	肾结石可以和红茶吗
红塔山香烟哪里有买的	红塔山香烟哪里有卖的
小腿痒是怎么回事	小腿氧是怎么回事
拉不出来屎怎么办	拉不出来时怎么办
过期的药能吃吗	过起的药能吃吗
张子枫多大	章子枫多大
补中益气丸的功效	补中益气丸的工效
后背疼挂什么科	后辈疼挂什么科
补血的药物有哪些	补血得药物有哪些
额头上长小疙瘩	额头上张小疙瘩
喝豆浆有什么好处	和豆浆有什么好处
落枕脖子疼怎么办	洛枕脖子疼怎么办
喝奶茶失眠怎么办	和奶茶失眠怎么办
世界人口最多的国家是哪个	世界人口最多的国家是那个
戴隐形眼镜可以滴眼药水吗	带隐形眼镜可以滴眼药水吗
皮肤过敏痒怎么办	皮服过敏痒怎么办
枸杞子的功效与作用	苟杞子的功效与作用
慢性荨麻疹吃什么好	慢性寻麻疹吃什么好
颈椎疼怎么办	颈椎腾怎么办
王俊凯在重庆哪里	王俊凯在重庆那里
喝头孢能喝酒吗	和头孢能喝酒吗
多囊卵巢能怀孕吗	多囊乱巢能怀孕吗
来例假腰疼是怎么回事	来历假腰疼是怎么回事
为什么会得霉菌性阴炎	为什么会的霉菌性阴炎
静脉曲张怎么治	静迈曲张怎么治
菱形块怎么切	菱形快怎么切
石河子市属于哪个地区	石河子是属于哪个地区
连云港是哪个省	连云港是那个省
肺部结节怎么治疗	肺部结界怎么治疗
掉头发是什么原因	掉头发是什么愿因
太阳穴长痘怎么回事	太阳学长痘怎么回事
做心电图多少钱	作心电图多少钱
简笔画怎么画	简笔画怎么花
孕妇可以戴隐形眼镜吗	孕妇可以带隐形眼镜吗
心情不好怎么办	心请不好怎么办
阿胶小孩可以吃吗	阿娇小孩可以吃吗
怎么去螨虫	怎么去满虫
什么洗发水好	什么洗法水好
肾结石吃什么水果好	肾结石吃什麼水果好
怀孕初期可以吃橘子吗	怀孕初期可以吃桔子吗
坐飞机耳朵痛怎么办	做飞机耳朵痛怎么办
盆腔积液会影响怀孕吗	盆腔积液回影响怀孕吗
尿酸多少算痛风	尿酸多少算通风
冠心病症状	冠新病症状
天猫京东哪个好	天猫京东那个好
黑头怎么去掉	黒头怎么去掉
拔罐起泡是怎么回事	拔管起泡是怎么回事
手指上长小水泡	手指上张小水泡
八月二十七日是什么星座	八月二十七日是什么星坐
坐飞机能带充电宝吗	做飞机能带充电宝吗
生理期能喝茶吗	生理期能和茶吗
扁桃体发炎吃什么药	变桃体发炎吃什么药
得了脂肪肝怎么办	的了脂肪肝怎么办
现在考驾照难吗	现在靠驾照难吗
肠胃不好怎么调理	肠胃不好怎么调里
银耳的功效与作用	银儿的功效与作用
什么是躁郁症	什么是躁郁证
现在流行什么装修风格	现在留行什么装修风格
新生儿喉咙有痰怎么办	新生儿候咙有痰怎么办
神经衰弱如何治疗	神精衰弱如何治疗
打嗝是什么原因引起的	大嗝是什么原因引起的
咸鱼上怎么交易安全	闲鱼上怎么交易安全
慢性浅表性胃炎伴糜烂	漫性浅表性胃炎伴糜烂
喉咙有异物怎么办	喉咙有异物怎么半
检查艾滋病多久出结果	检查爱滋病多久出结果
一个男人爱你的表现	一个男人爱你得表现
小孩长痱子怎么办	小孩张痱子怎么办
西葫芦成份	西葫芦成分
尿液有泡沫是怎么回事	尿液有泡末是怎么回事
得了癌症怎么办	的了癌症怎么办
麻椒和什么不能一起吃	辣椒和什么不能一起吃
麻椒和什么不能一起吃	辣椒和什么不能一起吃
麻椒和什么不能一起吃	辣椒和什么不能一起吃
麻椒和什么不能一起吃	辣椒和什么不能一起吃
麻椒和什么不能一起吃	辣椒和什么不能一起吃
麻椒和什么不能一起吃	辣椒和什么不能一起吃
麻椒和什么不能一起吃	辣椒和什么不能一起吃
老是放屁是怎么回事	老是放屁是怎麼回事
感冒嗓子哑	感冒桑子哑
慢性肾炎吃什么药	慢行肾炎吃什么药
什么的小溪	什麼的小溪
水果什么时候吃最好	水果什么时侯吃最好
胃疼还打嗝是怎么回事	胃疼还打隔是怎么回事
手脱皮怎么回事	手脱皮怎么会事
孕妇能吃橘子吗	孕妇能吃桔子吗
喝啤酒上火吗	和啤酒上火吗
动感单车减肥效果好吗	动敢单车减肥效果好吗
舞蹈的种类	舞蹈得种类
荨麻疹一到晚上就痒	寻麻疹一到晚上就痒
尿液发红怎么办	尿夜发红怎么办
心脏病的早期症状有哪些	心脏病的早期症状有那些
脚上长水泡怎么办	教上长水泡怎么办
肚子上的赘肉怎么减	肚子上的坠肉怎么减
没有反回键	没有返回键
乙肝病毒表面抗体阳性是什么意思	已肝病毒表面抗体阳性是什么意思
怎么通过随心贴登陆别人账号	怎么通过随心贴登录别人账号
幽门螺旋杆菌高温能杀死吗	优门螺旋杆菌高温能杀死吗
尿毒症的症状有哪些	尿毒症的症状有那些
梦到自己被狗咬	梦到自己背狗咬
缺维生素d的症状	却维生素d的症状
乙型肝炎表面抗体阳性是什么意思	乙行肝炎表面抗体阳性是什么意思
脚水肿是怎么回事	脚水中是怎么回事
拉肚子吃什么药	垃肚子吃什么药
驼背怎么矫正	驮背怎么矫正
远志的功效与作用	远制的功效与作用
脂肪肝是什么症状	脂肪肝是什么证状
治湿疹的药膏	制湿疹的药膏
如何补气血	入何补气血
神经衰弱的症状	神经衰弱的整状
人为什么会做梦	仁为什么会做梦
小孩几个月长牙	小孩几个月长呀
荨麻疹不能吃什么	荨麻诊不能吃什么
穿越火线名字	穿越火线名子
胃食管反流不能吃什么	胃食管返流不能吃什么
华为怎么给苹果无线充电	华为怎么给苹果无限充电
希腊属于哪个州	希腊属于那个州
吃避孕药月经会推迟多久	吃避孕要月经会推迟多久
宝宝贫血有什么症状	宝宝贫血有什么证状
淡奶油能做什么	淡奶油能做什麼
媳妇是怎么炼成的	媳妇是怎么练成的
拉肚子可以喝粥吗	拉肚子可以和粥吗
我国汛期最长的河流	我过汛期最长的河流
玫瑰花茶的功效与作用	玫瑰花茶得功效与作用
四川在哪个地震带	四川在那个地震带
怎么在网上交电费	怎么再网上交电费
a九十二s支持面部解锁嘛	a九十二s支持面部解锁码
跨国公司在经济全球化中的作用	跨过公司在经济全球化中的作用
荨麻疹是啥样的	寻麻疹是啥样的
怎样排除体内湿毒	怎样排出体内湿毒
结肠炎什么症状	结肠炎什么证状
经期可以喝菊花茶吗	经期可以喝菊花茶马
鼻子上的黑头怎么去掉	鼻子上得黑头怎么去掉
三角形的周长公式	三角形的周常公式
双相情感障碍有哪些临床表现	双向情感障碍有哪些临床表现
现在做什么小吃赚钱	现在坐什么小吃赚钱
先有鸡还是先有蛋	先有鸡还是先有单
怎么才能长高	怎么才能涨高
大便频繁是怎么回事	大便频烦是怎么回事
降尿酸的药有哪些	降尿酸的要有哪些
唾液可以传播艾滋病吗	唾液可以传播爱滋病吗
胀气的食物有哪些	帐气的食物有哪些
牙齿痛怎么办	牙吃痛怎么办
大拇指甲有竖纹是怎么回事	大姆指甲有竖纹是怎么回事
经常腹泻是什么原因	经常复泻是什么原因
做完双眼皮注意事项	做玩双眼皮注意事项
紫癜有什么症状	紫殿有什么症状
小朋友可以喝蜂蜜水吗	小朋友可以和蜂蜜水吗
刮痧后多久可以洗澡	刮痧後多久可以洗澡
新生儿可以喝葡萄糖吗	新生儿可以和葡萄糖吗
胃疼喝蜂蜜水有用吗	胃疼和蜂蜜水有用吗
心率不齐怎么办	心率不气怎么办
刑法的年龄	刑罚的年龄
脚磨起泡了怎么办	脚磨气泡了怎么办
口臭是怎么回事	口臭是怎么会事
室性早搏算不算心脏病	室性早博算不算心脏病
嗓子疼怎么回事	嗓子疼怎麼回事
有痰咳不出怎么办	有谈咳不出怎么办
甲状腺结节的危害	甲状腺结节的威害
孩子脸上有白斑是怎么回事	孩子脸上又白斑是怎么回事
筋断了吃什么好得快	筋断了吃什么好的快
人工流产需要多少钱	人工流产许要多少钱
剖腹产坐月子注意事项	剖腹产做月子注意事项
牛黄上清片的功效与作用	牛黄上青片的功效与作用
lol登陆不进去	lol登录不进去
带状疱疹是怎么引起的	带壮疱疹是怎么引起的
减肥药有哪些危害	减肥药有那些危害
感冒喉咙痛吃什么药好	感冒吼咙痛吃什么药好
汇集英文	汇聚英文
银行卡怎么激活	银行卡怎么几活
不可想象不能理解的成语	不可想像不能理解的成语
糖尿病并发症有哪些	糖尿病屏发症有哪些
糖尿病并发症有哪些	糖尿病屏发症有哪些
糖尿病并发症有哪些	糖尿病屏发症有哪些
糖尿病并发症有哪些	糖尿病屏发症有哪些
糖尿病并发症有哪些	糖尿病屏发症有哪些
糖尿病并发症有哪些	糖尿病屏发症有哪些
糖尿病并发症有哪些	糖尿病屏发症有哪些
糖尿病并发症有哪些	糖尿病屏发症有哪些
糖尿病并发症有哪些	糖尿病屏发症有哪些
糖尿病并发症有哪些	糖尿病屏发症有哪些
糖尿病并发症有哪些	糖尿病屏发症有哪些
糖尿病并发症有哪些	糖尿病屏发症有哪些
糖尿病并发症有哪些	糖尿病屏发症有哪些
糖尿病并发症有哪些	糖尿病屏发症有哪些
喝什么可以去湿气	和什么可以去湿气
日元兑人民币汇率今日	日元对人民币汇率今日
分泌性中耳炎怎么治疗	分密性中耳炎怎么治疗
来月经可以喝蜂蜜水吗	来月经可以呵蜂蜜水吗
买理财产品有风险吗	卖理财产品有风险吗
湖南大学那些专业比较好	湖南大学哪些专业比较好
经期能喝茶吗	经期能和茶吗
结扎了还能接上吗	接扎了还能接上吗
梦见下大雪	梦见吓大雪
蛋白质食物有哪些	蛋白质食物有那些
怀孕肚子胀怎么回事	怀孕肚子帐怎么回事
华为手机如何截屏	华维手机如何截屏
手机刷机怎么刷	手机耍机怎么刷
牙痛怎么治	牙痛怎么制
红霉素眼膏可以涂嘴唇吗	红梅素眼膏可以涂嘴唇吗
尿道感染吃什么消炎药	尿到感染吃什么消炎药
小孩腿抽筋	小孩退抽筋
霍金得的什么病	霍金得得什么病
苹果手机怎么改字体	苹果手机怎么改自体
空腹喝牛奶好吗	空服喝牛奶好吗
怎么删除淘宝订单	怎么删除陶宝订单
怎样快速瘦脸	怎样快速受脸
不吃早餐的危害	不吃早餐的威害
交大mpa学费	交大mba学费
交大mpa学费	交大mba学费
交大mpa学费	交大mba学费
交大mpa学费	交大mba学费
交大mpa学费	交大mba学费
交大mpa学费	交大mba学费
交大mpa学费	交大mba学费
交大mpa学费	交大mba学费
交大mpa学费	交大mba学费
交大mpa学费	交大mba学费
交大mpa学费	交大mba学费
交大mpa学费	交大mba学费
交大mpa学费	交大mba学费
交大mpa学费	交大mba学费
怎么开微店	怎么凯微店
心梗的症状有哪些症状	心埂的症状有哪些症状
甲状腺结节怎么治	甲状腺结节怎么制
中暑会肚子疼吗	中署会肚子疼吗
甲状腺回声不均匀是什么意思	甲状腺回升不均匀是什么意思
重庆都有哪些好玩的地方	重庆都有那些好玩的地方
皮肤癌有哪些症状	皮肤癌有那些症状
新生儿打嗝怎么办	心生儿打嗝怎么办
肺里有结节	肺里有节节
一直打嗝怎么办	一直大嗝怎么办
胰腺炎的症状是什么	胰腺炎的证状是什么
血清阳性是什么意思	血青阳性是什么意思
尖锐湿疣的症状	尖锐湿疣的正状
华山是哪个市	华山是那个市
坐骨神经痛症状	坐骨神经痛证状
病毒性疱疹怎么治疗	病毒性泡疹怎么治疗
桂圆的功效与作用	桂员的功效与作用
怀孕怎么分辨男女	怀孕怎么分变男女
胃炎有什么症状	胃炎有什么证状
肠虫清怎么吃	长虫清怎么吃
经常腹泻是怎么回事	经常复泻是怎么回事
谷歌怎么注册账号	谷歌怎么注册帐号
怀孕可以喝豆浆吗	怀孕可以和豆浆吗
月经期可以敷面膜吗	月经期可以肤面膜吗
糖尿病能活多久	唐尿病能活多久
缥缈的释义	飘渺的释义
胃食管反流吃什么药	胃食馆反流吃什么药
先有鸡还是先有蛋	先右鸡还是先有蛋
血氧饱和度正常值	血养饱和度正常值
青霉素和头孢那个好	青霉素和头孢哪个好
什么是世界文化遗产	什么事世界文化遗产
腊七腊八冻死寒鸦的意思	蜡七腊八冻死寒鸦的意思
什么的波纹	什么得波纹
癣会传染吗	显会传染吗
什么是定向流量	什么是订向流量
社区戒毒期限	社区介毒期限
张杰她老婆是谁	张杰他老婆是谁
是什么动物	似什么动物
世上最小的国家	史上最小的国家
来例假能洗澡吗	来历假能洗澡吗
变形金刚人物	变形金钢人物
双侧卵巢多囊	双测卵巢多囊
名牌裤子有哪些	明牌裤子有哪些
回奶的食物有哪些	会奶的食物有哪些
身上长红痣是怎么回事	身上张红痣是怎么回事
血小板低的症状	血小板低得症状
膝盖响怎么回事	希盖响怎么回事
莲子的功效与作用	莲子的工效与作用
大便不成形的原因	大变不成形的原因
护士转行可以做什么	护士转型可以做什么
打完玻尿酸多久可以洗脸	打完波尿酸多久可以洗脸
芦荟可以直接擦脸吗	芦会可以直接擦脸吗
星座按阴历还是阳历算	星座安阴历还是阳历算
如何治疗脑梗	如何治疗脑埂
榴莲的营养价值	留莲的营养价值
淘宝运费险怎么买	淘宝运费险怎么卖
贫血怎么办	贫血怎么半
脚底长刺猴怎么治	脚底长刺瘊怎么治
视网膜脱落	是网膜脱落
坏蛋是怎样炼成的	坏蛋是怎样连成的
转氨酶高的原因	转安酶高的原因
爱默生是哪国人	艾默生是哪国人
蟑螂会咬人吗	蟑螂回咬人吗
前列腺增生吃什么药	前裂腺增生吃什么药
什么游戏好玩	什么游戏好晚
流清鼻涕吃什么药	留清鼻涕吃什么药
行车记录仪什么牌子好	行车纪录仪什么牌子好
氯化钠是不是生理盐水	录化钠是不是生理盐水
眼线怎么画	眼线怎么话
什么的目光	什麼的目光
口臭是什么原因引起的	口臭是什麼原因引起的
无痛人流要多少钱	无通人流要多少钱
嘴唇上长泡怎么办	嘴唇上长疱怎么办
百香果的功效	百香果得功效
怎么才能长高	怎麼才能长高
精神分裂症吃什么药最好	精神分裂证吃什么药最好
支气管炎怎么治疗	支气官炎怎么治疗
什么是天堂	什么事天堂
黄疸型肝炎的症状	黄疸行肝炎的症状
把什么比作什么	把什么比做什么
孕妇能吃枸杞叶吗	孕妇能吃狗杞叶吗
神经官能症的治疗	神经管能症的治疗
吃红糖会发胖吗	吃红唐会发胖吗
月经期间可以吃薏米吗	月经期间可以吃苡米吗
甲状腺结节有什么症状	甲装腺结节有什么症状
什么是心率不齐	什么事心率不齐
丙型肝炎的症状	丙性肝炎的症状
息屏时间	熄屏时间
验孕棒怎么看	验晕棒怎么看
小孩几岁换牙	小骇几岁换牙
无线鼠标没反应	无限鼠标没反应
什么原因导致的甲亢	什么原因导致得甲亢
感冒能吃橘子吗	感冒能吃桔子吗
涨肚子怎么办	胀肚子怎么办
手机怎么登录腾讯会员	手机怎么登入腾讯会员
手机怎么登录腾讯会员	手机怎么登入腾讯会员
手机怎么登录腾讯会员	手机怎么登入腾讯会员
手机怎么登录腾讯会员	手机怎么登入腾讯会员
手机怎么登录腾讯会员	手机怎么登入腾讯会员
手机怎么登录腾讯会员	手机怎么登入腾讯会员
手机怎么登录腾讯会员	手机怎么登入腾讯会员
手机怎么登录腾讯会员	手机怎么登入腾讯会员
手机怎么登录腾讯会员	手机怎么登入腾讯会员
月经期能吃芒果吗	月经期能吃忙果吗
最好的避孕方法	最好得避孕方法
流鼻涕咳嗽	留鼻涕咳嗽
尿毒症有什么症状	尿毒证有什么症状
信用卡哪个银行的最好	信用卡那个银行的最好
支原体感染是什么意思	支愿体感染是什么意思
颈纹怎么消除	颈纹怎么消处
无线鼠标推荐	无限鼠标推荐
大便变细是怎么回事	大便便细是怎么回事
糖尿病可以吃胡萝卜吗	糖尿病可以吃胡罗卜吗
京东优惠卷怎么兑换	京东优惠劵怎么兑换
牙齿牙根发黑怎么回事	牙齿压根发黑怎么回事
哪些动物是气象员	那些动物是气象员
怎样消除黑眼圈	怎样消出黑眼圈
月经期间可以打消炎针吗	月经其间可以打消炎针吗
如何戴假发	如何带假发
吃什么能提高免疫力	吃什么能提高勉疫力
尿酸高是怎么回事	尿酸高是怎么回是
戴牙套怎么刷牙	带牙套怎么刷牙
余秋雨的作品	于秋雨的作品
哺乳期感冒可以喝板蓝根吗	哺乳期感冒可以和板蓝根吗
宫颈糜烂有哪些症状	宫颈糜烂有那些症状
做散瞳对眼睛有伤害吗	做散童对眼睛有伤害吗
怀孕初期可以吃西瓜吗	怀孕出期可以吃西瓜吗
真分数和假分数	真分数和贾分数
学生什么时候放假	学生什么时侯放假
豆浆机什么牌子的好	豆将机什么牌子的好
医用外科口罩一次能戴多久	医用外科口罩一次能带多久
得了肾炎怎么办	的了肾炎怎么办
胆汁反流性胃炎的症状	胆汁反流性胃炎的证状
水星无线路由器如何恢复出场设置	水星无线路由器如何恢复出厂设置
乳腺结节需要手术吗	乳腺结节须要手术吗
颈部淋巴结肿大	颈部淋巴节肿大
怎么测怀孕	怎么册怀孕
怎么把胸变大	怎么把熊变大
微信怎么查聊天记录	微信怎么查聊天纪录
猫一年生几胎	猫一年生几台
补中益气丸的功效	补中一气丸的功效
抑郁症怎么治疗	意郁症怎么治疗
小腹隐隐作痛是什么原因	小腹隐隐做痛是什么原因
中国最大的鱼具市场	中国最大的渔具市场
孕妇可以拔罐吗	孕妇可以拔罐妈
梦见自己生孩子	梦见自几生孩子
老年性皮肤瘙痒症	老年性皮肤瘙痒证
补气血的药有哪些	补气血的药有那些
子宫肌瘤能吃鸡肉吗	子宫几瘤能吃鸡肉吗
慢性胃炎可以吃鱼子吗	慢性胃炎可以吃鱼籽吗
菠菜和鸡蛋能一起吃吗	波菜和鸡蛋能一起吃吗
逍遥丸什么时候吃好	消遥丸什么时候吃好
夏桑菊颗粒的作用	夏嗓菊颗粒的作用
脾虚湿气重吃什么药	脾需湿气重吃什么药
手上长鸡眼	手上涨鸡眼
喝阿莫西林能喝酒吗	喝啊莫西林能喝酒吗
高血压吃什么药	高学压吃什么药
活血化瘀的药有哪些	活血化瘀的要有哪些
胸部胀痛是不是怀孕了	胸部帐痛是不是怀孕了
社保能补缴十五年吗	社保能补交十五年吗
范冰冰用什么面膜	犯冰冰用什么面膜
脸上长斑怎么办	连上长斑怎么办
怎么才能的高分	怎么才能得高分
做核磁共振要多少钱	做和磁共振要多少钱
心肌酶高怎么办	心机酶高怎么办
梦中的婚礼简谱	梦中的婚礼间谱
手搓冰粉的做法	手挫冰粉的做法
猫可以吃橘子吗	猫可以吃桔子吗
半边头痛是怎么回事	办边头痛是怎么回事
膀胱炎有什么症状	旁胱炎有什么症状
手指关节痛怎么治疗	手只关节痛怎么治疗
大便不成型是直肠癌吗	大便不成形是直肠癌吗
内分泌失调怎么检查	内分泌时调怎么检查
精索静脉曲张的症状	精锁静脉曲张的症状
东革阿里的功效与作用	东格阿里的功效与作用
跑步能减肥吗	跑不能减肥吗
胡萝卜怎么做好吃	胡罗卜怎么做好吃
细腻绵长是什么意思	细密绵长是什么意思
细腻绵长是什么意思	细密绵长是什么意思
细腻绵长是什么意思	细密绵长是什么意思
细腻绵长是什么意思	细密绵长是什么意思
细腻绵长是什么意思	细密绵长是什么意思
细腻绵长是什么意思	细密绵长是什么意思
细腻绵长是什么意思	细密绵长是什么意思
细腻绵长是什么意思	细密绵长是什么意思
细腻绵长是什么意思	细密绵长是什么意思
细腻绵长是什么意思	细密绵长是什么意思
细腻绵长是什么意思	细密绵长是什么意思
细腻绵长是什么意思	细密绵长是什么意思
细腻绵长是什么意思	细密绵长是什么意思
什么是艾滋病	什麼是艾滋病
感冒鼻塞吃什么好得快	感冒鼻塞吃什么好的快
微信号怎么改	维信号怎么改
孕妇为什么会孕吐	孕妇为什么回孕吐
密集恐惧症怎么治疗	密极恐惧症怎么治疗
奥美拉唑是饭前吃还是饭后吃	奥美拉唑是饭钱吃还是饭后吃
乳腺癌手术后能活多久	乳现癌手术后能活多久
甲状腺肿大的症状	甲状腺肿大得症状
不消化肚子胀怎么办	不消化肚子涨怎么办
慢性浅表性胃炎伴糜烂	慢性浅表性胃炎半糜烂
咽喉癌的症状	咽喉癌的证状
痛风可以喝豆奶吗	通风可以喝豆奶吗
怎么去除地板上的乳胶漆	怎么祛除地板上的乳胶漆
朦拼音带组词	蒙拼音带组词
做胃镜需要空腹吗	作胃镜需要空腹吗
打喷嚏流鼻涕吃什么药	打喷嚏留鼻涕吃什么药
环保手抄报内容	环保手抄包内容
人生是什么	认生是什么
好听的女生英文名	好听得女生英文名
新生儿一天喝多少水	新生儿一天和多少水
眼皮上长麦粒肿怎么办	眼皮上张麦粒肿怎么办
月经量少影响怀孕吗	月经亮少影响怀孕吗
如和培养小孩的学习兴趣	如何培养小孩的学习兴趣
拉肚子喝藿香正气水管用吗	拉肚子和藿香正气水管用吗
新生儿打嗝怎么办	新生儿打隔怎么办
心电图导联位置	心点图导联位置
怎样去皱纹	怎样去绉纹
血管性头痛吃什么药	血官性头痛吃什么药
宝宝吃什么素菜好	宝宝吃什么蔬菜好
宝宝吃什么素菜好	宝宝吃什么蔬菜好
宝宝吃什么素菜好	宝宝吃什么蔬菜好
宝宝吃什么素菜好	宝宝吃什么蔬菜好
宝宝吃什么素菜好	宝宝吃什么蔬菜好
宝宝吃什么素菜好	宝宝吃什么蔬菜好
宝宝吃什么素菜好	宝宝吃什么蔬菜好
宝宝吃什么素菜好	宝宝吃什么蔬菜好
宝宝吃什么素菜好	宝宝吃什么蔬菜好
宝宝吃什么素菜好	宝宝吃什么蔬菜好
如何去皱纹	如何去皱问
查过敏源怎么查	查过敏原怎么查
奥得力是什么意思	奥得利是什么意思
为什么坐车脚会肿	为什么座车脚会肿
淋巴结发炎怎么办	淋巴杰发炎怎么办
皮肤过敏的症状	皮肤过敏的正状
嘴巴周围长痘	最巴周围长痘
怎么在微信上卖东西	怎么在微信上买东西
怎样利用网络赚钱	怎样立用网络赚钱
哪个星座男人最好	那个星座男人最好
小提琴琴拖怎么安装	小提琴琴托怎么安装
乳腺癌是什么症状	乳线癌是什么症状
怀孕会肚子疼吗	怀孕回肚子疼吗
膝关节韧带损伤	膝关节忍带损伤
额头和下巴长痘是什么原因	额头和下巴长豆是什么原因
火龙果可以减肥吗	火笼果可以减肥吗
微信密码忘记了怎么办	薇信密码忘记了怎么办
胆结石能喝牛奶吗	胆节石能喝牛奶吗
怀孕初期有什么反应	怀孕初期有什么反映
脚趾头痒是怎么回事	脚只头痒是怎么回事
开塞露可以擦脸吗	开塞路可以擦脸吗
请假条的格式	请加条的格式
小情歌吉他谱	小情歌吉它谱
激光去痣多少钱	激光取痣多少钱
葵花籽致癌吗	葵花籽治癌吗
太阳穴长痘怎么回事	太阳穴长痘怎么会事
经常放屁是怎么回事	经常放屁事怎么回事
有哪些好看的动漫电影	有那些好看的动漫电影
哺乳期可以吃桃子吗	哺乳期可以吃桃子妈
孕妇可以吃生蚝吗	孕妇可以吃生蚝妈
人流后多久来月经	人留后多久来月经
胃里反酸水	胃里范酸水
手机如何快速充电	手机如何快速冲电
变异型哮喘	变异性哮喘
女性内分泌失调吃什么药	女姓内分泌失调吃什么药
宝宝肚子有虫的症状	宝宝肚子又虫的症状
下肢静脉曲张的治疗	下支静脉曲张的治疗
乳腺肿块吃什么药	乳线肿块吃什么药
红霉素软膏的作用	红霉素软高的作用
莓菌性阴炎怎么根冶	莓菌性阴炎怎么跟冶
党员有哪些权利	党员有那些权利
酒醉的蝴蝶是谁作的曲	酒醉的蝴蝶是谁做的曲
胃溃疡的症状有哪些	胃溃疡的证状有哪些
左胸疼是怎么回事	昨胸疼是怎么回事
肝脏不好有什么症状	肝脏不好有什么正状
什么是皮肤病	什么事皮肤病
咳嗽有黄痰吃什么药	咳嗽有黄谈吃什么药
脖子痒是怎么回事	脖子痒是怎么会事
颈部淋巴结肿大	颈部琳巴结肿大
蜂蜜水什么时候喝好	蜂蜜水什么时候和好
嘉兴哪里有好玩的地方	嘉兴那里有好玩的地方
下腹痛怎么回事	下复痛怎么回事
关节松动术的适应证	关节松动术的适应症
孕妇可以打狂犬疫苗吗	孕妇可以大狂犬疫苗吗
淋巴在哪个位置	淋巴在那个位置
处女膜没破会怀孕吗	初女膜没破会怀孕吗
腰肌劳损有哪些症状	腰肌老损有哪些症状
声字的笔顺笔画	声字的笔顺笔划
长痘痘可以敷面膜吗	张痘痘可以敷面膜吗
眼睛流泪怎么治	眼睛流泪怎么制
流鼻涕打喷嚏是什么感冒	流鼻涕打喷涕是什么感冒
胃不好喝什么	胃不好和什么
怀孕多久有胸胀的感觉	怀孕多久有胸涨的感觉
甲状腺球蛋白抗体高是什么意思	甲壮腺球蛋白抗体高是什么意思
小儿脾胃虚弱怎么调理	小二脾胃虚弱怎么调理
肩周炎看哪个科室	肩周炎看那个科室
身体水分低怎么回事	身体水份低怎么回事
甲状腺结节是什么	甲状线结节是什么
怎样去疤痕	怎样去巴痕
肝脏的功能	肝脏得功能
促甲状腺激素受体抗体	促甲壮腺激素受体抗体
藕尖的作法	藕尖的做法
新鲜百合怎么吃	新鲜白合怎么吃
怎样联系记者	怎样联系记着
孕妇可以吃桔子吗	孕妇可以吃橘子吗
肺有结节怎么回事	肺有节节怎么回事
中暑的急救方法	重暑的急救方法
红色经典书籍	红色精典书籍
血液粘稠吃什么药	血液沾稠吃什么药
喝可乐有什么危害	和可乐有什么危害
艾滋病的传播途径有哪些	艾滋病得传播途径有哪些
水痘结痂几天能掉	水痘结痂几天能钓
体检心率不齐	体检心律不齐
绍兴有哪些高中	绍兴有那些高中
下奶的食物有哪些	下奶的实物有哪些
血糖高的人能吃橘子吗	血糖高的人能吃桔子吗
节育环什么时候取合适	节育环什么时候去合适
微博国际版登录不了	微博国际版登陆不了
黄斑水肿怎么治疗	黄班水肿怎么治疗
竖折折钩怎么写	竖折折勾怎么写
卡莎哪个皮肤	卡沙哪个皮肤
低血压吃什么可以补	滴血压吃什么可以补
长春搬家公司哪家好	长春搬家公司那家好
银行一般几点上班	银行一搬几点上班
可以找公司代缴社保吗	可以找公司代交社保吗
怎么治口臭	怎么知口臭
两月二十七日是什么星座	两月二十七日是什么星坐
前额胀痛是什么原因	前额帐痛是什么原因
橄榄油的功效与作用	橄兰油的功效与作用
恐龙是怎么死的	孔龙是怎么死的
血糖偏高怎么办	血唐偏高怎么办
粉底液哪个牌子好	粉底液那个牌子好
来例假能喝中药	来历假能喝中药
洋芋粑粑的做法	洋芋粑粑的作法
全国都带头盔吗	全国都戴头盔吗
什么时候用have	什么时侯用have
肾炎的症状	肾炎得症状
银耳汤的功效与作用	银儿汤的功效与作用
苹果云端在哪里登录	苹果云端在哪里登陆
头孢是抗生素吗	头孢事抗生素吗
包皮手术多少钱	抱皮手术多少钱
倒瓜子脸适合什么发型	到瓜子脸适合什么发型
怀孕能吃淮山吗	怀孕能吃怀山吗
月经期可以吃阿胶吗	月经期可以吃阿娇吗
小孩手脱皮是怎么回事	小孩手托皮是怎么回事
眼睛上长针眼	眼睛上张针眼
蚕的生长过程	蚕的生长过成
肾囊肿是什么	肾馕肿是什么
浑身冷不发烧怎么回事	混身冷不发烧怎么回事
三个月宝宝流清鼻涕怎么办	三个月宝宝流青鼻涕怎么办
什么是窦性心动过速	什么事窦性心动过速
吃阿胶糕的好处	吃阿胶糕得好处
什么食物含维生素d	什么实物含维生素d
高血压怎么治疗	高血压怎么治辽
鹦鹉怎么绝育	鹦鹉怎么节育
视神经萎缩	视神精萎缩
怎么搭配衣服好看	怎么打配衣服好看
烫伤了怎么办	烫伤了怎么半
北京的区号	背京的区号
脂肪肝有什么症状	脂防肝有什么症状
益母草的功效与作用	益母草的工效与作用
甲状腺炎症状	甲状线炎症状
怀男孩的症状	怀男孩的证状
副乳怎么消除才正确	附乳怎么消除才正确
杨幂和刘恺威真的复合了吗	杨幂和刘凯威真的复合了吗
微信怎么删除好友	微信怎么珊除好友
膀胱癌的症状	膀胱癌的证状
抑郁症如何治疗	抑郁正如何治疗
拉屎拉不出来怎么办	拉屎拉不出来怎么半
类风湿关节炎吃什么药	类凤湿关节炎吃什么药
达克宁治脚气吗	达客宁治脚气吗
今天阴历几号	今天阴里几号
剖腹产坐月子能吃虾吗	剖腹产做月子能吃虾吗
乙型肝炎病毒核心抗体	乙性肝炎病毒核心抗体
做无痛胃镜要多少钱	作无痛胃镜要多少钱
痛经能喝红糖水吗	痛经能和红糖水吗
坐骨神经痛是怎么回事	做骨神经痛是怎么回事
慢性咽炎的症状	慢性咽严的症状
脸上长痤疮怎么治疗	脸上张痤疮怎么治疗
下巴长痘痘的原因	下疤长痘痘的原因
淋巴结怎么治疗	淋吧结怎么治疗
来月经可以喝红枣枸杞吗	来月经可以和红枣枸杞吗
办健康证需要空腹吗	班健康证需要空腹吗
糖尿病可以吃黄瓜吗	塘尿病可以吃黄瓜吗
怎么卸假睫毛	怎么卸甲睫毛
乙肝有哪些症状	已肝有哪些症状
肩袖损伤的治疗方法	肩秀损伤的治疗方法
子宫疼怎么回事	字宫疼怎么回事
阿胶膏的副作用	阿胶糕的副作用
员工请假条怎么写	员工清假条怎么写
黑头怎么去掉	黑头怎么取掉
流产后可以喝红糖水吗	流产后可以和红糖水吗
芦荟可以直接涂在脸上吗	芦会可以直接涂在脸上吗
做什么生意好呢	作什么生意好呢
c三十怎么登录	c三十怎么登陆
绿豆糕的做法	绿豆糕的作法
电脑坏了怎么修	电脑坏了怎么休
戴隐形眼镜可以睡午觉吗	带隐形眼镜可以睡午觉吗
什么食物降血糖	什么食物将血糖
乳房疼是怎么回事	乳妨疼是怎么回事
生肖三合是什么意思	生肖三和是什么意思
南京哪最好玩	南京那最好玩
两边肋骨痛是什么原因	两边勒骨痛是什么原因
抑郁症能治愈吗	抑郁证能治愈吗
新生儿黄疸值多少正常	新生儿黄疸直多少正常
宫寒的症状有哪些	宫寒的症状有那些
青岛和大连哪个好	青岛和大连那个好
哺乳期可以吃李子吗	哺乳期可以吃李子妈
大三阳是什么	大三样是什么
频发室性早搏三联律	频发室性早搏三联率
抗甲状腺球蛋白抗体高怎么办	康甲状腺球蛋白抗体高怎么办
肾阴虚吃什么药	身阴虚吃什么药
刷牙时牙龈出血怎么办	刷牙是牙龈出血怎么办
孕妇拉肚子怎么办	孕妇拉肚子怎么半
开塞露怎么用	开赛露怎么用
舌苔厚腻是怎么回事	舌台厚腻是怎么回事
上腹胀是什么原因	上腹帐是什么原因
什么浏览器好用	什么流览器好用
甲状腺结节钙化是怎么回事	甲状腺结节丐化是怎么回事
避孕药安全吗	比孕药安全吗
怎样种植芹菜	怎样种值芹菜
来月经可以喝蜂蜜水吗	来月经可以喝蜂密水吗
荨麻疹是怎么引起来的	寻麻疹是怎么引起来的
卡布奇诺是什么意思	卡布其诺是什么意思
左胸下方是什么器官	左胸下放是什么器官
什么时候清明节	什么时侯清明节
甲状腺癌术后能活多久	胛状腺癌术后能活多久
刮痧多久刮一次	刮痧多久挂一次
我的世界怎么去天堂	我的世界怎么去天唐
奥美拉唑是饭前吃还是饭后吃	奥美拉做是饭前吃还是饭后吃
哪些网站可以免费发布信息	那些网站可以免费发布信息
家用血压计哪种好	家用血压计那种好
小孩打喷嚏流鼻涕吃什么药	小孩打喷涕流鼻涕吃什么药
咳嗽艾灸哪个穴位	咳嗽艾灸那个穴位
冬天荨麻疹	冬天寻麻疹
血糖高吃什么水果	学糖高吃什么水果
单唾液酸四己糖神经节苷脂钠	单唾液酸四几糖神经节苷脂钠
脑动脉硬化怎么治疗	闹动脉硬化怎么治疗
阿迪达斯的标志	阿迪达斯得标志
肺癌的治疗方法	肺癌的制疗方法
橙子糖分高吗	橙子糖粉高吗
十到三十之间的合数	十到三十之间的和数
扁桃体发炎化脓吃什么药	扁桃体发炎化浓吃什么药
老流鼻血怎么回事	老留鼻血怎么回事
腰疼针灸有用吗	腰疼针久有用吗
女性尿结石的症状	女姓尿结石的症状
深圳有什么好玩的地方	深圳有什么好完的地方
邵阳属哪个地区	邵阳是哪个地区
荨麻疹不能吃什么食物	荨麻诊不能吃什么食物
乳腺增生能不能吃蜂蜜	乳腺增升能不能吃蜂蜜
大便黑是怎么回事	大便黒是怎么回事
月经淋漓不尽怎么办	月经淋离不尽怎么办
支气管发炎怎么办	支汽管发炎怎么办
舌苔厚腻是怎么回事	舌态厚腻是怎么回事
张子枫多大	张子风多大
怎样申请微信号	怎样身请微信号
做梦梦见鬼	做梦梦见贵
陈字偏旁是什么	陈字边旁是什么
陈字偏旁是什么	陈字边旁是什么
陈字偏旁是什么	陈字边旁是什么
陈字偏旁是什么	陈字边旁是什么
陈字偏旁是什么	陈字边旁是什么
陈字偏旁是什么	陈字边旁是什么
陈字偏旁是什么	陈字边旁是什么
陈字偏旁是什么	陈字边旁是什么
陈字偏旁是什么	陈字边旁是什么
陈字偏旁是什么	陈字边旁是什么
陈字偏旁是什么	陈字边旁是什么
陈字偏旁是什么	陈字边旁是什么
陈字偏旁是什么	陈字边旁是什么
陈字偏旁是什么	陈字边旁是什么
小孩出水痘怎么办	小孩出水逗怎么办
吃方便面好吗	吃放便面好吗
陕西和四川有多远	山西和四川有多远
百合的功效与作用	百合的功效与做用
什么是更年期综合症	什么是更年期综合证
扑克牌的花色	扑克排的花色
左下眼皮跳是怎么回事	左下眼皮条是怎么回事
孕妇拉肚子怎么办	孕妇啦肚子怎么办
流产后的注意事项	流产后的住意事项
决明子的功效	决明子的功校
眼睛腿怎么调最合适	眼镜腿怎么调最合适
痔疮吃什么药好得快	痔疮吃什么药好的快
肺炎的症状	肺炎得症状
怀孕拉肚子怎么办	怀孕垃肚子怎么办
经常口腔溃疡是什么原因	经常口腔溃阳是什么原因
怎么治口臭	怎么只口臭
面膜过敏怎么办	面莫过敏怎么办
怎么数胎动	怎么书胎动
什么是甲状腺结节	什么是胛状腺结节
脚痒脱皮起水疱是怎么回事	脚痒脱皮起水泡是怎么回事
肚子涨是什么原因	肚子涨是什么愿因
气缸垫有哪些类型	汽缸垫有哪些类型
喉咙有痰是怎么回事	候咙有痰是怎么回事
写字的正确笔画	写字的正确笔划
月经推迟多久能测出怀孕	月经推迟多久能侧出怀孕
那里批发服装便宜	哪里批发服装便宜
五行缺土的女孩起名	五行缺土的女孩取名
来月经有血块是怎么回事	来月经又血块是怎么回事
长期吃安眠药	常期吃安眠药
伤口化脓怎么处理	伤口化浓怎么处理
大拇指疼怎么办	大姆指疼怎么办
尿道感染怎么治	尿到感染怎么治
甲状腺球蛋白抗体高是怎么回事	甲壮腺球蛋白抗体高是怎么回事
幼儿舌头长泡疹图	幼儿舌头长疱疹图
吃什么增强免疫力	吃什么增强勉疫力
拉的黑色的屎怎么回事	拉的黑色的是怎么回事
中耳炎吃什么药	种耳炎吃什么药
附近有什么好吃的	附近由什么好吃的
上环后会怀孕吗	上环后回怀孕吗
对月贴怎么写	对月帖怎么写
南州是什么地方	南洲是什么地方
青春痘疤痕怎么消除	青春豆疤痕怎么消除
记忆力差怎么办	记意力差怎么办
皮肤晒伤怎么办	皮夫晒伤怎么办
经常抠鼻子有什么坏处	经常扣鼻子有什么坏处
冷冻鳕鱼的做法	冷冻雪鱼的做法
榴莲有哪些品种	榴莲有那些品种
怎么申请支付宝账号	怎么申请支付宝帐号
剪映怎么设置视频封面	剪影怎么设置视频封面
肠胃炎可以吃橘子吗	肠胃炎可以吃桔子吗
做梦梦到猪仔	做梦梦到猪崽
如何注册淘宝账号	如何注册淘宝帐号
大姨妈期间能喝中药吗	大姨妈期间能和中药吗
怀孕mt检查	怀孕nt检查
怀孕mt检查	怀孕nt检查
怀孕mt检查	怀孕nt检查
怀孕mt检查	怀孕nt检查
怀孕mt检查	怀孕nt检查
怀孕mt检查	怀孕nt检查
怀孕mt检查	怀孕nt检查
怀孕mt检查	怀孕nt检查
怀孕mt检查	怀孕nt检查
怀孕mt检查	怀孕nt检查
怀孕mt检查	怀孕nt检查
怀孕mt检查	怀孕nt检查
怀孕mt检查	怀孕nt检查
脚背痒是怎么回事	教背痒是怎么回事
属马的是什么命	数马的是什么命
耳朵流水怎么办	耳多流水怎么办
怎样去除老年斑	怎样去除老年版
三围是哪三围	三维是哪三围
进入公会有什么用	进入工会有什么用
猕猴桃会上火吗	弥猴桃会上火吗
血糖高可以吃玉米吗	雪糖高可以吃玉米吗
什么是汗斑	什么是汉斑
双氧水洗耳朵	双阳水洗耳朵
背上长痘痘	辈上长痘痘
为什么脖子上长小肉粒	为什么勃子上长小肉粒
糖尿病可以吃玉米吗	塘尿病可以吃玉米吗
小孩得了荨麻疹怎么办	小孩得了寻麻疹怎么办
来月经可以喝豆浆吗	来月经可以和豆浆吗
李艺泽这个名字怎么样	李雨泽这个名字怎么样
新鲜莲子的功效与作用	新鲜连子的功效与作用
蒸汽机谁发明的	蒸器机谁发明的
月经有血块是怎么回事	月经又血块是怎么回事
脱式计算是什么	脱式记算是什么
多利妈是什么药	多力妈是什么药
黄芩的功效与作用	黄芩的功效与做用
增强记忆力的食物	增强计忆力的食物
来月经可以喝豆浆吗	来月经可以喝豆江吗
耳朵后面长疙瘩	耳朵后面长疙搭
怎样申请微信号	怎样伸请微信号
心肌缺血的症状	心肌缺血得症状
葡萄是热性还是凉性	葡萄是热性还是良性
口臭怎么办	口臭怎么半
摔伤了涂什么药好得快	摔伤了涂什么药好的快
拔牙多少钱	把牙多少钱
这是什么型号的	这是什么性号的
忽如一夜春风来千树万树梨花开是哪个季节	呼如一夜春风来千树万树梨花开是哪个季节
孕妇可以吃桂圆吗	孕妇可以吃桂元吗
盐城盛产盐吗	盐城生产盐吗
女的被男的叉什么感觉	女的被男的插什么感觉
下巴疼是怎么回事	下把疼是怎么回事
大便不成型	大便不成性
南瓜怎么做好吃	难瓜怎么做好吃
凌志nx三百报价	凌志rx三百报价
凌志nx三百报价	凌志rx三百报价
凌志nx三百报价	凌志rx三百报价
凌志nx三百报价	凌志rx三百报价
凌志nx三百报价	凌志rx三百报价
凌志nx三百报价	凌志rx三百报价
凌志nx三百报价	凌志rx三百报价
艾灸盒怎么用	艾久盒怎么用
猴属什么生肖	猴是什么生肖
小孩经常流鼻血怎么办	小孩经长流鼻血怎么办
外阴瘙痒用什么药好	外因瘙痒用什么药好
拉肚子可以喝茶吗	啦肚子可以喝茶吗
脚底长水泡是什么原因	脚底长水疱是什么原因
吃什么药来月经	吃什么要来月经
现在什么电视剧好看	先在什么电视剧好看
老是打喷嚏是怎么回事	老是打喷涕是怎么回事
吃橘子会胖吗	吃桔子会胖吗
哪种减肥药安全有效	那种减肥药安全有效
嘴巴周围长痘	嘴吧周围长痘
小孩剪什么发型好看	小孩减什么发型好看
手机号码注销了微信怎么登陆	手机号码注销了微信怎么登录
嗜酸性粒细胞偏低	是酸性粒细胞偏低
喝什么降血糖	喝什么将血糖
怀孕一个月可以药流吗	怀孕一个月可以药留吗
做仰卧起坐能减肥吗	做仰卧起座能减肥吗
血小板低是怎么回事	血小版低是怎么回事
例假肚子疼	历假肚子疼
小孩扁桃体发炎咳嗽	小孩篇桃体发炎咳嗽
小孩扁桃体发炎咳嗽	小孩篇桃体发炎咳嗽
小孩扁桃体发炎咳嗽	小孩篇桃体发炎咳嗽
小孩扁桃体发炎咳嗽	小孩篇桃体发炎咳嗽
小孩扁桃体发炎咳嗽	小孩篇桃体发炎咳嗽
小孩扁桃体发炎咳嗽	小孩篇桃体发炎咳嗽
小孩扁桃体发炎咳嗽	小孩篇桃体发炎咳嗽
小孩扁桃体发炎咳嗽	小孩篇桃体发炎咳嗽
小孩扁桃体发炎咳嗽	小孩篇桃体发炎咳嗽
小孩扁桃体发炎咳嗽	小孩篇桃体发炎咳嗽
小孩扁桃体发炎咳嗽	小孩篇桃体发炎咳嗽
小孩扁桃体发炎咳嗽	小孩篇桃体发炎咳嗽
小孩扁桃体发炎咳嗽	小孩篇桃体发炎咳嗽
小孩扁桃体发炎咳嗽	小孩篇桃体发炎咳嗽
哺乳期能用化妆品吗	补乳期能用化妆品吗
风油精能治灰指甲吗	风油精能制灰指甲吗
人流后多久可以洗澡	人流厚多久可以洗澡
小肚子胀怎么回事	小肚子涨怎么回事
糖尿病早期症状	糖尿病早期症壮
坐月子可以吃什么水果	作月子可以吃什么水果
一岁宝宝拉肚子吃什么药	一岁宝宝垃肚子吃什么药
健脾胃的食物	建脾胃的食物
小儿生长发育的一般规律	小二生长发育的一般规律
痛风能治断根吗	痛风能治段根吗
橘子的升糖指数	桔子的升糖指数
乙型肝炎表面抗体阳性是什么意思	已型肝炎表面抗体阳性是什么意思
迈凯伦汽车标志	迈凯轮汽车标志
胆汁反流性胃炎的症状	胆汁返流性胃炎的症状
和乙肝患者共用碗筷会传染吗	和乙肝患者公用碗筷会传染吗
坐月子能吃李子吗	做月子能吃李子吗
月经迟迟不来	月经吃迟不来
低血压症状	低血压证状
怎么叠爱心	怎么碟爱心
近年好看的电影	今年好看的电影
肠息肉有哪些症状	肠西肉有哪些症状
小腹痛是怎么回事	小腹痛是怎麼回事
怀孕初期会腰疼吗	怀孕初期回腰疼吗
又人工服务吗	由人工服务吗
上吐下泻怎么回事	上吐下泄怎么回事
眼睛混浊是什么原因	眼睛浑浊是什么原因
免疫球蛋白多少钱一针	免疫求蛋白多少钱一针
手发抖是什么原因引起的	手发斗是什么原因引起的
衡阳在哪里	衡阳在那里
怎么折爱心	怎么哲爱心
来月经腰痛	来月经要痛
晚上咳嗽厉害怎么办	晚上咳嗽历害怎么办
如何一夜暴富	如何一夜爆富
北京站在哪个区	北京站在那个区
神经衰弱有哪些症状	神经衰弱有那些症状
怎么看苹果手机真假	怎么看平果手机真假
怀孕了拉肚子怎么办	怀孕了垃肚子怎么办
移动好还是联通好	移动号还是联通好
怎么减小肚子	怎么剪小肚子
怎么分辨公鸭母鸭	怎么分辩公鸭母鸭
晚上吃香蕉有什么好处	晚上吃香焦有什么好处
高铁股票有哪些	高铁股票有那些
梅毒的症状	梅毒的政状
南宁知名律师事务所	南宁著名律师事务所
脚爆皮是怎么回事	脚暴皮是怎么回事
眼睛冒绿光	眼镜冒绿光
红薯糖分高吗	红署糖分高吗
大乐透怎么算中奖	大乐头怎么算中奖
眼睛下面长脂肪粒	眼睛下面涨脂肪粒
甲状腺结节有哪些症状	甲状腺结结有哪些症状
补气血的药有哪些	布气血的药有哪些
孕晚期可以吃冰淇淋吗	孕晚起可以吃冰淇淋吗
小腿酸痛是什么原因	小退酸痛是什么原因
什么是硬下疳	什么是硬下甘
脚趾甲长到肉里怎么办	脚止甲长到肉里怎么办
脸上长痘痘是什么原因	脸上涨痘痘是什么原因
子宫内膜多厚会来月经	子宫内膜多厚回来月经
梅毒的传播途径	梅毒得传播途径
心率不齐的症状	心率不齐得症状
解脲支原体阳性怎么办	解尿支原体阳性怎么办
丰胸的食物和水果	丰胸得食物和水果
如何控制不抠痘痘	如何控制不扣痘痘
小腿胀痛怎么办	小腿张痛怎么办
这个世界上谁最帅	这个事界上谁最帅
闲鱼的名字可以改吗	咸鱼的名字可以改吗
大姨妈来了要注意什么	大姨妈来了要主意什么
脚跟痛如何治疗	脚根痛如何治疗
白癜风遗传吗	白癜风移传吗
纸船怎么折	只船怎么折
做肠镜多少钱	做肠竟多少钱
皮肤黄怎么变白	皮服黄怎么变白
颈椎压迫神经的症状	颈椎压迫神经的证状
怎样腌罗卜干	怎样淹罗卜干
如何查询车辆违章	如何查讯车辆违章
孕妇可以吃黄鳝吗	孕妇可以吃黄善吗
一寸等多少厘米	一寸等多少里米
艾滋病有治愈的吗	爱滋病有治愈的吗
支付宝如何充值	支付宝如何冲值
膀胱过度活动症的症状	膀胱过度活动证的症状
胆囊炎可以喝牛奶吗	胆囊炎可以和牛奶吗
开塞露怎么用	凯塞露怎么用
肝硬化晚期症状	肝硬化晚期正状
玻尿酸多少钱一支	玻尿酸多少钱一只
珍珠的功效	珍珠得功效
坐月子期间能吃红薯吗	做月子期间能吃红薯吗
热感冒怎么办	热感冒怎么半
怀孕多久可以查出男女	怀孕多久可以差出男女
已婚妇女戒指戴哪个手指	已婚妇女戒指带哪个手指
女人会的疝气吗	女人会得疝气吗
腰疼是怎么回事	腰疼事怎么回事
脚后跟长骨刺怎么办	脚后跟涨骨刺怎么办
蒲公英泡水喝的功效	普公英泡水喝的功效
哪个牌子拖把好	那个牌子拖把好
孕妇能吃桔子吗	孕妇能吃橘子吗
治疗过敏性鼻炎的方法	制疗过敏性鼻炎的方法
水状白带是怎么回事	水壮白带是怎么回事
梦见被鬼追杀	梦见背鬼追杀
山西都有哪些县	陕西都有哪些县
如何找回微信密码	如何找会微信密码
孕妇能吃橘子吗晚期	孕妇能吃桔子吗晚期
黑枸杞有什么作用	黑狗杞有什么作用
产妇可以吃什么零食	产妇可以吃什么零时
微信如何添加银行卡	微信如何填加银行卡
蔓越莓的功效与作用	蔓越莓得功效与作用
湿热型体质如何调理	湿热性体质如何调理
闲鱼在哪里改地址	咸鱼在哪里改地址
艾滋病检测多久出结果	爱滋病检测多久出结果
六大行动台帐	六大行动台账
中国最穷的县	中国最穷得县
怀孕会尿频吗	怀孕回尿频吗
怎么制作二维码	怎么制作二维玛
心脏早搏是怎么引起的	心脏早博是怎么引起的
纪念碑谷第九关怎么过	记念碑谷第九关怎么过
什么是腺样体面容	什么事腺样体面容
高锰酸钾能治脚气吗	高锰酸钾能治脚气马
脚后跟疼是怎么回事	叫后跟疼是怎么回事
霍金得的什么病	霍金德的什么病
长治二甲医院有那些	长治二甲医院有哪些
淋病梅毒早期症状	淋病梅毒早起症状
被开水烫伤起泡怎么办	被开水汤伤起泡怎么办
糖尿病人可以吃辣椒吗	唐尿病人可以吃辣椒吗
手机怎么连上音响	手机怎么连上音箱
即可以组什么词	既可以组什么词
拔罐起水泡是什么原因	拔罐七水泡是什么原因
枸杞泡水喝有什么好处	苟杞泡水喝有什么好处
肾结石什么症状	肾结石什么证状
电脑开不了机	电脑开不了记
胸大怎么办	胸大怎么班
舌苔厚怎么办	舌太厚怎么办
纸船怎么折	纸船怎么者
小腿肚抽筋怎么回事	小腿杜抽筋怎么回事
抑郁症治疗方法	抑郁证治疗方法
湿热体质怎么调理	湿热体制怎么调理
孝感哪个厂工资高	孝感那个厂工资高
静脉曲张吃什么药	静迈曲张吃什么药
脚底板痒是怎么回事	脚底版痒是怎么回事
红薯长芽了还能吃吗	红署长芽了还能吃吗
什么食物含锌	什么实物含锌
感冒喝什么药	感冒和什么药
偏头痛是怎么引起的	偏头痛是怎么引起得
先涂防晒霜还是隔离霜	先图防晒霜还是隔离霜
包皮手术有哪几种	包皮手术有那几种
老烂腿怎么治	老兰腿怎么治
头孢是消炎药吗	头胞是消炎药吗
放屁臭是什么原因	防屁臭是什么原因
淋巴结肿大严重吗	林巴结肿大严重吗
汽车坐垫什么牌子好	汽车做垫什么牌子好
洗牙的好处	洗呀的好处
网上定火车票怎么取票	网上订火车票怎么取票
流清鼻涕是什么感冒	刘清鼻涕是什么感冒
普洱茶能减肥吗	谱洱茶能减肥吗
什么牌子的洗发水好用	什么牌子得洗发水好用
一万公积金能贷款多少	一万公积金能代款多少
新生儿拉奶瓣怎么回事	新生儿垃奶瓣怎么回事
耳朵嗡嗡响怎么办	耳朵嗡嗡想怎么办
颈椎变形怎么办	颈椎变型怎么办
不孕不育的原因	不孕不育得原因
湿疹的发病原因	湿诊的发病原因
性病的症状有哪些	性病的症状有那些
来月经能喝酒吗	来月经能和酒吗
北京的区号	北京得区号
指甲长到肉里怎么办	指甲涨到肉里怎么办
血糖高可以吃红薯吗	血糖高可以吃红署吗
浑身发热但不发烧	混身发热但不发烧
蓝牙耳机怎么用	蓝呀耳机怎么用
其的偏旁是什么	其的边旁是什么
其的偏旁是什么	其的边旁是什么
其的偏旁是什么	其的边旁是什么
其的偏旁是什么	其的边旁是什么
其的偏旁是什么	其的边旁是什么
其的偏旁是什么	其的边旁是什么
其的偏旁是什么	其的边旁是什么
其的偏旁是什么	其的边旁是什么
其的偏旁是什么	其的边旁是什么
其的偏旁是什么	其的边旁是什么
其的偏旁是什么	其的边旁是什么
其的偏旁是什么	其的边旁是什么
其的偏旁是什么	其的边旁是什么
其的偏旁是什么	其的边旁是什么
什么是定向流量	什麼是定向流量
吃了不消化怎么办	吃了不消话怎么办
乙肝小三阳会传染吗	乙干小三阳会传染吗
乳腺癌有哪些症状	乳线癌有哪些症状
肺上有结节	肺上有结界
颈椎病引起头晕怎么办	颈椎病引气头晕怎么办
妊娠糖尿病可以吃什么水果	妊娠唐尿病可以吃什么水果
什么是附件炎	什么事附件炎
怀孕初期白带多是怎么回事	怀孕出期白带多是怎么回事
妇科纳囊是什么病	妇科那囊是什么病
一安培等多少库仑	一安培等多少库伦
做完人流多久复查	昨完人流多久复查
脚受伤了吃哪些食物恢复得快	脚受伤了吃那些食物恢复得快
燃气初装费	燃气出装费
荨麻疹可以吃鸡翅吗	寻麻疹可以吃鸡翅吗
刺激性食物有哪些	刺激性实物有哪些
身上长猴子是什么原因	身上涨猴子是什么原因
慢性咽炎吃什么药	慢性咽炎吃什么要
中考让带手表吗	中考让戴手表吗
肾虚是什么症状	肾虚是什么证状
催月经来的方法	崔月经来的方法
芒果吃多了会上火吗	茫果吃多了会上火吗
拉肚子挂什么科	拉肚子挂什么课
怎么可以瘦脸	怎么可以受脸
单机游戏推荐	单击游戏推荐
中暑了吃什么药	中署了吃什么药
舌头有黑点	舌头又黑点
经期喝红糖水好吗	经期和红糖水好吗
内痔有什么症状	内痔有什么证状
宫腔积液吃什么药	宫腔积夜吃什么药
怎么治疗腰肌劳损	怎么治疗腰肌老损
宝宝吃什么奶粉好	宝宝吃什麼奶粉好
脚底脱皮怎么办	脚底脱皮怎么半
唐氏筛查多少钱	唐氏晒查多少钱
吃完药能喝牛奶吗	吃完药能和牛奶吗
保安族有多少人	保安组有多少人
怎么孵小鸡	怎么孚小鸡
坐月子可以吃鹿茸吗	做月子可以吃鹿茸吗
六味地黄丸的功效	六位地黄丸的功效
怎么去除扁平疣	怎么去除扁平尤
黄疸有哪些症状	黄疸有那些症状
手上长鸡眼	手上张鸡眼
车架号是什么	车加号是什么
如何申请小号	如何申清小号
如何去除体内的湿气	如何去处体内的湿气
什么食物降血糖	什么食物绛血糖
肝脏血管瘤注意什么	肝脏血官瘤注意什么
吃头孢可以喝啤酒吗	吃头孢可以和啤酒吗
什么的枝条	什么得枝条
宽带密码怎么查	宽带蜜码怎么查
支付宝如何解绑手机号	支付宝如何解邦手机号
血压低吃什么药好	血压地吃什么药好
吃西瓜有什么好处	吃西瓜又什么好处
甲状腺病传染吗	甲壮腺病传染吗
老是长口腔溃疡是什么原因	老是张口腔溃疡是什么原因
乙型肝炎表面抗体呈阳性是什么意思	乙型肝炎表面抗体成阳性是什么意思
小三阳和大三阳哪个严重	小三阳和大三阳那个严重
拉肚子能吃什么	垃肚子能吃什么
子宫内膜厚是什么原因	字宫内膜厚是什么原因
胃病能吃桑椹吗	胃病能吃桑葚吗
人为什么要睡觉	仁为什么要睡觉
黑枸杞功效与作用	黑苟杞功效与作用
说话结巴怎么办	说话结吧怎么办
皮肤痒一抓就红	皮肤养一抓就红
孕妇可以吃冰激凌吗	孕妇可以吃冰激凌妈
奥美拉唑饭前吃还是饭后吃	奥美啦唑饭前吃还是饭后吃
素菜有那些	蔬菜有那些
素菜有那些	蔬菜有那些
素菜有那些	蔬菜有那些
素菜有那些	蔬菜有那些
素菜有那些	蔬菜有那些
素菜有那些	蔬菜有那些
素菜有那些	蔬菜有那些
素菜有那些	蔬菜有那些
素菜有那些	蔬菜有那些
素菜有那些	蔬菜有那些
前列腺炎吃什么药	前列线炎吃什么药
手脱皮是怎么回事	收脱皮是怎么回事
绿豆汤怎么煮	绿豆汤怎么住
mba报名时间	mpa报名时间
mba报名时间	mpa报名时间
mba报名时间	mpa报名时间
mba报名时间	mpa报名时间
mba报名时间	mpa报名时间
mba报名时间	mpa报名时间
mba报名时间	mpa报名时间
mba报名时间	mpa报名时间
mba报名时间	mpa报名时间
mba报名时间	mpa报名时间
mba报名时间	mpa报名时间
mba报名时间	mpa报名时间
mba报名时间	mpa报名时间
mba报名时间	mpa报名时间
膀胱炎有什么症状	膀胱炎有什么证状
经常打嗝是怎么回事	经常打隔是怎么回事
梦见戴手环	梦见带手环
心脏彩超多少钱	心赃彩超多少钱
艾滋病还能活多久	爱滋病还能活多久
抑郁症的治疗方法	抑郁症得治疗方法
肝脾不和的症状	肝脾不合的症状
苹果平板电脑可以打电话吗	平果平板电脑可以打电话吗
月经期间能拔牙吗	月经其间能拔牙吗
排卵期一般几天	排卵期一半几天
颈椎痛怎么缓解	颈椎同怎么缓解
慢性胃炎的症状	慢性胃炎的证状
子宫切除有什么影响	自宫切除有什么影响
怀孕多久有反应	怀孕多九有反应
结石不能吃什么	节石不能吃什么
卵子的存活时间	卵子的存火时间
荨麻疹能吃姜	寻麻疹能吃姜
喝豆浆会胖吗	呵豆浆会胖吗
哪些人不适合吃阿胶	那些人不适合吃阿胶
韩国化妆品有哪些品牌	韩国化妆品有那些品牌
早上空腹可以吃苹果吗	早上空复可以吃苹果吗
再生障碍性贫血能治愈吗	在生障碍性贫血能治愈吗
一把青哪里可以看	一把青那里可以看
怎么样去黑眼圈	怎么样取黑眼圈
康妇消炎栓为什么是直肠给药	康复消炎栓为什么是直肠给药
腰椎间盘突出正确睡姿	腰椎间盘突出正确睡资
厦门地理位置	厦门地里位置
什么是癔症	什么事癔症
怎样推迟月经	怎样推持月经
怎样恢复眼睛视力	怎样回复眼睛视力
颈椎病的症状有哪些	颈椎病的证状有哪些
如何收缩毛孔	如何收索毛孔
小肚子胀怎么回事	小肚子帐怎么回事
孕妇可以吃川贝炖雪梨吗	孕妇可以吃川北炖雪梨吗
拉肚子能打预防针吗	啦肚子能打预防针吗
小儿打呼噜是病吗	小二打呼噜是病吗
经常打喷嚏是什么原因	经常打噴嚏是什么原因
月经期间怎么减肥	月经其间怎么减肥
梅尼埃病是什么病	梅尼挨病是什么病
低血糖是糖尿病吗	低雪糖是糖尿病吗
什么时候清明节	什么时候青明节
转氨酶高有什么症状	转氨酶高有什么证状
腰左侧疼是怎么回事	要左侧疼是怎么回事
山药的功效与作用	山药的功效与做用
怀孕初期能喝姜糖水吗	怀孕初期能喝姜汤水吗
甲状腺球蛋白偏高	甲状腺求蛋白偏高
尿道结石怎么治疗	尿道结实怎么治疗
嘴唇长疱疹是什么原因	嘴唇长泡疹是什么原因
拉屎拉不出来怎么办	拉屎啦不出来怎么办
坐月子有湿疹怎么办	做月子有湿疹怎么办
胃肠功能紊乱的症状	胃肠工能紊乱的症状
输尿管末端结石好排吗	输尿管末端结石好牌吗
小便时尿道刺痛是怎么回事	小便是尿道刺痛是怎么回事
甲状腺球蛋白高	甲壮腺球蛋白高
小孩长湿疹怎么办	小孩涨湿疹怎么办
熬夜有什么危害	熬夜有什么威害
小孩子可以喝蜂蜜吗	小孩子可以和蜂蜜吗
什么是细菌性阴道炎	什么事细菌性阴道炎
爸爸去哪主题曲	爸爸去哪主体曲
孕酮低吃什么补得快	孕酮低吃什么补的快
甲状腺切除的后遗症	甲状腺切除的后疑症
拔罐出水泡是怎么回事	拔罐出水疱是怎么回事
糖尿病人可以吃莲藕吗	糖尿病人可以吃连藕吗
经期喝柠檬水好吗	经期和柠檬水好吗
氯化钾注射液可以口服吗	氯化钾注射夜可以口服吗
怎样在电脑上截图	怎样再电脑上截图
丙型肝炎抗体	丙性肝炎抗体
食言了是什么意思	失言了是什么意思
腹股沟在什么位置	服股沟在什么位置
心里难受怎么办	心理难受怎么办
新生儿打嗝怎么办	新生儿大嗝怎么办
静脉曲张有哪些危害	静脉曲张有那些危害
微信转账多久到账	微信转帐多久到账
如何学好历史	如何学号历史
江西农保怎么交费	江西农保怎么缴费
小孩不睡觉怎么办	小还不睡觉怎么办
什么的小路	什么得小路
脚背痛是不是痛风	脚背痛是不是通风
米黄色裤子配什么上衣	米黄色裤子陪什么上衣
怎样排肝毒	怎样拍肝毒
服用逍遥丸的副作用	服用消遥丸的副作用
硫磺皂洗脸好吗	流磺皂洗脸好吗
怎么减肚子上的赘肉	怎么见肚子上的赘肉
被蚂蚁咬了怎么办	被蚂蚁咬了怎么半
颈椎病怎样治疗	颈椎病怎样制疗
熬夜喝什么好	熬夜和什么好
吃橘子会回奶吗	吃桔子会回奶吗
胃不好能喝茶叶吗	胃不好能和茶叶吗
牛奶和香蕉可以同时吃吗	牛奶和香焦可以同时吃吗
腋下淋巴结肿大怎么办	夜下淋巴结肿大怎么办
泌尿结石吃什么可以排石	秘尿结石吃什么可以排石
胸闷气短是怎么回事	凶闷气短是怎么回事
返流性食道炎	返流行食道炎
怀孕能吃牛肉吗	怀孕能吃牛肉妈
晚上睡觉磨牙是什么原因	晚上睡觉模牙是什么原因
长期坐着腰疼怎么办	长期做着腰疼怎么办
鼻窦炎的症状有哪些	鼻窦炎得症状有哪些
大乐透怎么中奖	大乐透怎么种奖
卖水果赚钱吗	卖水果转钱吗
电信移动联通哪个好	电信移动联通那个好
脚指头痒是怎么回事	脚只头痒是怎么回事
骨质疏松的症状	骨质疏松得症状
脚气水泡怎么治疗	脚气水疱怎么治疗
精英律师带的表	精英律师戴的表
高蛋白食物有哪些	高蛋百食物有哪些
血栓怎么治疗	学栓怎么治疗
如何让胸变大	如何让熊变大
地中海贫血	地重海贫血
盆腔积液是什么	盆腔积夜是什么
雌激素是什么	雌激素事什么
经期可以洗牙吗	经期可以洗呀吗
什么时候放暑假	什么时侯放暑假
吃了头孢喝酒会怎么样	吃了头孢和酒会怎么样
萨达姆是哪国的	撒达姆是哪国的
月经干净后几天是安全期	月经干经后几天是安全期
湿气重喝什么茶好	湿气中喝什么茶好
橄榄油的功效与作用	敢榄油的功效与作用
手麻是怎么回事	手麻是怎么会事
健身能长高吗	建身能长高吗
新生儿喉咙有痰怎么办	新生儿喉咙有谈怎么办
卵泡每天长多少	卵泡每天涨多少
肩膀长痘痘是什么原因	肩膀张痘痘是什么原因
怎样治疗白癜风	怎样治疗白电风
左下腹痛是怎么回事	左下复痛是怎么回事
经常头痛是什么原因	经常头痛是什么愿因
小孩心肌酶高怎么办	小孩心机酶高怎么办
输卵管通而不畅怎么办	输卵管通儿不畅怎么办
怎样才能去除脸上的痘印	怎样才能祛除脸上的痘印
心情烦躁不安怎么办	心情烦燥不安怎么办
丙氨酸转氨酶偏高是什么原因	丙氨酸转安酶偏高是什么原因
感冒喉咙痛吃什么药好	感帽喉咙痛吃什么药好
喝柠檬水有什么好处	和柠檬水有什么好处
腰肌劳损怎么治疗	腰肌劳损怎么治辽
猝死的前兆是什么	促死的前兆是什么
姜和白醋能去斑吗	姜和白醋能祛斑吗
老放屁怎么办	老方屁怎么办
头发有头皮屑怎么办	头发又头皮屑怎么办
吃避孕药会流血吗	吃避孕药会留血吗
茶叶蛋的营养价值	茶业蛋的营养价值
一喝酒头疼怎么回事	一喝就头疼怎么回事
北京属于哪个省	北京属于那个省
什么是激素脸	什麼是激素脸
怀孕能吃原荽吗	怀孕能吃园荽吗
怀孕会犯困吗	怀孕回犯困吗
怎么刷白皮鞋	怎么刷白布鞋
宝宝腹泻怎么办	宝宝复泻怎么办
vivo手机来电拒接怎么取消	vivo手机来电拒绝怎么取消
宝宝老是揉眼睛是怎么回事	宝宝老是柔眼睛是怎么回事
孕妇可以喝红糖水吗	孕妇可以和红糖水吗
怀孕多久有反应	怀孕多久又反应
脂肪肝怎么治	脂方肝怎么治
小腿痒是怎么回事	小退痒是怎么回事
月经推迟一天能测出怀孕吗	月经退迟一天能测出怀孕吗
眼霜的作用	眼霜得作用
颈椎退行性变如何治疗	颈椎推行性变如何治疗
双相情感障碍的诊断	双向情感障碍的诊断
周公解梦梦见蛇	周工解梦梦见蛇
福州哪家装修公司好	福州那家装修公司好
乙型肝炎表面抗体阳性是什么意思	乙性肝炎表面抗体阳性是什么意思
新生儿湿疹怎么办	新生儿时疹怎么办
艾滋病的症状	艾滋病的政状
被虫子咬了起水泡	被虫子咬了起水疱
取环多久可以怀孕	去环多久可以怀孕
什么是超声心动图	什么是超生心动图
南京属于哪里	南京属于那里
闭合性粉刺怎么治疗	闭和性粉刺怎么治疗
怎样去除妊娠纹	怎样去出妊娠纹
怎么查电话号码归属地	怎么差电话号码归属地
麦芽精的功效与作用	卖芽精的功效与作用
沪是哪里的简称	沪是那里的简称
什么动物会变形	什么动物会变性
半月板损伤的症状	半月板损伤得症状
珍珠疹用什么药	珍珠珍用什么药
什么是光子嫩肤	什么事光子嫩肤
燃气热水器怎么安装	燃汽热水器怎么安装
经期可以吃芒果吗	经起可以吃芒果吗
脚被砸到了肿了怎么办	脚背砸到了肿了怎么办
震楼器会影响楼下吗	振楼器会影响楼下吗
白癜风会传染吗	白殿风会传染吗
手哆嗦是什么原因	手多嗦是什么原因
风油精可以口服吗	风油精可以口福吗
男性尿血是怎么回事	男姓尿血是怎么回事
最厉害的武器是什么	最历害的武器是什么
孕妇能吃海参吗	孕妇能吃海参妈
去肝火的食物	去干火的食物
孕妇能喝什么茶	孕妇能喝什麼茶
巧影怎么扣图	巧影怎么抠图
梅花什么时候开	梅花什么时候凯
网上怎么定汽车票	网上怎么顶汽车票
肺结核的传播途径	肺结核的传播途经
感动中国十大人物	敢动中国十大人物
油性记号笔怎么清除	油性记号笔怎么清楚
佝偻病是什么	佝楼病是什么
抗甲状腺过氧化物酶高	扛甲状腺过氧化物酶高
拔完牙多久可以喝水	把完牙多久可以喝水
哪些昆虫是害虫	那些昆虫是害虫
乙肝携带者传染吗	乙肝协带者传染吗
注意力不集中	主意力不集中
标志英语单词	标识英语单词
什么是寒性体质	什么事寒性体质
怎么登陆vps	怎么登录vps
孕妇糖尿病对胎儿有什么影响	孕妇唐尿病对胎儿有什么影响
枸杞有什么功效	苟杞有什么功效
宝宝几个月可以坐	宝宝几个月可以座
荨麻疹检查过敏源	寻麻疹检查过敏源
发烧挂哪个科	发烧挂那个科
右胸口疼是怎么回事	友胸口疼是怎么回事
小腹坠胀怎么回事	小腹坠涨怎么回事
面瘫怎样按摩	面滩怎样按摩
怎样把银行卡的钱转到支付宝	怎样把银行卡的钱赚到支付宝
被鬼上身怎么办	背鬼上身怎么办
肝炎的早期症状	肝炎的早起症状
孕期长斑怎么办	孕期张斑怎么办
黑枸杞多少钱一斤	黒枸杞多少钱一斤
什么食物养胃	什么事物养胃
大象的耳朵想什么	大象的耳朵象什么
如何锻炼腰腹力量	如何锻练腰腹力量
安乐片是安眠药吗	安了片是安眠药吗
过渡性是什么意思	过度性是什么意思
百度在哪里提问	百度在那里提问
打乙脑疫苗发烧怎么办	打已脑疫苗发烧怎么办
新生儿黄疸多少正常	新生二黄疸多少正常
喉咙痛流鼻涕吃什么药	喉咙痛留鼻涕吃什么药
宫外孕早期有哪些症状	宫外孕早期有那些症状
怀孕能喝咖啡吗	怀孕能和咖啡吗
猕猴桃果汁怎么做	弥猴桃果汁怎么做
左下腹痛是什么原因	昨下腹痛是什么原因
人为什么要睡觉	人为什么要谁觉
精索静脉曲张的症状	精缩静脉曲张的症状
经期能喝柠檬水吗	经期能喝拧檬水吗
咸鱼卖东西靠谱吗	闲鱼卖东西靠谱吗
每天早上喝蜂蜜水好吗	每天早上和蜂蜜水好吗
肾阴虚吃什么药	肾阴虚吃什么要
转氨酶高是什么原因	转按酶高是什么原因
湿疹有什么症状	湿诊有什么症状
碳水化合物食物有哪些	碳水化合物食物有那些
腿抽筋怎么办	腿抽筋怎么半
拉肚子可以吃橘子吗	拉肚子可以吃桔子吗
白带带血丝是什么原因	百带带血丝是什么原因
甲状腺结节需要手术吗	甲状腺结结需要手术吗
产后能喝牛奶吗	产后能和牛奶吗
新生儿为什么老打嗝	新生儿为什么老打隔
微信怎么群发	微信怎么裙发
什么是慢性病	什么事慢性病
淘宝买手机靠谱吗	淘宝卖手机靠谱吗
甲状腺球蛋白抗体高怎么办	甲状腺秋蛋白抗体高怎么办
北京那个医院皮肤科最好	北京哪个医院皮肤科最好
脚后跟疼是怎么回事	脚侯跟疼是怎么回事
陈薇院士研究的疫苗属于哪类疫苗	陈微院士研究的疫苗属于哪类疫苗
拔罐出水泡是怎么回事	拔灌出水泡是怎么回事
尿道感染是怎么引起的	尿道感染是怎么引起得
希腊属于哪个州	希腊属于哪个洲
眼睛的英文是什么	眼镜的英文是什么
蓝色配什么颜色好看	蓝色陪什么颜色好看
月经期间可以健身吗	月经期间可以建身吗
电脑开不了机	点脑开不了机
暗度陈仓的上一句	暗渡陈仓的上一句
玻尿酸多少钱一只	玻尿酸多少钱一直
孕妇能用沐浴露吗	孕妇能用沐浴乳吗
孕妇能用沐浴露吗	孕妇能用沐浴乳吗
孕妇能用沐浴露吗	孕妇能用沐浴乳吗
孕妇能用沐浴露吗	孕妇能用沐浴乳吗
孕妇能用沐浴露吗	孕妇能用沐浴乳吗
孕妇能用沐浴露吗	孕妇能用沐浴乳吗
孕妇能用沐浴露吗	孕妇能用沐浴乳吗
孕妇能用沐浴露吗	孕妇能用沐浴乳吗
孕妇能用沐浴露吗	孕妇能用沐浴乳吗
肝痛是在哪个位置	肝痛是在那个位置
考试作弊打一数学名词	考试做弊打一数学名词
手机通讯录如何备份	手机通迅录如何备份
孙红雷的电视剧	孙红梅的电视剧
孙红雷的电视剧	孙红梅的电视剧
孙红雷的电视剧	孙红梅的电视剧
孙红雷的电视剧	孙红梅的电视剧
孙红雷的电视剧	孙红梅的电视剧
孙红雷的电视剧	孙红梅的电视剧
孙红雷的电视剧	孙红梅的电视剧
接吻能不能减肥	结吻能不能减肥
血糖高吃什么水果	血糖高吃什么水国
骨质疏松的症状	骨质疏松的证状
血糖高吃什么水果好	雪糖高吃什么水果好
麦滋林饭前吃还是饭后吃	麦兹林饭前吃还是饭后吃
恶心想吐是怎么回事	饿心想吐是怎么回事
刮痧后多久可以洗澡	刮莎后多久可以洗澡
怎么降血糖	怎么将血糖
牙周炎吃什么药	牙周炎吃什么要
阿胶糕的功效与作用	阿胶高的功效与作用
大便便不出来怎么办	大便变不出来怎么办
交通安全手抄报内容	交通安全收抄报内容
头部伽玛刀十大副作用	头部伽马刀十大副作用
肠胃不好能喝蜂蜜吗	肠胃不好能和蜂蜜吗
谁发明了电话	谁发名了电话
肾结石有什么症状	肾洁石有什么症状
怎样才能让腿变细	怎样才能让退变细
哺乳期乳房有硬块是怎么回事	补乳期乳房有硬块是怎么回事
月经期可以艾灸吗	月精期可以艾灸吗
牡蛎的营养价值及功效	母蛎的营养价值及功效
晨曦名字的含义是什么	晨旭名字的含义是什么
宫颈癌四价疫苗价格	宫颈癌四家疫苗价格
脱发怎么办	脱发怎么班
割包皮需要多少钱	割包皮须要多少钱
老虎狮子谁厉害	老虎狮子谁历害
怎么种豆芽	怎麼种豆芽
男孩子起什么名字好听	男孩子启什么名字好听
蜗牛是昆虫吗	蜗牛事昆虫吗
小儿多动症的表现	小二多动症的表现
拉黑色大便怎么回事	拉黑色大变怎么回事
打狂犬疫苗注意事项	打狂犬疫苗主意事项
取环后的注意事项	去环后的注意事项
鼻塞流鼻涕吃什么药	鼻赛流鼻涕吃什么药
怎么查别人的通话记录	怎么茶别人的通话记录
强直性脊椎炎的症状	强直性脊椎炎的症壮
手上起小水泡是怎么回事	手上起小水疱是怎么回事
喉咙痒咳嗽怎么办	候咙痒咳嗽怎么办
桔子糖分高吗	桔子糖份高吗
慢性宫颈炎怎么治	曼性宫颈炎怎么治
月经后几天容易怀孕	月精后几天容易怀孕
结肠癌早期症状	结肠癌早起症状
低血糖是糖尿病吗	低学糖是糖尿病吗
软化血管的食物有哪些	软化血管的食物有那些
如何注销微信号	如何注销微信好
怀孕肚子胀怎么回事	怀孕肚子涨怎么回事
肺结节是怎么回事	肺结接是怎么回事
男人大腿根部内侧瘙痒	男人大腿根部内测瘙痒
输尿管上段结石	输尿管上端结石
小孩感冒流鼻涕吃什么药	小孩感冒留鼻涕吃什么药
幽门螺旋杆菌会传染吗	由门螺旋杆菌会传染吗
如何去除牙结石	如何去除牙洁石
卵巢多囊综合症能怀孕吗	卵巢多囊综合证能怀孕吗
如何报考mba	如何报考mpa
如何报考mba	如何报考mpa
如何报考mba	如何报考mpa
如何报考mba	如何报考mpa
如何报考mba	如何报考mpa
如何报考mba	如何报考mpa
如何报考mba	如何报考mpa
如何报考mba	如何报考mpa
如何报考mba	如何报考mpa
如何报考mba	如何报考mpa
如何报考mba	如何报考mpa
如何报考mba	如何报考mpa
如何报考mba	如何报考mpa
如何报考mba	如何报考mpa
如何判断幼儿急疹	如何判断幼儿急诊
六类网线的标识	六类网线的标志
修眉的注意事项	绣眉的注意事项
坐骨神经痛症状	座骨神经痛症状
心脏早搏的药	心脏早博的药
小脚趾骨折	小脚指骨折
空腹可以喝柠檬蜂蜜水吗	空复可以喝柠檬蜂蜜水吗
最强nba钻石艾弗森怎么加点	最强nba钻石艾佛森怎么加点
白蛋白偏高	白蛋百偏高
近视眼怎么恢复视力	近视眼怎么回复视力
九一年属什么	九壹年属什么
牛油果怎么吃	牛油国怎么吃
肝胆湿热的症状	肝胆湿热的正状
新生儿要准备哪些东西	新生儿要准备那些东西
血红蛋白高是怎么回事	学红蛋白高是怎么回事
荨麻疹的治疗方法	寻麻疹的治疗方法
二尖瓣三尖瓣轻度反流	二间瓣三尖瓣轻度反流
脚底出汗是什么原因	脚底出汉是什么原因
消防拴漏水	消防栓漏水
碳酸钠是什么	炭酸钠是什么
吃榴莲会便秘吗	吃榴莲回便秘吗
鲜鲍鱼怎么做好吃	先鲍鱼怎么做好吃
什么是维生素c	什么是微生素c
淤血淤青怎么消除	瘀血淤青怎么消除
尖锐湿疣是怎么得的	尖锐湿疣是怎么得得
鼻息肉的症状	鼻息肉得症状
小孩脸上有白斑	小孩连上有白斑
鸡眼长什么样	鸡眼涨什么样
心肌梗塞有哪些症状	心肌梗塞有那些症状
吃完榴莲不能吃什么	吃完榴连不能吃什么
肠胃炎吃什么药	常胃炎吃什么药
红糖的功效与作用	红糖得功效与作用
喝咖啡对月经有影响吗	和咖啡对月经有影响吗
高蛋白食物有哪些	高蛋白食物有那些
肺部衣原体感染症状	肺部依原体感染症状
蒲公英的功效与作用	蒲公英的工效与作用
孕妇可以吃烧仙草吗	孕妇可以吃烧鲜草吗
大拇指腱鞘炎的治疗	大姆指腱鞘炎的治疗
小米账号怎么注销	小米帐号怎么注销
什么是康复治疗	什么是康复制疗
深海鱼油的功效与作用	深海鱼尤的功效与作用
肩膀痛是什么原因	肩旁痛是什么原因
肩膀痛是什么原因	肩旁痛是什么原因
肩膀痛是什么原因	肩旁痛是什么原因
肩膀痛是什么原因	肩旁痛是什么原因
肩膀痛是什么原因	肩旁痛是什么原因
肩膀痛是什么原因	肩旁痛是什么原因
肩膀痛是什么原因	肩旁痛是什么原因
肩膀痛是什么原因	肩旁痛是什么原因
肩膀痛是什么原因	肩旁痛是什么原因
肩膀痛是什么原因	肩旁痛是什么原因
肩膀痛是什么原因	肩旁痛是什么原因
肩膀痛是什么原因	肩旁痛是什么原因
肩膀痛是什么原因	肩旁痛是什么原因
肩膀痛是什么原因	肩旁痛是什么原因
来例假可以吃榴莲吗	来历假可以吃榴莲吗
上吐下泻肚子疼吃什么药	上吐下泄肚子疼吃什么药
赞美教室的句子	赞美教师的句子
男生头发怎么长的快	男生头发怎么长得快
三尖瓣轻度返流是什么意思	三尖瓣轻度反流是什么意思
什么样的嘴巴	什么样的嘴吧
宝宝拉肚子怎么办	宝宝啦肚子怎么办
尼泊尔是那个国家	尼泊尔是哪个国家
圣诞节礼物	圣诞接礼物
花呗账单怎么删除	花呗张单怎么删除
血糖偏高怎么办	雪糖偏高怎么办
坐月子可以吃红枣么	做月子可以吃红枣么
吃避孕药还会怀孕吗	吃避孕要还会怀孕吗
唑疮怎么治	唑创怎么治
怀孕了还会来月经吗	怀孕了还回来月经吗
纸船怎么折	纸船怎么哲
胃癌的早期症状是什么	胃癌的早起症状是什么
中国哪个男明星最帅	中国那个男明星最帅
尿频尿急是怎么回事	尿濒尿急是怎么回事
尿频尿急是怎么回事	尿濒尿急是怎么回事
尿频尿急是怎么回事	尿濒尿急是怎么回事
尿频尿急是怎么回事	尿濒尿急是怎么回事
尿频尿急是怎么回事	尿濒尿急是怎么回事
尿频尿急是怎么回事	尿濒尿急是怎么回事
尿频尿急是怎么回事	尿濒尿急是怎么回事
尿频尿急是怎么回事	尿濒尿急是怎么回事
尿频尿急是怎么回事	尿濒尿急是怎么回事
尿频尿急是怎么回事	尿濒尿急是怎么回事
尿频尿急是怎么回事	尿濒尿急是怎么回事
尿频尿急是怎么回事	尿濒尿急是怎么回事
尿频尿急是怎么回事	尿濒尿急是怎么回事
尿频尿急是怎么回事	尿濒尿急是怎么回事
烂嘴角是怎么回事	烂嘴角是怎么会事
六味地黄丸怎么样	六位地黄丸怎么样
怎么查询中考成绩	怎么查寻中考成绩
虚幻缥缈的意思	虚幻飘渺的意思
细辛的功效与作用	细心的功效与作用
膝盖痛怎么回事	膝盖痛怎么会事
疱疹的初期症状	疱疹的初起症状
带套不会怀孕吧	戴套不会怀孕吧
跑完步能喝水吗	跑完不能喝水吗
太阳穴长痘痘是怎么回事	太阳血长痘痘是怎么回事
心理医生哪里有	心理医生那里有
心率不齐的危害是什么	心律不齐的危害是什么
左眼一直跳怎么回事	昨眼一直跳怎么回事
什么的枫叶	什么得枫叶
淋巴细胞百分比偏低	琳巴细胞百分比偏低
脚上长湿疹	脚上涨湿疹
悲恸近义词	悲痛近义词
怎么煎鱼不粘锅	怎么剑鱼不粘锅
平安车险和人保车险哪个好	平安车险和人保车险那个好
剖腹产多久可以洗澡	剖复产多久可以洗澡
尿毒症的症状有哪些	尿毒证的症状有哪些
嗜酸性粒细胞偏高	是酸性粒细胞偏高
坐月子可以敷面膜吗	坐月子可以肤面膜吗
肾结石吃什么好	肾结实吃什么好
宝宝肠炎怎么办	宝宝肠严怎么办
月子可以吃桃子吗	月子可以吃桃子妈
组织机构代码证在哪里办理	组织机构代码证在那里办理
手机wps下划线怎么打出来	手机wps下滑线怎么打出来
豆芽的营养价值	豆芽得营养价值
小腿肿是什么原因	小腿肿是什麼原因
绘画形式有那些	绘画形式有哪些
十边形内角和	十边型内角和
电话是谁发明的	电话是谁发名的
手上长水泡怎么办	手上张水泡怎么办
宝宝猛涨期的表现是什么	宝宝猛长期的表现是什么
被狗咬了怎么办	备狗咬了怎么办
骨质疏松的症状	骨质疏松的症壮
脑梗塞的症状有哪些	脑梗塞的症状有那些
生理期可以吃菠萝吗	生理期可以吃波萝吗
怀孕多久能查出男女	怀孕多就能查出男女
世界上最小的国家是哪个国家	世界上最小的国家是那个国家
咳嗽怎样好得快	咳嗽怎样好的快
表示风的词语	表是风的词语
怎么锻炼背部肌肉	怎么锻练背部肌肉
脚脱皮是怎么回事	脚脱皮是怎么会事
牙痛怎么治	牙痛怎么志
滑石粉的功效与作用	华石粉的功效与作用
东莞火车站在哪里	东莞火车站在那里
艾滋病会通过唾液传染吗	爱滋病会通过唾液传染吗
密饯是什么	蜜饯是什么
怎么制作蛋挞	怎么制做蛋挞
眼睛有血丝是怎么回事	眼睛有血丝是怎麼回事
孕妇可以喝咖啡吗	孕妇可以和咖啡吗
痔疮用什么药好	治疮用什么药好
肚子胀胀的怎么回事	肚子涨涨的怎么回事
阴道镜活检疼吗	阴道镜火检疼吗
喝完酒能洗澡吗	喝完就能洗澡吗
什么是发烧	什么事发烧
女孩子取什么名字好听	女孩子取什么名子好听
你会吐位情况吗	你会吐胃情况吗
什么是包皮垢	什么事包皮垢
脸形胖的适合什么发型	脸型胖的适合什么发型
如何祛草莓印	如何去草莓印
嘴唇发紫是什么原因	最唇发紫是什么原因
细菌性阴道炎	细菌性阴倒炎
坐月子能做面膜吗	做月子能做面膜吗
手上起水泡是怎么回事	收上起水泡是怎么回事
颧骨高怎么办	颧骨搞怎么办
正常人心率	正常人心律
肾结石能吃豆芽吗	肾结石能吃豆牙吗
新生儿鼻子不通气怎么办	新生二鼻子不通气怎么办
做蛋糕用什么面粉	坐蛋糕用什么面粉
什么蔬菜的根好吃	什么蔬菜的跟好吃
老放屁是怎么回事	老房屁是怎么回事
糖尿病吃什么蔬菜好	糖尿病吃什么蔬才好
烧心是怎么回事	烧心是怎么会事
什么是大三阳	什么事大三阳
吃完避孕药多久可以吃东西	吃玩避孕药多久可以吃东西
糖尿病患者可以喝豆浆吗	糖尿病患者可以和豆浆吗
怎样清洗羽绒服	怎样请洗羽绒服
心肌梗塞有哪些症状	心机梗塞有哪些症状
淋巴结肿大严重吗	淋巴节肿大严重吗
血管堵塞吃什么好	血管赌塞吃什么好
非布司他可以长期吃吗	非布斯他可以长期吃吗
骨密度检查多少钱	骨蜜度检查多少钱
一型糖尿病和二型糖尿病的区别	一性糖尿病和二型糖尿病的区别
低血压的危害	低血压的为害
脑梗塞的症状有哪些	脑梗赛的症状有哪些
什么是肺结节	什么是肺结结
血小板计数偏高怎么办	血小板记数偏高怎么办
偏头痛是什么原因	片头痛是什么原因
什么时候开学	神么时候开学
脑膜炎后遗症能治好吗	脑莫炎后遗症能治好吗
刘昊然演的综艺	刘浩然演的综艺
孟鲁司特钠要吃多久	孟鲁司特纳要吃多久
怎样会导致不孕	怎样会导至不孕
人参的功效	人参得功效
尿浑浊是什么原因	尿昏浊是什么原因
偏头痛是什么原因	翩头痛是什么原因
芒果的功效与作用	芒果的工效与作用
第一次一定会流血吗	第一次一定回流血吗
怀孕多久孕吐	怀孕多久晕吐
痔疮的危害	痔疮得危害
泡疹的症状	泡诊的症状
药流后多久来月经	药流后多就来月经
大腿内侧磨的疼	大腿内侧磨得疼
怎么转换数值格式	怎么转换数字格式
怎么转换数值格式	怎么转换数字格式
怎么转换数值格式	怎么转换数字格式
怎么转换数值格式	怎么转换数字格式
怎么转换数值格式	怎么转换数字格式
怎么转换数值格式	怎么转换数字格式
怎么转换数值格式	怎么转换数字格式
怎么转换数值格式	怎么转换数字格式
怎么转换数值格式	怎么转换数字格式
怎么转换数值格式	怎么转换数字格式
怎么转换数值格式	怎么转换数字格式
怎么转换数值格式	怎么转换数字格式
一百九十二点一百六十八点三点一登录不了	一百九十二点一百六十八点三点一登陆不了
眼睛红血丝怎么回事	眼镜红血丝怎么回事
月经后第几天是排卵期	月经后弟几天是排卵期
手心出汗是怎么回事	手心出汗是怎么会事
湿疹怎么办	湿诊怎么办
女孩几岁开始乳房发育	女孩几岁开是乳房发育
脚趾麻木是怎么回事	脚止麻木是怎么回事
花斑癣会传染吗	花班癣会传染吗
三维彩超什么时候做最好	三围彩超什么时候做最好
爱心怎么折	爱心怎么哲
腰间盘突出手术多少钱	腰肩盘突出手术多少钱
身上长水泡是怎么回事	身上张水泡是怎么回事
怎样去除眼袋	怎样去出眼袋
羊奶粉好还是牛奶粉好	养奶粉好还是牛奶粉好
种牙多少钱一颗	种呀多少钱一颗
脚后跟痛怎么办	角后跟痛怎么办
湖洲到徐州高铁时刻表	湖州到徐州高铁时刻表
心律不齐怎么调养	心率不齐怎么调养
打嗝怎么治	大嗝怎么治
六味地黄丸哪个牌子好	六位地黄丸哪个牌子好
中国著名产品	中国知名产品
中国古代的文房四宝是什么	中国古代的文防四宝是什么
儿童流鼻血是什么原因	儿童留鼻血是什么原因
牙齿痛的睡不着怎么办	牙齿痛得睡不着怎么办
孕酮多少是怀孕	孕酮多少事怀孕
商务公司起名	商务公司取名
骨癌的症状	骨癌的症壮
血小板增多症	血小板赠多症
一只拉布拉多狗多少钱	一只拉不拉多狗多少钱
治疗灰指甲的药有哪些	治疗灰指甲的药有那些
蜂蜜水什么时候喝好	风蜜水什么时候喝好
梦见已故的亲人	梦见一故的亲人
隐适美价格	隐世美价格
湿疹是什么引起的	湿诊是什么引起的
小孩长痱子怎么办	小孩涨痱子怎么办
频发室性早搏三联律	频发室性早搏三连律
肠镜检查前应注意什么	肠境检查前应注意什么
血糖高能吃西瓜吗	血唐高能吃西瓜吗
血糖高能喝蜂蜜水吗	雪糖高能喝蜂蜜水吗
黑芝麻的功效与作用	嘿芝麻的功效与作用
孕妇小便混浊	孕妇小便浑浊
减肥能吃哈密瓜吗	减肥能吃哈蜜瓜吗
方便面会胖吗	方便面回胖吗
肩周炎的症状	肩周炎的正状
那里有二手摩托车买	那里有二手摩托车卖
新生儿打嗝怎么回事	新生儿打隔怎么回事
眼睛里进东西了怎么办	眼睛里今东西了怎么办
牙齿有裂纹怎么办	牙齿又裂纹怎么办
如何治疗荨麻疹	如何治疗荨麻诊
肚子胀拉不出大便怎么回事	肚子帐拉不出大便怎么回事
什么是定向流量	什么事定向流量
格力售后服务电话	格立售后服务电话
皮肤瘙痒吃什么药	皮夫瘙痒吃什么药
怎么治好荨麻疹	怎么治好寻麻疹
静脉曲张早期症状	静脉曲张早起症状
口腔溃疡吃什么好	口腔溃疡吃什么号
尿毒症的症状	尿毒症得症状
血常规挂哪个科	血常规挂那个科
月经期能吃桔子吗	月经期能吃橘子吗
足浴器哪个牌子好	足浴器那个牌子好
心急吃不了热豆腐	心极吃不了热豆腐
荨麻疹中医如何治疗	寻麻疹中医如何治疗
强直性脊柱炎的症状	强直行脊柱炎的症状
石家庄是几线城市	石家庄是几线成市
蒲公英能降血压吗	蒲公英能将血压吗
怀孕可以泡温泉吗	怀孕可以跑温泉吗
烤箱什么牌子的好	烤箱什么牌子得好
痛风能吃鲈鱼吗	痛风能吃芦鱼吗
乳腺增生吃什么药	乳线增生吃什么药
无线路由器忘记密码怎么办	无限路由器忘记密码怎么办
降血糖食物	降雪糖食物
避孕药怎么吃	毕孕药怎么吃
什么冰箱好	什么冰箱号
橘子是什么季节的水果	桔子是什么季节的水果
好听的英文名字	好听的英问名字
心脏主要由什么细胞构成	心脏主要有什么细胞构成
中医学的基本特点	中医学得基本特点
最小公倍数怎么求	最小公倍数怎么球
喝蜂蜜水能减肥吗	喝蜂密水能减肥吗
什么是京东卡	什么事京东卡
月经过后几天可以取环	月经过后几天可以去环
尿潜血一个加号严重吗	尿浅血一个加号严重吗
艾灸可以减肥吗	爱灸可以减肥吗
怎么登录腾讯会员	怎么登入腾讯会员
怎么登录腾讯会员	怎么登入腾讯会员
怎么登录腾讯会员	怎么登入腾讯会员
怎么登录腾讯会员	怎么登入腾讯会员
怎么登录腾讯会员	怎么登入腾讯会员
怎么登录腾讯会员	怎么登入腾讯会员
怎么登录腾讯会员	怎么登入腾讯会员
怎么登录腾讯会员	怎么登入腾讯会员
怎么登录腾讯会员	怎么登入腾讯会员
两组对边什么的四边形叫做平行四边形	两组对边什么的四边形叫作平行四边形
喉咙有痰怎么办	喉咙有痰怎么半
如何渡过奥德赛岁月	如何度过奥德赛岁月
小儿扁桃体发炎吃什么药	小二扁桃体发炎吃什么药
孕妇什么时候开始补钙	孕服什么时候开始补钙
正往下落得树叶像什么	正往下落的树叶像什么
王者怎么用别人的微信登陆	王者怎么用别人的微信登录
脖子涨痛是怎么回事	脖子胀痛是怎么回事
健脾的食物	建脾的食物
脚底长水疱是湿气吗	脚底长水泡是湿气吗
心脏病人可以坐飞机吗	心脏病人可以做飞机吗
怎么死不痛	怎么死不通
羊奶和牛奶哪个好	羊奶和牛奶那个好
甲状腺结节	甲状腺结洁
桃花是什么颜色	桃花事什么颜色
长期大便不成形是什么原因	长期大便不成型是什么原因
大蒜发芽了还能吃吗	打蒜发芽了还能吃吗
垃圾桶怎么折	垃圾筒怎么折
什么人不适合吃芒果	什么人不适合吃忙果
月经后几天是排卵期	月经后几天是拍卵期
脸上长螨虫怎么办	脸上长满虫怎么办
布艺沙发哪个品牌好	布艺沙发那个品牌好
焦虑症的症状	焦虑症得症状
脸长的女生适合什么发型	脸长得女生适合什么发型
疱疹几天能好	泡疹几天能好
小肚子疼是怎么回事	小度子疼是怎么回事
来月经可以吃乌鸡白凤丸吗	来月经可以吃乌鸡白风丸吗
英文怎么读	英文怎么度
坐久了腰疼是怎么回事	做久了腰疼是怎么回事
湿疹与痱子的区别	湿诊与痱子的区别
什么的目光	什么得目光
孕妇能喝加多宝吗	孕妇能和加多宝吗
手发麻是怎么回事	手法麻是怎么回事
低血糖是怎么回事	低血唐是怎么回事
肚子大怎么减	肚子打怎么减
有几种荨麻疹	有几种寻麻疹
小孩上吐下泻	小孩上吐下泄
怎样去除眼袋	怎样去处眼袋
太阳穴长痘痘是怎么回事	太阳穴张痘痘是怎么回事
肾积水怎么办	肾几水怎么办
高速公路收费标准	高速工路收费标准
上环后注意事项	上环后主意事项
发烧的症状	发烧得症状
试管婴儿多少钱	试官婴儿多少钱
real原声技术哪样	real原生技术哪样
肺部结节严重吗	肺布结节严重吗
尖锐湿疣是性病吗	尖锐湿疣事性病吗
脚后跟磨出水泡怎么处理好的快	脚后根磨出水泡怎么处理好的快
怎么练出腹肌	怎么连出腹肌
慢性荨麻疹怎么根治	慢性荨麻诊怎么根治
身上有红点是怎么回事	身上有红点是怎么会事
老烂腿怎么治	老烂腿怎麼治
做四维彩超的最佳时间	做四围彩超的最佳时间
喝咖啡能减肥吗	和咖啡能减肥吗
哺乳期吃什么好	捕乳期吃什么好
苯和汽油互融吗	苯和汽油互溶吗
带状泡疹最佳治疗方法	带壮泡疹最佳治疗方法
什么食物含叶酸	什么食物喊叶酸
男人可以吃逍遥丸吗	男人可以吃消遥丸吗
婴儿打嗝是什么原因	婴儿打隔是什么原因
盆腔炎的症状是什么	盆腔炎得症状是什么
脑梗塞病人吃什么食物好	脑更塞病人吃什么食物好
血糖高吃什么好能降糖	血塘高吃什么好能降糖
阿斯匹林作用	阿司匹林作用
喝中药会上火吗	喝中药回上火吗
孕妇能吃阿莫西林胶囊吗	孕妇能吃啊莫西林胶囊吗
眼睛里进东西了怎么办	眼睛里进动西了怎么办
朴实的朴可以组什么词	朴素的朴可以组什么词
睡觉流口水是怎么回事	睡觉流口水是怎么回是
背痛是什么原因	背痛是什麼原因
心脏病吃什么药	心脏病吃什么要
租房都有哪些网站	租房都有那些网站
新生儿睡觉不踏实	新声儿睡觉不踏实
脸上长疙瘩怎么办	脸上涨疙瘩怎么办
眼霜的作用	眼霜的做用
身体长红痣是什么原因	身体张红痣是什么原因
新型冠状病毒属哪类	新型冠状病毒是哪类
卖家具好吗	卖家居好吗
如何查询自己的手机号	如何查寻自己的手机号
孕妇能喝金银花露吗	孕妇能和金银花露吗
大拇指指甲凹凸不平是怎么回事	大母指指甲凹凸不平是怎么回事
薄荷的功效与作用	薄荷的功效与做用
博美能吃橘子吗	博美能吃桔子吗
舌苔有裂纹是怎么回事	舌台有裂纹是怎么回事
胃溃疡的症状有哪些	胃溃疡的症状有那些
逍遥丸和加味逍遥丸有什么区别	消遥丸和加味逍遥丸有什么区别
脚趾发麻怎么办	脚指发麻怎么办
孩子脸上有白斑是怎么回事	孩子脸上有白班是怎么回事
营口在哪里	营口在那里
湿气重的症状有哪些	湿气中的症状有哪些
什么情况下需要做胃镜	什么情况下需要作胃镜
小儿肺炎有哪些症状	小儿肺炎有那些症状
怀孕能喝苹果醋吗	怀孕能和苹果醋吗
吃蜂蜜有什么好处	吃风蜜有什么好处
痛经喝红糖姜水有用吗	痛经和红糖姜水有用吗
结扎手术多少钱	接扎手术多少钱
郎朗为什么出名	朗朗为什么出名
晚上吃梨好吗	晚上吃黎好吗
纯碱作洗涤剂的原理	纯碱做洗涤剂的原理
白癜风会痒吗	白癜风回痒吗
晚上跑步能减肥吗	晚上跑不能减肥吗
荨麻疹是什么症状	荨麻诊是什么症状
容易出汗怎么办	容易出汗怎么半
淘宝买家客服	淘宝卖家客服
枸杞和西洋参可以一起泡水喝吗	狗杞和西洋参可以一起泡水喝吗
抽烟会瘦吗	抽烟回瘦吗
子宫脱落是怎么回事	子宫托落是怎么回事
经期可以喝逍遥丸吗	经期可以和逍遥丸吗
沪是哪里的车牌	沪是那里的车牌
前庭神经炎	前厅神经炎
支气管炎咳嗽有痰吃什么好的快	支气管炎咳嗽有痰吃什么好得快
石榴籽能吃吗	石榴子能吃吗
羊奶好还是牛奶好	养奶好还是牛奶好
什么是幽默	什么事幽默
精神分列症可以痊愈吗	精神分裂症可以痊愈吗
一直拉稀怎么回事	一只拉稀怎么回事
迷你世界蘑菇怎么繁殖	迷你世界磨菇怎么繁殖
知名主持人死亡	著名主持人死亡
左肺上叶小结节	左肺上页小结节
刚出生的婴儿打嗝怎么办	刚出生的婴儿打隔怎么办
吃什么水果补血	吃什么水果不血
蓝色配什么颜色好看	蓝色佩什么颜色好看
豆腐怎么做好吃	豆腐怎么作好吃
来月经吃什么菜好	来月经吃什么才好
吃什么补气血	吃什么布气血
开塞露有副作用吗	开赛露有副作用吗
大便出血是怎么回事	大变出血是怎么回事
试管婴儿移植后几天着床	试管婴儿移值后几天着床
胃疼拉肚子怎么回事	胃疼垃肚子怎么回事
甲亢的早期症状	甲亢的早起症状
痘坑痘印怎么修复	都坑痘印怎么修复
孕妇可以喝金银花吗	孕妇可以和金银花吗
鲜胚移植后几天着床	鲜配移植后几天着床
黄鳝的价格	黄蟮的价格
反流性咽喉炎	反流性咽候炎
八十后女星名字	八十后女性名字
睡觉睡的腰疼	睡觉睡得腰疼
毕业赠言给老师的	毕业增言给老师的
被蜱虫咬了有什么症状	被脾虫咬了有什么症状
蓝牙耳机怎么听歌	蓝牙儿机怎么听歌
帕金森综合症	帕金森总合症
血糖低怎么办	血糖低怎么半
杜甫诗怎么写	杜甫是怎么写
指甲出现竖纹是什么原因	指甲出现竖文是什么原因
痔疮可以吃橘子吗	痔疮可以吃桔子吗
电蚊香对孕妇有影响吗	电文香对孕妇有影响吗
得了肩周炎怎么办	的了肩周炎怎么办
梦见死去姑父	梦见死去姑夫
小孩腹泻吃什么药好得快	小孩腹泻吃什么药好的快
荨麻疹会不会传染	荨麻诊会不会传染
橱柜柜体用什么材料	厨柜柜体用什么材料
什么是心脏早搏	什么是心脏早博
粗纤维食物有哪些	粗纤维实物有哪些
扁桃体肿大分度	扁桃体重大分度
脚底长鸡眼怎么办	角底长鸡眼怎么办
凯立德导航怎么升级	凯立得导航怎么升级
荨麻疹可以吃海苔吗	寻麻疹可以吃海苔吗
头皮上长痘痘是怎么回事	头皮上涨痘痘是怎么回事
乳腺结节怎么治最好	乳腺节节怎么治最好
我的座右铭是什么意思	我的坐右铭是什么意思
双肺纹理增多紊乱	双肺文理增多紊乱
肾虚什么症状	肾虚什么证状
蓝牙音箱什么牌子最好	蓝牙音响什么牌子最好
怎样教宝宝说话	怎样交宝宝说话
节育环哪种最好	节育环那种最好
咳嗽有白痰	咳嗽又白痰
梦见别人作手术	梦见别人做手术
尿道炎是怎么引起的	尿到炎是怎么引起的
不锈钢锅可以熬中药吗	不绣钢锅可以熬中药吗
脂肪肝有什么症状	脂肪肝有什么证状
葛根粉的作用与功效	葛根分的作用与功效
聚鑫是什么意思	聚心是什么意思
三角形的周长公式	三角形得周长公式
鼻窦炎的症状	鼻逗炎的症状
失眠怎么办	失眠怎麼办
压力大怎么办	压力打怎么办
孕妇早期可以吃辣条吗	孕妇早起可以吃辣条吗
手脱皮怎么回事	手拖皮怎么回事
痛风可以吃薯片吗	通风可以吃薯片吗
治疗胃病的药	治疗胃病的要
腿部肌肉疼痛怎么办	腿部机肉疼痛怎么办
两对半是什么	两队半是什么
如何去除老年斑	如何去处老年斑
我的世界怎么防蜘蛛	我的世界怎么放蜘蛛
宝宝爱出汗是什么原因	宝宝爱出汉是什么原因
电饼铛什么牌子的好	电饼挡什么牌子的好
地中海贫血有什么症状	地中海贫血有什么正状
水痘和疱疹的区别	水豆和疱疹的区别
小腹痛怎么回事	小服痛怎么回事
白蛋白的作用是什么	白蛋白的做用是什么
病毒性感冒怎么好的快	病毒性感冒怎么好得快
决明子的功效与作用	决明子的工效与作用
心情不好怎么调节	心情不好怎么调解
痛风能吃生蚝吗	通风能吃生蚝吗
压疮的预防措施	压疮得预防措施
婴儿眼睛红	婴儿眼镜红
什么的月光	什么得月光
运动后多久可以洗澡	运动厚多久可以洗澡
打狂犬疫苗注意事项	大狂犬疫苗注意事项
经常胃胀是什么原因	经常胃帐是什么原因
酷暑难挡是什么意思	酷暑难当是什么意思
什么是美尼尔氏综合症	什么是美尼尔氏综合证
耳洞发炎还能戴耳钉吗	耳洞发炎还能带耳钉吗
痛风能吃菠菜么	通风能吃菠菜么
月经期可以喝益母草吗	月经期可以喝意母草吗
咳嗽有痰怎么办	咳嗽有谈怎么办
后背疼是怎么回事	后北疼是怎么回事
社区戒毒期限	社区解毒期限
白带多是怎么回事	白带多是怎么会事
孕妇吃什么补血	孕妇吃什么不血
满月黄疸正常值	满月黄胆正常值
交感神经型颈椎病症状	交感神经型颈椎病证状
被蚂蚁咬了怎么办	被吗蚁咬了怎么办
关于红军长征的诗	关于红军长征的事
刺激性食物有哪些	刺激性食物有那些
脸上汗毛多怎么去除	脸上汗毛多怎么祛除
梦见吃橘子	梦见吃桔子
二郎神属什么生肖	二朗神属什么生肖
自的行书怎么写	紫的行书怎么写
生理期可以吃什么水果	生理期可以吃什麼水果
腹腔淋巴结肿大的症状	腹腔淋巴结肿大的证状
低血糖的症状有哪些	低雪糖的症状有哪些
感冒会拉肚子吗	感冒回拉肚子吗
六味地黄丸和逍遥丸可以一起吃吗	六味地黄丸和消遥丸可以一起吃吗
婴儿退烧药有哪些	婴儿退烧药有那些
为什么登录不了支付宝	为什么登入不了支付宝
为什么登录不了支付宝	为什么登入不了支付宝
为什么登录不了支付宝	为什么登入不了支付宝
为什么登录不了支付宝	为什么登入不了支付宝
为什么登录不了支付宝	为什么登入不了支付宝
为什么登录不了支付宝	为什么登入不了支付宝
为什么登录不了支付宝	为什么登入不了支付宝
为什么登录不了支付宝	为什么登入不了支付宝
为什么登录不了支付宝	为什么登入不了支付宝
食管癌遗传吗	食管癌移传吗
消逝的光芒怎么丢炸弹	消失的光芒怎么丢炸弹
口腔溃疡吃什么药	口强溃疡吃什么药
内分泌失调是什么症状	内分泌失调是什么证状
老人补钙哪个牌子好	老人补钙那个牌子好
膀胱炎的症状	膀胱炎的证状
黄疸型肝炎能治好吗	黄疸性肝炎能治好吗
女生下面流水怎么回事	女生下面留水怎么回事
疱疹和湿疹	泡疹和湿疹
尿道疼痛是什么原因	尿道疼痛是甚么原因
喝藿香正气水能喝酒吗	和藿香正气水能喝酒吗
书籍是人类进步的阶梯是谁说的	书记是人类进步的阶梯是谁说的
法制是什么	法治是什么
猫为什么舔爪子	猫为什么添爪子
腰椎管狭窄的治疗方法	腰椎管侠窄的治疗方法
梦到自己被狗咬	梦到自己备狗咬
叶绍翁是哪个朝代的	叶少翁是哪个朝代的
肚子胀是什么原因	肚子帐是什么原因
脸上突然长斑是什么原因	脸上突然张斑是什么原因
怎样戴古筝指甲	怎样带古筝指甲
心率不齐的危害	心律不齐的危害
明宣宗之后是哪个皇帝	明宪宗之后是哪个皇帝
孕妇可以喝金银花茶吗	孕妇可以喝紧银花茶吗
宅是啥意思	斋是啥意思
拉肚子吃什么药	拉度子吃什么药
宽带密码怎么改	宽带秘码怎么改
枸杞红枣泡水喝的功效	狗杞红枣泡水喝的功效
种植牙的费用	种植牙得费用
大便墨绿色怎么回事	大便默绿色怎么回事
月经推迟的危害	月经推迟得危害
做完人流腰疼怎么回事	坐完人流腰疼怎么回事
怀孕多久有孕吐反应	怀孕多久有孕吐反映
孕妇可以吃银耳吗	孕妇可以吃银耳妈
如何注册微信号	如何注册微信好
酒喝多了头疼怎么办	就喝多了头疼怎么办
被蟑螂咬了怎么办	背蟑螂咬了怎么办
怀孕多久可以药流	怀孕多久可以药留
