章子怡是那里人	张子怡是那里人
例假前十天是安全期吗	例假前四天是安全期吗
月初十是什么星座	月初四是什么星座
五月十日是什么星座	五月四日是什么星座
十和十五用短除法计算	四和十五用短除法计算
十除零点四	四除零点四
刘晓燕哪里人	刘小燕哪里人
十月四日是什么星座	四月四日是什么星座
刘恺威多少岁数	刘凯威多少岁数
贾玲多少岁了	嘉玲多少岁了
四的多少次方等七	十的多少次方等七
王健林哪里人	王建林哪里人
表格四次方怎么打出来	表格十次方怎么打出来
韩语姐姐怎么说	汉语姐姐怎么说
四mod两等多少	十mod两等多少
十字短句签名	四字短句签名
二十除几等十	二十除几等四
唐嫣哪里人	唐岩哪里人
朱德是那里人	朱徳是那里人
我国十大名画有哪些	我国四大名画有哪些
三点四除十等多少	三点四除四等多少
