小孩补什么钙好	小孩补什么盖好
被猫咬了要打针吗	背猫咬了要打针吗
肺结节是什么	肺接节是什么
阿长与山海经滴主要内容是什么	阿长与山海经的主要内容是什么
脚后跟疼是什么原因	脚后跟疼是什么愿因
慢性肠胃炎吃什么药	漫性肠胃炎吃什么药
肠梗阻怎么治疗	肠耿阻怎么治疗
被蜜蜂蛰了怎么处理	被密蜂蛰了怎么处理
先兆流产的症状	先找流产的症状
胰腺是什么	遗腺是什么
甲状腺结节有什么症状	甲状腺结节有什么证状
黄瓜片敷脸有什么好处	黄瓜片肤脸有什么好处
梦见被蛇咬	梦见备蛇咬
心血管堵塞	心学管堵塞
来月经可以运动吗	来月经可以动动吗
吃什么养胃	吃十么养胃
植物神经功能紊乱有哪些症状	植物神精功能紊乱有哪些症状
孕妇能吃牛油果吗	孕妇能吃牛油果妈
胸部胀痛是不是怀孕了	胸不胀痛是不是怀孕了
猪脚闷莲藕的做法大全家常	猪脚焖莲藕的做法大全家常
章子怡是那里人	张子怡是那里人
打耳洞疼吗	打儿洞疼吗
含人体器官的成语	含人体器关的成语
蜂蜜的功效与作用	蜂密的功效与作用
带状疱疹的症状	带壮疱疹的症状
婴儿流黄鼻涕	婴儿留黄鼻涕
糖尿病人能吃花生吗	塘尿病人能吃花生吗
甲状腺结节	甲妆腺结节
眼皮肿了怎么办	眼皮肿了怎么半
脂肪肝有什么症状	脂肪肝有什么正状
咽喉炎怎么治疗	咽候炎怎么治疗
糖尿病可以吃核桃吗	唐尿病可以吃核桃吗
什么是注册资本	什么事注册资本
嘴巴周围长痘	嘴巴周围张痘
膝盖痛是什么原因	希盖痛是什么原因
颈椎病症状	颈椎病政状
没有户口本怎么迁户口	没有户口本怎么签户口
打嗝放屁是怎么回事	大嗝放屁是怎么回事
举头三尺有神明	举头三尺有神名
乙肝吃什么药	亿肝吃什么药
月经推迟二十天正常吗	月经退迟二十天正常吗
右脚大拇指发麻	右脚大母指发麻
尿道炎吃什么药	尿到炎吃什么药
乳房疼痛怎么回事	乳房疼痛怎么会事
胃下垂的症状	胃下垂的症壮
甲亢不能吃什么	甲抗不能吃什么
血小板偏高	血小版偏高
便秘吃什么	便秘吃什药
脚后跟疼怎么治疗	脚后跟疼怎么制疗
关节积液怎么治疗	关节积夜怎么治疗
用手机怎么批照片	用手机怎么劈照片
带状疱疹看什么科	带状疱诊看什么科
心脏供血不足怎么治	心脏功血不足怎么治
有痰咳不出来吃什么药	有谈咳不出来吃什么药
糖尿病的前期症状	唐尿病的前期症状
地中海贫血	地种海贫血
怀孕可以吃螺丝粉吗	怀孕可以吃罗丝粉吗
嗓子哑了怎么办	嗓子哑了怎么半
感冒了鼻子不通气怎么办	感冒了鼻子不痛气怎么办
带状疱疹的症状	带状疱疹的正状
左手发麻怎么回事	左手发麻怎么会事
眼睛有红血丝怎么办	眼精有红血丝怎么办
牙龈老出血怎么回事	牙龈老出血怎么会事
乳房疼是怎么回事	乳房疼是怎么回是
人体正常体温	人体正长体温
神经性头痛怎么治疗	神精性头痛怎么治疗
乙肝e抗体阳性	已肝e抗体阳性
脚跟痛是什么原因	脚根痛是什么原因
怀孕为什么会流血	怀孕为什么会留血
在括号里填上合适的数	再括号里填上合适的数
房事后有血怎么回事	房是后有血怎么回事
怀孕多久可以测出来	怀孕多久可以侧出来
为什么会长痤疮	为什么会张痤疮
鬼压床是怎么回事	鬼押床是怎么回事
慢性胃炎怎么调理	漫性胃炎怎么调理
缺氧怎么办	缺氧怎么半
营养不良的症状	营养不良的证状
如何去除法令纹	如何去除法另纹
神经性耳聋的治疗方法	神精性耳聋的治疗方法
缺少维生素c的症状	却少维生素c的症状
为什么手机收不到验证码	为什么手机收不到验正码
中兴通讯怎么样	中兴通迅怎么样
胃胀气怎么回事	胃长气怎么回事
封闭针是什么	封毕针是什么
怎样快速长高	怎样快速张高
男性性病怎么治	男性姓病怎么治
为什么会得白血病	为什么会德白血病
平均血小板体积偏低	评均血小板体积偏低
孕妇可以喝蜂蜜柚子茶吗	孕妇可以喝蜂密柚子茶吗
尿毒症有什么症状	尿毒症有什么证状
孕妇能吃韭菜吗	孕夫能吃韭菜吗
来月经可以泡脚吗	来月经可以跑脚吗
包皮红肿怎么回事	包皮红重怎么回事
糖尿病能吃苹果吗	塘尿病能吃苹果吗
个人简历自我评价怎么写	个人简力自我评价怎么写
血压过低是什么原因	血压过第是什么原因
结婚祝贺词	结婚祝合词
关节响是怎么回事	关结响是怎么回事
西葫芦怎么做好吃	西胡芦怎么做好吃
怀孕能不能泡温泉	怀孕能不能跑温泉
白细胞高怎么回事	白细胞高怎么会事
月经有血块怎么回事	月精有血块怎么回事
剖腹产后多久可以下床	破腹产后多久可以下床
坐骨结节滑囊炎的症状	坐股结节滑囊炎的症状
必须犯规的游戏	必须范规的游戏
绿豆解药吗	绿豆接药吗
舌头有裂纹是怎么回事	舌头有列纹是怎么回事
脚趾麻木是怎么回事	脚趾麻目是怎么回事
拉肚子怎么回事	拉肚子怎么会事
经常打嗝是什么病	经常打隔是什么病
糖尿病能吃水果吗	唐尿病能吃水果吗
甲状腺癌能吃豆制品吗	甲壮腺癌能吃豆制品吗
破腹产后腹胀怎么办	剖腹产后腹胀怎么办
什么运动可以瘦肚子	什么运动可以收肚子
带状疱疹怎么治疗	带装疱疹怎么治疗
低血糖吃什么	低血糖吃什药
肺热的症状	肺热的正状
肺结核有什么症状	肺结核有什么症壮
微信密码忘记了怎么办	微信蜜码忘记了怎么办
来月经可以喝蜂蜜水吗	来月经可以喝峰蜜水吗
经常做梦是什么原因	经常坐梦是什么原因
怀孕初期出血	怀孕出期出血
哺乳期可以吃巧克力吗	补乳期可以吃巧克力吗
脑动脉硬化	脑动脉硬花
经常放屁好不好	经长放屁好不好
菠萝上火吗	菠罗上火吗
白癜风会传染吗	白癜风会传然吗
乙肝的症状有哪些	已肝的症状有哪些
脑供血不足怎么办	脑供血不足怎么半
膀胱炎有什么症状	膀胱炎有什么症壮
无线路由器怎么设置	无线露由器怎么设置
嗓子发炎吃什么药	桑子发炎吃什么药
脚后跟痛怎么办	脚后根痛怎么办
霉菌阴道炎	霉菌阴到炎
引产有多痛	引产有多疼
月经来之前乳房疼怎么回事	月经来之前乳房痒怎么回事
心脏早搏如何治疗	心脏早博如何治疗
脚麻木是怎么回事	脚麻模是怎么回事
结肠炎有那些症状	结长炎有那些症状
腿酸是怎么回事	腿酸是怎么会事
牙齿疼怎么办	芽齿疼怎么办
痛经吃什么	痛经吃什药
什么东西补肾	什么东西布肾
尿道炎吃什么药	尿导炎吃什么药
蜜蜂蛰了怎么处理	蜜峰蛰了怎么处理
高血糖可以吃什么水果	高雪糖可以吃什么水果
心脏供血不足吃什么药	心赃供血不足吃什么药
痛风病人能吃菠菜吗	痛风病人能吃波菜吗
内分泌失调怎么调理	内分秘失调怎么调理
吃什么可以长胖	吃什么可以涨胖
怎样才能长胖	怎杨才能长胖
肾的生理功能是什么	肾的生里功能是什么
美容养颜喝什么茶	美蓉养颜喝什么茶
慢性浅表性胃炎的症状	慢性浅表性胃炎的政状
臀部疼痛是什么原因	屯部疼痛是什么原因
如何恢复视力	如何会复视力
电子烟对身体有害吗	电子烟队身体有害吗
性刘的女明星有哪些人	姓刘的女明星有哪些人
打狂犬育苗可以吃芒果吗	打狂犬预苗可以吃芒果吗
咸鱼退款卖家拒绝	闲鱼退款卖家拒绝
心脏早搏吃什么药	心藏早搏吃什么药
晚上做恶梦是什么原因	晚上坐恶梦是什么原因
检查尿常规多少钱	检查尿长规多少钱
妊娠糖尿病能吃玉米吗	妊娠唐尿病能吃玉米吗
神经官能症吃什么药	神经官能证吃什么药
甲沟炎用什么药膏	甲钩炎用什么药膏
心脏不好吃什么	心脏不好吃什药
家长意见和建议	家长意见和建意
无花果的功效	无花果的公效
乙肝有哪些症状	艺肝有哪些症状
肾功能检查有哪些项目	肾公能检查有哪些项目
汗蒸完多久可以洗澡	汉蒸完多久可以洗澡
脚浮肿怎么办	脚俘肿怎么办
吃果导片有什么副作用	吃果倒片有什么副作用
慢性咽炎的症状	慢性咽炎的证状
宫颈癌前期有什么症状	宫颈癌前期有什么证状
坐月子能吃甜瓜吗	坐月子能吃田瓜吗
糖尿病的症状有哪些	糖尿病的证状有哪些
淋巴瘤有什么症状	淋巴瘤有什么证状
脚心疼怎么回事	脚心疼怎么会事
腿部肌肉酸痛	腿不肌肉酸痛
手脱皮是什么原因	手拖皮是什么原因
皮肤发痒怎么回事	皮夫发痒怎么回事
人有多少颗牙齿	人有多少克牙齿
神经炎是什么症状	神精炎是什么症状
脸上长斑怎么办	脸上长办怎么办
痛风能喝白酒吗	痛风能喝百酒吗
世界上最小的国家	事界上最小的国家
搪瓷锅可以熬中药吗	唐瓷锅可以熬中药吗
0六年是闰哪个月	0六年是润哪个月
足跟滑囊炎怎么治疗	足根滑囊炎怎么治疗
双氯芬酸钠栓的作用与功效	双氯芬酸纳栓的作用与功效
坐骨神经痛吃什么药	坐骨神精痛吃什么药
打开付款吗	打开付款码
感冒喉咙痛怎么办	感冒候咙痛怎么办
长辈过生日送什么花	长背过生日送什么花
白内障怎么治疗	百内障怎么治疗
肚脐眼痛是怎么回事	肚齐眼痛是怎么回事
脉搏一分钟九十下正常吗	脉博一分钟九十下正常吗
宝宝缺钙的表现	宝宝确钙的表现
怎么教孩子画画	怎么教孩子画花
考瓷牙多少钱一颗	烤瓷牙多少钱一颗
长痘痘的原因是什么	张痘痘的原因是什么
头皮糠疹治疗方法	头皮康疹治疗方法
怎样才能戒烟	怎样才能介烟
萝卜樱怎么做好吃	萝卜婴怎么做好吃
透析一次多少钱	透希一次多少钱
小腹坠胀怎么回事	小腹赘胀怎么回事
胳膊麻木怎么回事	胳膊麻木怎么会事
橙子怎么吃	橙字怎么吃
梅毒的症状	梅毒的证状
喉咙有痰怎么办	侯咙有痰怎么办
小腹坠痛外阴瘙痒	小腹坠疼外阴瘙痒
几何体是什么	几和体是什么
肚子饿了怎么办	度子饿了怎么办
神经性头痛怎么治疗	神经性头通怎么治疗
肝火旺盛吃什么药	肝火旺胜吃什么药
端午节的习俗	端午节的习素
哺乳期能吃茄子吗	补乳期能吃茄子吗
经期能艾灸吗	经期能爱灸吗
减肥期间可以吃核桃吗	减肥期间可一吃核桃吗
女性更年期年龄	女姓更年期年龄
柠檬蜂蜜水的功效	拧檬蜂蜜水的功效
血氧饱和度低怎么办	血养饱和度低怎么办
怎么治疗静脉曲张	怎么制疗静脉曲张
手麻木怎么回事	手麻木怎么会事
盆腔积液是怎么引起的	喷腔积液是怎么引起的
海鲜过敏怎么办	还鲜过敏怎么办
白花蛇舌草功效与作用	白花蛇蛇草功效与作用
支气管哮喘	支气官哮喘
吃太胀了怎么办	吃太涨了怎么办
盆腔炎吃什么药	盆腔严吃什么药
如何治疗抑郁症	如何治疗抑郁证
怎样快速去眼袋	怎样快速去眼带
功能性消化不良怎么治	功能性销化不良怎么治
肝功能挂什么科	肝工能挂什么科
蓝光眼镜有必要带吗	蓝光眼镜有必要戴吗
微信号怎么注销	微信号怎么注消
月经推迟吃什么药	月经退迟吃什么药
胃肠功能紊乱的症状	胃肠功能稳乱的症状
如何培养孩子的自信	如何陪养孩子的自信
阴虚火旺吃什么药	阴虚火望吃什么药
开水烫伤会留疤吗	开水烫伤回留疤吗
月经期能喝柠檬水吗	月经期能喝宁檬水吗
精索静脉曲张	精索静脉曲掌
生姜蜂蜜水能减肥吗	生姜蜂密水能减肥吗
烧心反酸怎么办	烧心返酸怎么办
天麻的功效与作用	天麻的功效与做用
手机听筒声音小怎么办	手机听桶声音小怎么办
东南西北怎么折	动南西北怎么折
苹果手机怎么设置来电铃声	苹果手机怎么设置来点铃声
急性心肌梗死的治疗方法	急性心机梗死的治疗方法
大便拉不出来怎么办	大便垃不出来怎么办
哺乳期可以烫发吗	哺乳期可以汤发吗
现在什么行业好做	现在什麼行业好做
蒲公英泡水喝的功效	朴公英泡水喝的功效
左下腹痛怎么回事	左下复痛怎么回事
膝盖痛是什么原因	息盖痛是什么原因
水痘症状图片	水逗症状图片
腹泻能吃什么水果	腹泄能吃什么水果
早上起来头晕是怎么回事	早上起来头晕是怎么会事
胸闷胸痛怎么办	胸闷熊痛怎么办
卵巢囊肿会影响怀孕吗	卵巢囊种会影响怀孕吗
宝宝喉咙有痰怎么办	宝宝吼咙有痰怎么办
喜帖街的歌词	喜贴街的歌词
小孩正常体温是多少度	小孩正长体温是多少度
房性早搏是怎么回事	房行早搏是怎么回事
坐骨神经痛症状	坐骨神经痛症壮
脚扭伤肿了怎么办	脚纽伤肿了怎么办
龟头炎的症状	龟头炎的证状
吃坏肚子怎么办	吃坏肚子怎么半
无痛胃镜是怎么麻醉的	无痛胃经是怎么麻醉的
高血糖吃什么水果	高雪糖吃什么水果
种植牙能用多久	种值牙能用多久
什么叫定向流量	什么教定向流量
莲耦怎么做才好吃	莲藕怎么做才好吃
我国的四大发明是什么	我国的四大发名是什么
柠檬泡水功效	宁檬泡水功效
滴虫性阴道炎的症状	滴虫性阴道炎的证状
什么是世界文化遗产	十么是世界文化遗产
脑供血不足怎么治疗	脑功血不足怎么治疗
乙肝喝什么茶好	已肝喝什么茶好
频发房性早搏严重吗	频发房性早博严重吗
多囊卵巢综合症	多馕卵巢综合症
糖尿病人能吃桃子吗	塘尿病人能吃桃子吗
吃完榴莲可以喝牛奶吗	吃完榴连可以喝牛奶吗
淋巴细胞百分比偏高	琳巴细胞百分比偏高
嗓子哑了怎么办	嗓子哑了怎么班
喉咙长息肉有什么症状	喉咙张息肉有什么症状
社保卡怎么激活	社宝卡怎么激活
女孩子取什么名字好听	女孩子娶什么名字好听
冰箱为什么不制冷	冰箱为什么不治冷
舌苔白是怎么回事	舌台白是怎么回事
保护环境的标语	报护环境的标语
牙齿有裂痕是什么原因	牙齿有列痕是什么原因
坐骨神经痛看什么科	座骨神经痛看什么科
包皮过长手术要多少钱	保皮过长手术要多少钱
湿气重吃什么药	湿汽重吃什么药
苹果手机通讯录怎么批量删除	苹果手机通迅录怎么批量删除
怀孕会犯困吗	怀孕会范困吗
绿萝的营养液怎么配	绿箩的营养液怎么配
眼睛有红血丝怎么回事	眼精有红血丝怎么回事
前列腺增生有什么症状	前列腺增生有什么症壮
脸上长斑是什么原因	脸上张斑是什么原因
香蕉和酸奶可以一起吃吗	香焦和酸奶可以一起吃吗
经常放屁是什么原因	经常放屁是什么愿因
怎么删除淘宝订单	怎么删除淘宝定单
怎么在淘宝上开网店	怎么在陶宝上开网店
坏肚子吃什么	坏肚子吃什药
输卵管积液是怎么回事	输卵管积液是怎么会事
红细胞计数偏高是什么原因	红细胞记数偏高是什么原因
荨麻疹注意事项	荨麻诊注意事项
肝钙化是什么意思	肝丐化是什么意思
我的世界怎么去天堂	我的世界怎麼去天堂
肛肠息肉怎么治	刚肠息肉怎么治
淋巴结肿大是什么原因	淋疤结肿大是什么原因
脉搏八十五正常吗	脉博八十五正常吗
肝不好有哪些症状	肝不好有哪些症壮
脸上一直长痘痘是什么原因	脸上一直张痘痘是什么原因
咽炎吃什么药效果最好	咽严吃什么药效果最好
揉腹部的正确方法	揉腹补的正确方法
胳膊扭伤怎么办	胳膊纽伤怎么办
半月板损伤怎么治疗	板月板损伤怎么治疗
佛山到桂林货车	佛山到桂林火车
水痘和疱疹的区别	水逗和疱疹的区别
怎样申请低保	怎样伸请低保
水丸和蜜丸的区别	水丸和密丸的区别
湿气重怎么治疗	湿汽重怎么治疗
熬夜喝什么好	敖夜喝什么好
毛囊炎症状	毛囊炎证状
脚痒脱皮怎么办	脚氧脱皮怎么办
黄体酮和地屈孕酮片的区别	黄体酮和地区孕酮片的区别
尿血是怎么回事	尿血是怎么会事
人的正常体温	人的正尝体温
左卵巢囊肿	做卵巢囊肿
胆囊炎的症状	胆囊研的症状
微信如何升级	微信如何生级
额头下巴长痘痘是什么原因	额头下巴涨痘痘是什么原因
一岁宝宝呕吐	一岁宝宝欧吐
糖尿病人能吃南瓜吗	唐尿病人能吃南瓜吗
黑豆的功效与作用	黑豆的功效与做用
根据词语的不同意思造句	跟据词语的不同意思造句
脚底疼怎么回事	脚底疼怎么会事
换个充点口多少钱	换个充电口多少钱
玫瑰代表着什么意思	玫瑰带表着什么意思
月经不调怎么办	月经不条怎么办
上火吃什么水果好	上活吃什么水果好
放疗和化疗有什么区别	方疗和化疗有什么区别
蒸生蚝多长时间	整生蚝多长时间
白带有血丝怎么回事	白代有血丝怎么回事
绝经前的症状	绝经前的证状
生理期可以洗头发吗	生理期可以冼头发吗
白带异常怎么办	百带异常怎么办
心肌缺血的症状	心肌缺血的证状
耳朵痒是怎么回事	儿朵痒是怎么回事
乳腺癌是什么症状	乳腺言是什么症状
胸口闷怎么回事	胸口闷怎么会事
怎么还原魔方	怎么还原摩方
头晕恶心是怎么回事	头晕恶心是怎么会事
经常拉肚子是什么原因	经常垃肚子是什么原因
宫颈炎症状	宫颈炎正状
甲状腺结节	甲状线结节
新生儿体温多少正常	新生二体温多少正常
淋巴细胞偏低	琳巴细胞偏低
感冒吃什么水果好	感帽吃什么水果好
甲状腺旁腺瘤严重吗	甲状腺旁线瘤严重吗
怀孕初期吃什么好	坏孕初期吃什么好
经期能吃菠萝蜜吗	经期能吃菠萝密吗
灰指甲传染吗	灰之甲传染吗
口腔溃疡吃什么药	口腔溃疡吃十么药
抑郁症怎么治疗	抑郁症怎么治辽
肠梗阻怎么治疗	肠梗组怎么治疗
哺乳期能吃大蒜吗	补乳期能吃大蒜吗
减肥可以吃葡萄吗	减肥可以吃葡萄妈
小腹胀痛是怎么回事	小腹长痛是怎么回事
哮喘病的症状	哮喘病的证状
肺部有结节严重吗	肺不有结节严重吗
不停打嗝怎么办	不挺打嗝怎么办
小脑萎缩的症状	小闹萎缩的症状
眼睛充血用什么眼药水	眼睛冲血用什么眼药水
肚子咕噜咕噜响	肚子咕噜咕噜想
火锅鸡的做法	活锅鸡的做法
结肠炎有那些症状	结肠炎有那些正状
别人欠钱不还怎么办	别人歉钱不还怎么办
来月经可以刮痧吗	来月经可以括痧吗
空腹血糖正常值范围	空服血糖正常值范围
有痰咳不出来怎么办	有谈咳不出来怎么办
舌苔发黑是什么原因	舌苔发嘿是什么原因
胃肠胀气吃什么药	胃长胀气吃什么药
腿疼是什么原因	腿疼是什么愿因
滴虫性阴道炎治疗	滴虫性阴到炎治疗
骨裂和骨折的区别	股裂和骨折的区别
中暑的症状	种暑的症状
水浒传作者	谁浒传作者
脑部核磁共振多少钱	脑步核磁共振多少钱
最近老放屁怎么回事	最近老放屁怎么会事
脚趾甲往肉里长怎么办	脚止甲往肉里长怎么办
怎么去除痘印	怎么去除逗印
人流后多久来月经	人流后多久莱月经
脸上长斑怎么处理	脸上长班怎么处理
好听的男孩名字	好听的男孩名子
打呼噜是怎么回事	打呼噜事怎么回事
螃蟹死了还能吃吗	庞蟹死了还能吃吗
大便不成形是什么原因	打便不成形是什么原因
脖子后面长痘	脖子后面张痘
尿液混浊是怎么回事	尿夜混浊是怎么回事
什么是神经性尿频	什么是神精性尿频
坐月子可以洗澡吗	昨月子可以洗澡吗
手腕酸痛是怎么回事	手湾酸痛是怎么回事
来大姨妈吃什么水果	来大姨妈吃什麼水果
经常放屁是怎么回事	经常方屁是怎么回事
焦虑症的症状	焦虑症的症壮
查乙肝五项需要空腹吗	差乙肝五项需要空腹吗
食物中毒症状	食物种毒症状
葡萄的功效	葡萄的公效
慢性胃炎可以吃苹果吗	漫性胃炎可以吃苹果吗
双侧肾盂未见明显分离是什么意思	双测肾盂未见明显分离是什么意思
支付宝怎么赚钱给别人	支付宝怎么传钱给别人
肉苁蓉怎么泡酒	肉苁蓉怎么炮酒
肺炎吃什么药	费炎吃什么药
肝不好吃什么	肝不好吃什药
月经来了能吃芒果吗	月经来了能吃茫果吗
怎样提高免疫力	怎样题高免疫力
烤瓷牙一颗多少钱	考瓷牙一颗多少钱
玫瑰糠疹怎么治疗	玫瑰康疹怎么治疗
供血不足吃什么	公血不足吃什么
膝盖疼是怎么回事	膝盖疼是怎么会事
拔罐拔出水泡怎么办	拔管拔出水泡怎么办
暑湿感冒吃什么药	署湿感冒吃什么药
拉不出来屎怎么办	拉不出来时怎么办
落枕脖子疼怎么办	洛枕脖子疼怎么办
静脉曲张怎么治	静迈曲张怎么治
肺部结节怎么治疗	肺部结界怎么治疗
掉头发是什么原因	掉头发是什么愿因
心情不好怎么办	心请不好怎么办
黑头怎么去掉	黒头怎么去掉
扁桃体发炎吃什么药	变桃体发炎吃什么药
银耳的功效与作用	银儿的功效与作用
什么是躁郁症	什么是躁郁证
现在流行什么装修风格	现在留行什么装修风格
新生儿喉咙有痰怎么办	新生儿候咙有痰怎么办
神经衰弱如何治疗	神精衰弱如何治疗
打嗝是什么原因引起的	大嗝是什么原因引起的
怀孕一周的征兆	还孕一周的征兆
慢性浅表性胃炎伴糜烂	漫性浅表性胃炎伴糜烂
感冒嗓子哑	感冒桑子哑
手脱皮怎么回事	手脱皮怎么会事
动感单车减肥效果好吗	动敢单车减肥效果好吗
尿液发红怎么办	尿夜发红怎么办
肚子上的赘肉怎么减	肚子上的坠肉怎么减
没有反回键	没有返回键
幽门螺旋杆菌高温能杀死吗	优门螺旋杆菌高温能杀死吗
梦到自己被狗咬	梦到自己背狗咬
乙型肝炎表面抗体阳性是什么意思	乙行肝炎表面抗体阳性是什么意思
拉肚子吃什么药	垃肚子吃什么药
失眠吃什么	失眠吃什药
脂肪肝是什么症状	脂肪肝是什么证状
治湿疹的药膏	制湿疹的药膏
如何补气血	入何补气血
神经衰弱的症状	神经衰弱的整状
经常熬夜的人吃什么好	经长熬夜的人吃什么好
宝宝贫血有什么症状	宝宝贫血有什么证状
我国汛期最长的河流	我过汛期最长的河流
怎么在网上交电费	怎么再网上交电费
结肠炎什么症状	结肠炎什么证状
鼻子下面有点痛	鼻子下面有点疼
三角形的周长公式	三角形的周常公式
大便频繁是怎么回事	大便频烦是怎么回事
胀气的食物有哪些	帐气的食物有哪些
牙齿痛怎么办	牙吃痛怎么办
经常腹泻是什么原因	经常复泻是什么原因
做完双眼皮注意事项	做玩双眼皮注意事项
刮痧后多久可以洗澡	刮痧後多久可以洗澡
口臭是怎么回事	口臭是怎么会事
有痰咳不出怎么办	有谈咳不出怎么办
甲状腺结节的危害	甲状腺结节的威害
人工流产需要多少钱	人工流产许要多少钱
牛黄上清片的功效与作用	牛黄上青片的功效与作用
带状疱疹是怎么引起的	带壮疱疹是怎么引起的
感冒喉咙痛吃什么药好	感冒吼咙痛吃什么药好
银行卡怎么激活	银行卡怎么几活
分泌性中耳炎怎么治疗	分密性中耳炎怎么治疗
结扎了还能接上吗	接扎了还能接上吗
肠胃炎吃什么好	肠胃炎吃什药好
华为手机如何截屏	华维手机如何截屏
手机刷机怎么刷	手机耍机怎么刷
尿道感染吃什么消炎药	尿到感染吃什么消炎药
空腹喝牛奶好吗	空服喝牛奶好吗
怎么删除淘宝订单	怎么删除陶宝订单
不吃早餐的危害	不吃早餐的威害
心梗的症状有哪些症状	心埂的症状有哪些症状
一直打嗝怎么办	一直大嗝怎么办
胰腺炎的症状是什么	胰腺炎的证状是什么
尖锐湿疣的症状	尖锐湿疣的正状
坐骨神经痛症状	坐骨神经痛证状
怀孕怎么分辨男女	怀孕怎么分变男女
胃炎有什么症状	胃炎有什么证状
经常腹泻是怎么回事	经常复泻是怎么回事
糖尿病能活多久	唐尿病能活多久
胃食管反流吃什么药	胃食馆反流吃什么药
先有鸡还是先有蛋	先右鸡还是先有蛋
血氧饱和度正常值	血养饱和度正常值
腊七腊八冻死寒鸦的意思	蜡七腊八冻死寒鸦的意思
癣会传染吗	显会传染吗
社区戒毒期限	社区介毒期限
双侧卵巢多囊	双测卵巢多囊
膝盖响怎么回事	希盖响怎么回事
打完玻尿酸多久可以洗脸	打完波尿酸多久可以洗脸
星座按阴历还是阳历算	星座安阴历还是阳历算
如何治疗脑梗	如何治疗脑埂
榴莲的营养价值	留莲的营养价值
贫血怎么办	贫血怎么半
转氨酶高的原因	转安酶高的原因
前列腺增生吃什么药	前裂腺增生吃什么药
流清鼻涕吃什么药	留清鼻涕吃什么药
氯化钠是不是生理盐水	录化钠是不是生理盐水
口臭是什么原因引起的	口臭是什麼原因引起的
无痛人流要多少钱	无通人流要多少钱
精神分裂症吃什么药最好	精神分裂证吃什么药最好
吃红糖会发胖吗	吃红唐会发胖吗
甲状腺结节有什么症状	甲装腺结节有什么症状
丙型肝炎的症状	丙性肝炎的症状
息屏时间	熄屏时间
验孕棒怎么看	验晕棒怎么看
小孩几岁换牙	小骇几岁换牙
月经期能吃芒果吗	月经期能吃忙果吗
尿毒症有什么症状	尿毒证有什么症状
支原体感染是什么意思	支愿体感染是什么意思
颈纹怎么消除	颈纹怎么消处
京东优惠卷怎么兑换	京东优惠劵怎么兑换
烂脚丫怎么治	烂觉丫怎么治
怎样消除黑眼圈	怎样消出黑眼圈
吃什么能提高免疫力	吃什么能提高勉疫力
尿酸高是怎么回事	尿酸高是怎么回是
做散瞳对眼睛有伤害吗	做散童对眼睛有伤害吗
怀孕初期可以吃西瓜吗	怀孕出期可以吃西瓜吗
豆浆机什么牌子的好	豆将机什么牌子的好
胆汁反流性胃炎的症状	胆汁反流性胃炎的证状
颈部淋巴结肿大	颈部淋巴节肿大
抑郁症怎么治疗	意郁症怎么治疗
小腹隐隐作痛是什么原因	小腹隐隐做痛是什么原因
梦见自己生孩子	梦见自几生孩子
老年性皮肤瘙痒症	老年性皮肤瘙痒证
子宫肌瘤能吃鸡肉吗	子宫几瘤能吃鸡肉吗
慢性胃炎可以吃鱼子吗	慢性胃炎可以吃鱼籽吗
菠菜和鸡蛋能一起吃吗	波菜和鸡蛋能一起吃吗
夏桑菊颗粒的作用	夏嗓菊颗粒的作用
脾虚湿气重吃什么药	脾需湿气重吃什么药
高血压吃什么药	高学压吃什么药
胸部胀痛是不是怀孕了	胸部帐痛是不是怀孕了
半边头痛是怎么回事	办边头痛是怎么回事
膀胱炎有什么症状	旁胱炎有什么症状
内分泌失调怎么检查	内分泌时调怎么检查
精索静脉曲张的症状	精锁静脉曲张的症状
东革阿里的功效与作用	东格阿里的功效与作用
胡萝卜怎么做好吃	胡罗卜怎么做好吃
跳绳能减肥吗	调绳能减肥吗
密集恐惧症怎么治疗	密极恐惧症怎么治疗
乳腺癌手术后能活多久	乳现癌手术后能活多久
咽喉癌的症状	咽喉癌的证状
怎么去除地板上的乳胶漆	怎么祛除地板上的乳胶漆
眼皮上长麦粒肿怎么办	眼皮上张麦粒肿怎么办
月经量少影响怀孕吗	月经亮少影响怀孕吗
心电图导联位置	心点图导联位置
血管性头痛吃什么药	血官性头痛吃什么药
皮肤过敏的症状	皮肤过敏的正状
嘴巴周围长痘	最巴周围长痘
怎样利用网络赚钱	怎样立用网络赚钱
小提琴琴拖怎么安装	小提琴琴托怎么安装
膝关节韧带损伤	膝关节忍带损伤
心脏病的症状	心藏病的症状
微信密码忘记了怎么办	薇信密码忘记了怎么办
胆结石能喝牛奶吗	胆节石能喝牛奶吗
脚趾头痒是怎么回事	脚只头痒是怎么回事
开塞露可以擦脸吗	开塞路可以擦脸吗
请假条的格式	请加条的格式
葵花籽致癌吗	葵花籽治癌吗
太阳穴长痘怎么回事	太阳穴长痘怎么会事
人流后多久来月经	人留后多久来月经
胃里反酸水	胃里范酸水
手机如何快速充电	手机如何快速冲电
下肢静脉曲张的治疗	下支静脉曲张的治疗
喉咙干痛是怎么回事	喉咙千痛是怎么回事
红霉素软膏的作用	红霉素软高的作用
胃溃疡的症状有哪些	胃溃疡的证状有哪些
左胸疼是怎么回事	昨胸疼是怎么回事
肝脏不好有什么症状	肝脏不好有什么正状
脖子痒是怎么回事	脖子痒是怎么会事
下腹痛怎么回事	下复痛怎么回事
脾虚吃什么	脾虚吃什药
处女膜没破会怀孕吗	初女膜没破会怀孕吗
腰肌劳损有哪些症状	腰肌老损有哪些症状
长痘痘可以敷面膜吗	张痘痘可以敷面膜吗
不亦乐乎中的通假字	不亦说乎中的通假字
怀孕多久有胸胀的感觉	怀孕多久有胸涨的感觉
甲状腺球蛋白抗体高是什么意思	甲壮腺球蛋白抗体高是什么意思
甲状腺结节是什么	甲状线结节是什么
怎样去疤痕	怎样去巴痕
新鲜百合怎么吃	新鲜白合怎么吃
怎样联系记者	怎样联系记着
中暑的急救方法	重暑的急救方法
黄斑水肿怎么治疗	黄班水肿怎么治疗
银行一般几点上班	银行一搬几点上班
两月二十七日是什么星座	两月二十七日是什么星坐
橄榄油的功效与作用	橄兰油的功效与作用
恐龙是怎么死的	孔龙是怎么死的
血糖偏高怎么办	血唐偏高怎么办
银耳汤的功效与作用	银儿汤的功效与作用
包皮手术多少钱	抱皮手术多少钱
倒瓜子脸适合什么发型	到瓜子脸适合什么发型
月经期可以吃阿胶吗	月经期可以吃阿娇吗
蚕的生长过程	蚕的生长过成
浑身冷不发烧怎么回事	混身冷不发烧怎么回事
三个月宝宝流清鼻涕怎么办	三个月宝宝流青鼻涕怎么办
高血压怎么治疗	高血压怎么治辽
怎么搭配衣服好看	怎么打配衣服好看
烫伤了怎么办	烫伤了怎么半
北京的区号	背京的区号
脂肪肝有什么症状	脂防肝有什么症状
甲状腺炎症状	甲状线炎症状
怀男孩的症状	怀男孩的证状
微信怎么删除好友	微信怎么珊除好友
膀胱癌的症状	膀胱癌的证状
拉屎拉不出来怎么办	拉屎拉不出来怎么半
类风湿关节炎吃什么药	类凤湿关节炎吃什么药
乙型肝炎病毒核心抗体	乙性肝炎病毒核心抗体
坐骨神经痛是怎么回事	做骨神经痛是怎么回事
慢性咽炎的症状	慢性咽严的症状
脸上长痤疮怎么治疗	脸上张痤疮怎么治疗
怀孕多久能测出来	还孕多久能测出来
下巴长痘痘的原因	下疤长痘痘的原因
糖尿病可以吃黄瓜吗	塘尿病可以吃黄瓜吗
乙肝有哪些症状	已肝有哪些症状
子宫疼怎么回事	字宫疼怎么回事
乳房疼是怎么回事	乳妨疼是怎么回事
鱼刺卡在喉咙怎么办	鱼刺恰在喉咙怎么办
两边肋骨痛是什么原因	两边勒骨痛是什么原因
抑郁症能治愈吗	抑郁证能治愈吗
大三阳是什么	大三样是什么
为什么老露尿	为什么老漏尿
舌苔厚腻是怎么回事	舌台厚腻是怎么回事
避孕药安全吗	比孕药安全吗
怎样种植芹菜	怎样种值芹菜
甲状腺癌术后能活多久	胛状腺癌术后能活多久
我的世界怎么去天堂	我的世界怎么去天唐
血糖高吃什么水果	学糖高吃什么水果
单唾液酸四己糖神经节苷脂钠	单唾液酸四几糖神经节苷脂钠
脑动脉硬化怎么治疗	闹动脉硬化怎么治疗
肺癌的治疗方法	肺癌的制疗方法
老流鼻血怎么回事	老留鼻血怎么回事
女性尿结石的症状	女姓尿结石的症状
荨麻疹不能吃什么食物	荨麻诊不能吃什么食物
乳腺增生能不能吃蜂蜜	乳腺增升能不能吃蜂蜜
大便黑是怎么回事	大便黒是怎么回事
月经淋漓不尽怎么办	月经淋离不尽怎么办
支气管发炎怎么办	支汽管发炎怎么办
舌苔厚腻是怎么回事	舌态厚腻是怎么回事
怎样申请微信号	怎样身请微信号
吃方便面好吗	吃放便面好吗
决明子的功效	决明子的功校
肚子涨是什么原因	肚子涨是什么愿因
喉咙有痰是怎么回事	候咙有痰是怎么回事
月经推迟多久能测出怀孕	月经推迟多久能侧出怀孕
长期吃安眠药	常期吃安眠药
伤口化脓怎么处理	伤口化浓怎么处理
尿道感染怎么治	尿到感染怎么治
甲状腺球蛋白抗体高是怎么回事	甲壮腺球蛋白抗体高是怎么回事
吃什么增强免疫力	吃什么增强勉疫力
拉的黑色的屎怎么回事	拉的黑色的是怎么回事
青春痘疤痕怎么消除	青春豆疤痕怎么消除
记忆力差怎么办	记意力差怎么办
皮肤晒伤怎么办	皮夫晒伤怎么办
剪映怎么设置视频封面	剪影怎么设置视频封面
耳朵流水怎么办	耳多流水怎么办
血糖高可以吃玉米吗	雪糖高可以吃玉米吗
为什么脖子上长小肉粒	为什么勃子上长小肉粒
糖尿病可以吃玉米吗	塘尿病可以吃玉米吗
新鲜莲子的功效与作用	新鲜连子的功效与作用
蒸汽机谁发明的	蒸器机谁发明的
增强记忆力的食物	增强计忆力的食物
来月经可以喝豆浆吗	来月经可以喝豆江吗
耳朵后面长疙瘩	耳朵后面长疙搭
怎样申请微信号	怎样伸请微信号
葡萄是热性还是凉性	葡萄是热性还是良性
口腔溃疡吃什么好	口腔溃疡吃什药好
这是什么型号的	这是什么性号的
孕妇可以吃桂圆吗	孕妇可以吃桂元吗
南瓜怎么做好吃	难瓜怎么做好吃
艾灸盒怎么用	艾久盒怎么用
小孩经常流鼻血怎么办	小孩经长流鼻血怎么办
做仰卧起坐能减肥吗	做仰卧起座能减肥吗
血小板低是怎么回事	血小版低是怎么回事
例假肚子疼	历假肚子疼
哺乳期能用化妆品吗	补乳期能用化妆品吗
糖尿病早期症状	糖尿病早期症壮
坐月子可以吃什么水果	作月子可以吃什么水果
一岁宝宝拉肚子吃什么药	一岁宝宝垃肚子吃什么药
健脾胃的食物	建脾胃的食物
痛风能治断根吗	痛风能治段根吗
低血压症状	低血压证状
肠息肉有哪些症状	肠西肉有哪些症状
免疫球蛋白多少钱一针	免疫求蛋白多少钱一针
来月经腰痛	来月经要痛
如何一夜暴富	如何一夜爆富
怎么看苹果手机真假	怎么看平果手机真假
怀孕了拉肚子怎么办	怀孕了垃肚子怎么办
晚上吃香蕉有什么好处	晚上吃香焦有什么好处
梅毒的症状	梅毒的政状
红薯糖分高吗	红署糖分高吗
小腿酸痛是什么原因	小退酸痛是什么原因
脚趾甲长到肉里怎么办	脚止甲长到肉里怎么办
脸上长痘痘是什么原因	脸上涨痘痘是什么原因
小腿胀痛怎么办	小腿张痛怎么办
这个世界上谁最帅	这个事界上谁最帅
闲鱼的名字可以改吗	咸鱼的名字可以改吗
脚跟痛如何治疗	脚根痛如何治疗
颈椎压迫神经的症状	颈椎压迫神经的证状
支付宝如何充值	支付宝如何冲值
开塞露怎么用	凯塞露怎么用
肝硬化晚期症状	肝硬化晚期正状
热感冒怎么办	热感冒怎么半
怀孕多久可以查出男女	怀孕多久可以差出男女
蒲公英泡水喝的功效	普公英泡水喝的功效
治疗过敏性鼻炎的方法	制疗过敏性鼻炎的方法
梦见被鬼追杀	梦见背鬼追杀
如何找回微信密码	如何找会微信密码
嗓子疼喝什么好	嗓子痒喝什么好
心脏早搏是怎么引起的	心脏早博是怎么引起的
被开水烫伤起泡怎么办	被开水汤伤起泡怎么办
糖尿病人可以吃辣椒吗	唐尿病人可以吃辣椒吗
肾结石什么症状	肾结石什么证状
舌苔厚怎么办	舌太厚怎么办
抑郁症治疗方法	抑郁证治疗方法
静脉曲张吃什么药	静迈曲张吃什么药
先涂防晒霜还是隔离霜	先图防晒霜还是隔离霜
老烂腿怎么治	老兰腿怎么治
放屁臭是什么原因	防屁臭是什么原因
流清鼻涕是什么感冒	刘清鼻涕是什么感冒
普洱茶能减肥吗	谱洱茶能减肥吗
一万公积金能贷款多少	一万公积金能代款多少
湿疹的发病原因	湿诊的发病原因
血糖高可以吃红薯吗	血糖高可以吃红署吗
浑身发热但不发烧	混身发热但不发烧
乙肝小三阳会传染吗	乙干小三阳会传染吗
妊娠糖尿病可以吃什么水果	妊娠唐尿病可以吃什么水果
怀孕初期白带多是怎么回事	怀孕出期白带多是怎么回事
燃气初装费	燃气出装费
肾虚是什么症状	肾虚是什么证状
芒果吃多了会上火吗	茫果吃多了会上火吗
怎么可以瘦脸	怎么可以受脸
中暑了吃什么药	中署了吃什么药
内痔有什么症状	内痔有什么证状
怎么治疗腰肌劳损	怎么治疗腰肌老损
宝宝吃什么奶粉好	宝宝吃什麼奶粉好
保安族有多少人	保安组有多少人
如何申请小号	如何申清小号
如何去除体内的湿气	如何去处体内的湿气
肝脏血管瘤注意什么	肝脏血官瘤注意什么
宽带密码怎么查	宽带蜜码怎么查
支付宝如何解绑手机号	支付宝如何解邦手机号
甲状腺病传染吗	甲壮腺病传染吗
脖子疼怎么缓解	脖子痒怎么缓解
子宫内膜厚是什么原因	字宫内膜厚是什么原因
说话结巴怎么办	说话结吧怎么办
皮肤痒一抓就红	皮肤养一抓就红
孕妇打喷嚏肚子抽痛	孕妇打喷嚏肚子抽疼
前列腺炎吃什么药	前列线炎吃什么药
膀胱炎有什么症状	膀胱炎有什么证状
经常打嗝是怎么回事	经常打隔是怎么回事
心脏彩超多少钱	心赃彩超多少钱
慢性胃炎的症状	慢性胃炎的证状
结石不能吃什么	节石不能吃什么
卵子的存活时间	卵子的存火时间
怎样推迟月经	怎样推持月经
颈椎病的症状有哪些	颈椎病的证状有哪些
如何收缩毛孔	如何收索毛孔
经常打喷嚏是什么原因	经常打噴嚏是什么原因
低血糖是糖尿病吗	低雪糖是糖尿病吗
什么时候清明节	什么时候青明节
转氨酶高有什么症状	转氨酶高有什么证状
山药的功效与作用	山药的功效与做用
剖腹产后怎样减肥	破腹产后怎样减肥
尿道结石怎么治疗	尿道结实怎么治疗
胃肠功能紊乱的症状	胃肠工能紊乱的症状
甲状腺球蛋白高	甲壮腺球蛋白高
熬夜有什么危害	熬夜有什么威害
甲状腺切除的后遗症	甲状腺切除的后疑症
拔罐出水泡是怎么回事	拔罐出水疱是怎么回事
腹股沟在什么位置	服股沟在什么位置
硫磺皂洗脸好吗	流磺皂洗脸好吗
被蚂蚁咬了怎么办	被蚂蚁咬了怎么半
颈椎病怎样治疗	颈椎病怎样制疗
牛奶和香蕉可以同时吃吗	牛奶和香焦可以同时吃吗
泌尿结石吃什么可以排石	秘尿结石吃什么可以排石
胸闷气短是怎么回事	凶闷气短是怎么回事
晚上睡觉磨牙是什么原因	晚上睡觉模牙是什么原因
大乐透怎么中奖	大乐透怎么种奖
正常心率	正长心率
卖水果赚钱吗	卖水果转钱吗
高蛋白食物有哪些	高蛋百食物有哪些
血栓怎么治疗	学栓怎么治疗
地中海贫血	地重海贫血
盆腔积液是什么	盆腔积夜是什么
月经干净后几天是安全期	月经干经后几天是安全期
橄榄油的功效与作用	敢榄油的功效与作用
手麻是怎么回事	手麻是怎么会事
健身能长高吗	建身能长高吗
肩膀长痘痘是什么原因	肩膀张痘痘是什么原因
左下腹痛是怎么回事	左下复痛是怎么回事
经常头痛是什么原因	经常头痛是什么愿因
输卵管通而不畅怎么办	输卵管通儿不畅怎么办
丙氨酸转氨酶偏高是什么原因	丙氨酸转安酶偏高是什么原因
感冒喉咙痛吃什么药好	感帽喉咙痛吃什么药好
腰肌劳损怎么治疗	腰肌劳损怎么治辽
宝宝腹泻怎么办	宝宝复泻怎么办
宝宝老是揉眼睛是怎么回事	宝宝老是柔眼睛是怎么回事
脂肪肝怎么治	脂方肝怎么治
小腿痒是怎么回事	小退痒是怎么回事
月经推迟一天能测出怀孕吗	月经退迟一天能测出怀孕吗
乙型肝炎表面抗体阳性是什么意思	乙性肝炎表面抗体阳性是什么意思
新生儿湿疹怎么办	新生儿时疹怎么办
艾滋病的症状	艾滋病的政状
闭合性粉刺怎么治疗	闭和性粉刺怎么治疗
经常感冒是怎么回事	经长感冒是怎么回事
燃气热水器怎么安装	燃汽热水器怎么安装
手哆嗦是什么原因	手多嗦是什么原因
风油精可以口服吗	风油精可以口福吗
男性尿血是怎么回事	男姓尿血是怎么回事
孕妇能吃海参吗	孕妇能吃海参妈
感动中国十大人物	敢动中国十大人物
佝偻病是什么	佝楼病是什么
什么时候开学	十么时候开学
乙肝携带者传染吗	乙肝协带者传染吗
孕妇糖尿病对胎儿有什么影响	孕妇唐尿病对胎儿有什么影响
宝宝几个月可以坐	宝宝几个月可以座
小腹坠胀怎么回事	小腹坠涨怎么回事
桑叶的功效与作用	桑什的功效与作用
面瘫怎样按摩	面滩怎样按摩
被鬼上身怎么办	背鬼上身怎么办
黑枸杞多少钱一斤	黒枸杞多少钱一斤
打乙脑疫苗发烧怎么办	打已脑疫苗发烧怎么办
左下腹痛是什么原因	昨下腹痛是什么原因
精索静脉曲张的症状	精缩静脉曲张的症状
咸鱼卖东西靠谱吗	闲鱼卖东西靠谱吗
湿疹有什么症状	湿诊有什么症状
腿抽筋怎么办	腿抽筋怎么半
微信怎么群发	微信怎么裙发
脚后跟疼是怎么回事	脚侯跟疼是怎么回事
陈薇院士研究的疫苗属于哪类疫苗	陈微院士研究的疫苗属于哪类疫苗
月经期间可以健身吗	月经期间可以建身吗
电脑开不了机	点脑开不了机
考试作弊打一数学名词	考试做弊打一数学名词
手机通讯录如何备份	手机通迅录如何备份
接吻能不能减肥	结吻能不能减肥
血糖高吃什么水果	血糖高吃什么水国
骨质疏松的症状	骨质疏松的证状
血糖高吃什么水果好	雪糖高吃什么水果好
麦滋林饭前吃还是饭后吃	麦兹林饭前吃还是饭后吃
交通安全手抄报内容	交通安全收抄报内容
谁发明了电话	谁发名了电话
肾结石有什么症状	肾洁石有什么症状
哺乳期乳房有硬块是怎么回事	补乳期乳房有硬块是怎么回事
月经期可以艾灸吗	月精期可以艾灸吗
牡蛎的营养价值及功效	母蛎的营养价值及功效
割包皮需要多少钱	割包皮须要多少钱
男孩子起什么名字好听	男孩子启什么名字好听
鼻塞流鼻涕吃什么药	鼻赛流鼻涕吃什么药
怎么查别人的通话记录	怎么茶别人的通话记录
强直性脊椎炎的症状	强直性脊椎炎的症壮
喉咙痒咳嗽怎么办	候咙痒咳嗽怎么办
慢性宫颈炎怎么治	曼性宫颈炎怎么治
月经后几天容易怀孕	月精后几天容易怀孕
低血糖是糖尿病吗	低学糖是糖尿病吗
肺结节是怎么回事	肺结接是怎么回事
男人大腿根部内侧瘙痒	男人大腿根部内测瘙痒
幽门螺旋杆菌会传染吗	由门螺旋杆菌会传染吗
如何去除牙结石	如何去除牙洁石
卵巢多囊综合症能怀孕吗	卵巢多囊综合证能怀孕吗
如何判断幼儿急疹	如何判断幼儿急诊
坐骨神经痛症状	座骨神经痛症状
心脏早搏的药	心脏早博的药
乳腺增生严重吗	乳腺曾生严重吗
空腹可以喝柠檬蜂蜜水吗	空复可以喝柠檬蜂蜜水吗
白蛋白偏高	白蛋百偏高
肝胆湿热的症状	肝胆湿热的正状
血红蛋白高是怎么回事	学红蛋白高是怎么回事
脚底出汗是什么原因	脚底出汉是什么原因
鲜鲍鱼怎么做好吃	先鲍鱼怎么做好吃
什么是康复治疗	什么是康复制疗
肩膀痛是什么原因	肩旁痛是什么原因
血糖偏高怎么办	雪糖偏高怎么办
烂嘴角是怎么回事	烂嘴角是怎么会事
膝盖痛怎么回事	膝盖痛怎么会事
疱疹的初期症状	疱疹的初起症状
带套不会怀孕吧	戴套不会怀孕吧
跑完步能喝水吗	跑完不能喝水吗
左眼一直跳怎么回事	昨眼一直跳怎么回事
淋巴细胞百分比偏低	琳巴细胞百分比偏低
剖腹产多久可以洗澡	剖复产多久可以洗澡
糖醋里脊怎么做	糖错里脊怎么做
宝宝肠炎怎么办	宝宝肠严怎么办
什么有助于睡眠	十么有助于睡眠
小腿肿是什么原因	小腿肿是什麼原因
电话是谁发明的	电话是谁发名的
被狗咬了怎么办	备狗咬了怎么办
骨质疏松的症状	骨质疏松的症壮
生理期可以吃菠萝吗	生理期可以吃波萝吗
表示风的词语	表是风的词语
脚脱皮是怎么回事	脚脱皮是怎么会事
滑石粉的功效与作用	华石粉的功效与作用
眼睛有血丝是怎么回事	眼睛有血丝是怎麼回事
阴道镜活检疼吗	阴道镜火检疼吗
嘴唇发紫是什么原因	最唇发紫是什么原因
细菌性阴道炎	细菌性阴倒炎
做蛋糕用什么面粉	坐蛋糕用什么面粉
糖尿病吃什么蔬菜好	糖尿病吃什么蔬才好
烧心是怎么回事	烧心是怎么会事
血管堵塞吃什么好	血管赌塞吃什么好
非布司他可以长期吃吗	非布斯他可以长期吃吗
骨密度检查多少钱	骨蜜度检查多少钱
什么时候开学	神么时候开学
脑膜炎后遗症能治好吗	脑莫炎后遗症能治好吗
刘昊然演的综艺	刘浩然演的综艺
孟鲁司特钠要吃多久	孟鲁司特纳要吃多久
偏头痛是什么原因	翩头痛是什么原因
泡疹的症状	泡诊的症状
手心出汗是怎么回事	手心出汗是怎么会事
女孩几岁开始乳房发育	女孩几岁开是乳房发育
花斑癣会传染吗	花班癣会传染吗
腰间盘突出手术多少钱	腰肩盘突出手术多少钱
脚后跟痛怎么办	角后跟痛怎么办
湖洲到徐州高铁时刻表	湖州到徐州高铁时刻表
中国古代的文房四宝是什么	中国古代的文防四宝是什么
儿童流鼻血是什么原因	儿童留鼻血是什么原因
骨癌的症状	骨癌的症壮
血小板增多症	血小板赠多症
蜂蜜水什么时候喝好	风蜜水什么时候喝好
梦见已故的亲人	梦见一故的亲人
隐适美价格	隐世美价格
湿疹是什么引起的	湿诊是什么引起的
肠镜检查前应注意什么	肠境检查前应注意什么
血糖高能吃西瓜吗	血唐高能吃西瓜吗
血糖高能喝蜂蜜水吗	雪糖高能喝蜂蜜水吗
方便面会胖吗	方便面回胖吗
肩周炎的症状	肩周炎的正状
皮肤瘙痒吃什么药	皮夫瘙痒吃什么药
心急吃不了热豆腐	心极吃不了热豆腐
石家庄是几线城市	石家庄是几线成市
华为手机屏幕太次	华为手机屏幕太差
避孕药怎么吃	毕孕药怎么吃
什么是内分泌失调	什么是内分必失调
好听的英文名字	好听的英问名字
喝蜂蜜水能减肥吗	喝蜂密水能减肥吗
月经过后几天可以取环	月经过后几天可以去环
尿潜血一个加号严重吗	尿浅血一个加号严重吗
孕妇什么时候开始补钙	孕服什么时候开始补钙
健脾的食物	建脾的食物
甲状腺结节	甲状腺结洁
桃花是什么颜色	桃花事什么颜色
大蒜发芽了还能吃吗	打蒜发芽了还能吃吗
什么人不适合吃芒果	什么人不适合吃忙果
月经后几天是排卵期	月经后几天是拍卵期
小肚子疼是怎么回事	小度子疼是怎么回事
来月经可以吃乌鸡白凤丸吗	来月经可以吃乌鸡白风丸吗
湿疹与痱子的区别	湿诊与痱子的区别
低血糖是怎么回事	低血唐是怎么回事
肾积水怎么办	肾几水怎么办
高速公路收费标准	高速工路收费标准
试管婴儿多少钱	试官婴儿多少钱
肺部结节严重吗	肺布结节严重吗
慢性荨麻疹怎么根治	慢性荨麻诊怎么根治
身上有红点是怎么回事	身上有红点是怎么会事
胃炎吃什么	胃炎吃什药
做四维彩超的最佳时间	做四围彩超的最佳时间
哺乳期吃什么好	捕乳期吃什么好
苯和汽油互融吗	苯和汽油互溶吗
带状泡疹最佳治疗方法	带壮泡疹最佳治疗方法
婴儿打嗝是什么原因	婴儿打隔是什么原因
脑梗塞病人吃什么食物好	脑更塞病人吃什么食物好
血糖高吃什么好能降糖	血塘高吃什么好能降糖
眼睛里进东西了怎么办	眼睛里进动西了怎么办
睡觉流口水是怎么回事	睡觉流口水是怎么回是
如何查询自己的手机号	如何查寻自己的手机号
薄荷的功效与作用	薄荷的功效与做用
吃蜂蜜有什么好处	吃风蜜有什么好处
结扎手术多少钱	接扎手术多少钱
晚上吃梨好吗	晚上吃黎好吗
纯碱作洗涤剂的原理	纯碱做洗涤剂的原理
子宫脱落是怎么回事	子宫托落是怎么回事
石榴籽能吃吗	石榴子能吃吗
迷你世界蘑菇怎么繁殖	迷你世界磨菇怎么繁殖
试管婴儿移植后几天着床	试管婴儿移值后几天着床
鲜胚移植后几天着床	鲜配移植后几天着床
大便黏腻是怎么回事	大便粘腻是怎么回事
反流性咽喉炎	反流性咽候炎
毕业赠言给老师的	毕业增言给老师的
蓝牙耳机怎么听歌	蓝牙儿机怎么听歌
荨麻疹会不会传染	荨麻诊会不会传染
什么是心脏早搏	什么是心脏早博
脚底长鸡眼怎么办	角底长鸡眼怎么办
头皮上长痘痘是怎么回事	头皮上涨痘痘是怎么回事
我的座右铭是什么意思	我的坐右铭是什么意思
肾虚什么症状	肾虚什么证状
怎样教宝宝说话	怎样交宝宝说话
尿道炎是怎么引起的	尿到炎是怎么引起的
脂肪肝有什么症状	脂肪肝有什么证状
手脱皮怎么回事	手拖皮怎么回事
腿部肌肉疼痛怎么办	腿部机肉疼痛怎么办
宝宝爱出汗是什么原因	宝宝爱出汉是什么原因
地中海贫血有什么症状	地中海贫血有什么正状
水痘和疱疹的区别	水豆和疱疹的区别
小腹痛怎么回事	小服痛怎么回事
运动后多久可以洗澡	运动厚多久可以洗澡
经常胃胀是什么原因	经常胃帐是什么原因
月经期可以喝益母草吗	月经期可以喝意母草吗
咳嗽有痰怎么办	咳嗽有谈怎么办
后背疼是怎么回事	后北疼是怎么回事
白带多是怎么回事	白带多是怎么会事
孕妇吃什么补血	孕妇吃什么不血
照样子写词语	照样子解词语
交感神经型颈椎病症状	交感神经型颈椎病证状
生理期可以吃什么水果	生理期可以吃什麼水果
腹腔淋巴结肿大的症状	腹腔淋巴结肿大的证状
低血糖的症状有哪些	低雪糖的症状有哪些
食管癌遗传吗	食管癌移传吗
口腔溃疡吃什么药	口强溃疡吃什么药
内分泌失调是什么症状	内分泌失调是什么证状
膀胱炎的症状	膀胱炎的证状
腰椎管狭窄的治疗方法	腰椎管侠窄的治疗方法
梦到自己被狗咬	梦到自己备狗咬
叶绍翁是哪个朝代的	叶少翁是哪个朝代的
孕妇可以喝金银花茶吗	孕妇可以喝紧银花茶吗
拉肚子吃什么药	拉度子吃什么药
宽带密码怎么改	宽带秘码怎么改
