什么血糖仪最好	什么血糖仪比较好
怎么设置画笔	怎么设定画笔
三国演义最有名的片段	三国演义最著名的片段
怎样检查电脑硬件	怎样检测电脑硬件
近义词怎么讲	同义词怎么讲
退出开车模式	退出车载模式
江阴市有啥好玩的地方	江阴有啥好玩的地方
你和小v谁厉害	你和小薇谁厉害
你喜欢旅游吗	你喜欢旅行吗
祝贺考试顺利的成语	祝福考试顺利的成语
为什么男人特别喜欢穿背心	为什么男人都喜欢穿背心
我奶奶漂亮吗	我奶奶美丽吗
为什么嘴巴总起泡	为什么嘴巴总是起泡
香菇怎么做菜	香菇怎么炒菜
捷径近义词	捷径同义词
温江有多少乡镇	温江区有多少乡镇
遵义医学院好吗	遵义医科大学好吗
黑芝麻核桃粉什么时候喝比较好	黑芝麻核桃粉什么时候喝最好
广州比较出名的茶楼	广州最出名的茶楼
火龙果和黄瓜能一起吃吗	火龙果和黄瓜能同时吃吗
天快黑了的	天都黑了的
怀孕两个多月肚子隐隐作痛	怀孕两个半月肚子隐隐作痛
形容宝宝淘气的歌曲	形容宝宝调皮的歌曲
手机铃声比较大	手机铃声太大
什么样的睡觉	什么样的睡眠
有房贷的房子可以赠予吗	有房贷的房子可以赠送吗
你不上学吗	你不用上学吗
ps是提示的意思吗	ps是提醒的意思吗
第一次大概多长时间	第一次大约多长时间
现在有什么好玩的游戏	目前有什么好玩的游戏
汕尾是属于潮汕吗	汕尾是属于潮汕地区吗
描写孔雀美丽的句子	描写孔雀优美的句子
angelababy综艺节目	杨颖综艺节目
生菜如何保存	生菜如何储藏
九龙山墓园地址	九龙山陵园地址
大面积近义词	大面积同义词
狮子座明天运势	狮子座明日运势
干海马怎么存放	干海马怎么保存
疫情十一月份还会来吗	疫情十一月还会来吗
望结尾的成语	看结尾的成语
几点睡觉算熬夜	几点睡眠算熬夜
刘禹锡最有名的一句诗句	刘禹锡最著名的一句诗句
月经迟迟不来怎么办	月经一直不来怎么办
孕妇为什么特别小气	孕妇为什么很小气
祝福长辈生日的诗句	祝贺长辈生日的诗句
dnf为什么老掉线	dnf为什么老是掉线
嬴政的儿子分别叫什么	嬴政的儿子都叫什么
银耳能和地瓜一起吃吗	银耳能和地瓜在一起吃吗
嘴里特别臭是怎么回事	嘴里很臭是怎么回事
用什么相机拍照清晰	用什么相机拍照清楚
流产后流血特别少正常吗	流产后流血很少正常吗
暮色的同义词	暮色的近义词
快走可以减肥吗	快走可以减脂吗
师傅的女师傅喊什么	师傅的女师傅叫什么
华为员工数	华为集团员工数
贝瑞基因地址	贝瑞基因公司地址
两个月没来月经是怎么回事	两月没来月经是怎么回事
小孩不愿意学习怎么办	小孩不愿意读书怎么办
认祖归宗同义词	认祖归宗近义词
轻微酒精过敏怎么办	有点酒精过敏怎么办
什么动物最勤劳	什么动物很勤劳
息屏时间调至三十分钟	息屏时间调至半小时
广东农工商职业技术学院什么时候开学	广东农工商职业技术学校什么时候开学
做梦经常梦到同一个人	做梦时常梦到同一个人
月经刚结束会排卵吗	月经才结束会排卵吗
鼓励孩子学习经典语句	鼓励孩子读书经典语句
经常喝牛奶有什么坏处	常常喝牛奶有什么坏处
有哪些有名的医生	有哪些著名的医生
男人身高多少最好	男人身高多少比较好
小孩子很胖	小孩子太胖
检测网络摄像头的软件	检查网络摄像头的软件
咳嗽很厉害怎么办	咳嗽太厉害怎么办
三十分钟后提醒我吃药	半个小时后提醒我吃药
笑容的形容词	笑脸的形容词
从此的此怎么组此	由此的此怎么组此
james身高	詹姆身高
眼睛一直肿	眼睛都肿
长相特别清纯的女生	长相很清纯的女生
我为什么这么暴躁	我为什么这么急躁
新冠肺炎多久能检查出来	新冠肺炎多久能检测出来
怎样投球最准	怎样投球才准
中国平安成立于哪一年	平安保险成立于哪一年
头孢和阿奇霉素能一起吃吗	头孢和阿奇霉素能同时吃吗
任丘有多大	任丘市有多大
电脑图标太小	电脑图标很小
吴奇隆马雅舒有孩子吗	吴奇隆马舒雅有孩子吗
南京有名的巷子	南京著名的巷子
江城属于哪个市	江城县属于哪个市
三个月宝宝老吃衣服	三个月宝宝老是吃衣服
怎么检查电池寿命	怎么检测电池寿命
日本著名主持人	日本有名主持人
灵芝孢子粉和三七粉能一起吃吗	灵芝孢子粉和三七粉能同时吃吗
广州怎么去阿尔山	广州怎么去阿尔山市
怎么训练宝宝抬头	怎么练习宝宝抬头
设置闹钟八点	设置闹钟八点钟
十一个月女宝身高体重	十一月女宝身高体重
衡阳火车站到衡东	衡阳火车站到衡东县
长宁游泳馆开放时间	长宁区游泳馆开放时间
叫的成语有哪些	喊的成语有哪些
如何进一步发挥党员作用	如何更好地发挥党员作用
小新pro十三怎么检测屏幕坏点	小新pro十三怎么检查屏幕坏点
形容声音开心的成语	形容声音高兴的成语
经期前疲劳	经期前疲惫
诗经著名的诗篇	诗经有名的诗篇
送数学老师什么礼物比较好	送数学老师什么礼物最好
月经迟迟不来的原因	月经总是不来的原因
有点肠胃炎	轻微肠胃炎
拼多多怎么买最省钱	拼多多怎么买更省钱
心跳很快怎么回事	心跳特别快怎么回事
苹果时间校准	ios时间校准
深圳最近天气怎么样	深圳今日天气怎么样
打瘦腿针大概多少钱	打瘦腿针大约多少钱
中国五十六个民族分别是哪些	中国五十六个民族都是哪些
正月十五的习俗急啊	一月十五的习俗急啊
月经经常推迟不来什么原因	月经常常推迟不来什么原因
社区居委会的功能	居民委员会的功能
舒服反义词语	舒适反义词语
描写夜幕的诗词	描写晚上的诗词
孕早期为什么饿的特别快	孕早期为什么饿的很快
湿热体质吃什么药最好	湿热体质吃什么药比较好
大同的同义词	大同的近义词
可以设置人物形象的游戏	可以设定人物形象的游戏
梦见和熟人一起睡觉	梦见和熟人在一起睡觉
怎么检查车上的gps	怎么检测车上的gps
十个月宝宝发烧怎么办	十一月宝宝发烧怎么办
怎么洗澡更干净	怎么洗澡最干净
猫咪为什么老叫	猫咪为什么一直叫
什么动物最聪明	什么动物很聪明
缺钙非常严重怎么办	缺钙太严重怎么办
多高兴啊补充句子	多开心啊补充句子
南昌信访局地址	南昌县信访局地址
设置语音提示	设置语音提醒
国美历史股价表	国美电器历史股价表
你不用睡觉吗	你不睡觉吗
怎么让大姨妈快点结束	怎么让大姨妈马上结束
看月思乡的诗句	望月思乡的诗句
天蝎座是几月	天蝎座是几月份
最近两个月月经量特别少	最近两个月月经量很少
合肥区gdp	合肥gdp
手机最低音量还是太大	手机最低音量还是很大
总头疼是因为什么	老是头疼是因为什么
七个多月能做引产吗	七个半月能做引产吗
入店转化率低	进店转化率低
儿子太淘气怎么办	儿子太调皮怎么办
修为的近义词	修为的同义词
设置一个下午两点的闹钟	设置一个下午两点钟的闹钟
骨质疏松太严重怎么办	骨质疏松很严重怎么办
重庆有哪些市	重庆省有哪些市
息屏时间调至三十分钟	息屏时间调至半个小时
拍照怎么发朋友圈	照相怎么发朋友圈
你今天好不好	你现在好不好
猪肝怎样做才好吃	猪肝怎样做更好吃
重庆皮肤科哪个医院比较好	重庆皮肤科哪个医院最好
京东售后太慢	京东售后很慢
最近发生了什么事	今天发生了什么事
苦瓜怎么做降火	苦瓜怎么做败火
什么东西人们都不喜欢吃	什么东西人们最不喜欢吃
青海旅行必备物品清单	青海旅游必备物品清单
脑梗塞吃什么药最好	脑梗塞吃什么药更好
促使近义词	促使同义词
糯米糍如何存放	糯米糍如何保存
吃苦瓜减肥吗	吃苦瓜减脂吗
男孩特别依赖妈妈怎么办	男孩太依赖妈妈怎么办
七月能摘口罩吗	七月份能摘口罩吗
拍照功能	照相功能
宽带用什么最好	宽带用什么比较好
做梦经常梦到同一个人	做梦常常梦到同一个人
男生每个月都有几天心情不好	男生每个月也有几天心情不好
怎样让女朋友兴奋	怎样让女朋友高兴
什么锅具最好	什么锅具比较好
巨蟹座是几月	巨蟹座是几月份
为什么打游戏总是四百六十	为什么打游戏经常四百六十
脸上很油怎么办	脸上太油怎么办
中信证券业绩	中信业绩
江阴距离上海有多远	江阴市距离上海有多远
脸上长了一个特别大的包	脸上长了一个很大的包
nike怎么验证真伪	耐克怎么验证真伪
陕师大属于九百八十五还是二百一十一	陕西师大属于九百八十五还是二百一十一
经常吃避孕药有什么危害	常常吃避孕药有什么危害
检查皮肤的app	检测皮肤的app
比较长的笑话	很长的笑话
肚子总饿是怎么回事	肚子很饿是怎么回事
凤凰卫视天气预报主持人王艺	凤凰台天气预报主持人王艺
直播屋里特别暗怎么办	直播屋里太暗怎么办
茶陵是哪个市	茶陵县是哪个市
最近总失眠怎么办	最近很失眠怎么办
什么地方最好玩	什么地方才好玩
什么星座比较挑剔	什么星座最挑剔
九峰山免费吗	九峰山景区免费吗
进户门摆放什么植物好	入户门摆放什么植物好
著名的现代诗诗人	有名的现代诗诗人
减脂早上喝什么牛奶	减肥早上喝什么牛奶
小孩子脚特别臭怎么办	小孩子脚很臭怎么办
女朋友特别挑食怎么办	女朋友很挑食怎么办
集美有什么好玩的	集美村有什么好玩的
谁也无法预测下一秒会发生什么	谁都无法预测下一秒会发生什么
玉露用什么土种比较好	玉露用什么土种最好
今天室外温度	当前室外温度
海南看什么	海南岛看什么
经常胃疼怎么办	常常胃疼怎么办
巨蟹座明天运势	巨蟹座明日运势
淮安到如皋多远	淮安区到如皋多远
尺度比较大的游戏	尺度最大的游戏
鲁迅的老婆叫什么	鲁迅先生的老婆叫什么
东岳是哪个朝代	东岳国是哪个朝代
奇妙的近义词奇特	奇妙的近义词奇异
房屋赠送要交多少税	房屋赠予要交多少税
金针菇怎样再生长	金针菇怎样再次生长
昆山二手市场在哪	昆山市二手市场在哪
什么水果含叶酸最高	什么水果含叶酸比较高
淮安在哪里	淮安区在哪里
怎么洗澡更干净	怎么洗澡才干净
春季的景物描	春天的景物描
鸡蛋怎样吃最有营养	鸡蛋怎样吃才有营养
剥好的大蒜怎么保存	剥好的大蒜怎么储藏
你的名字好好听	你的名字非常好听
六个多月能吃猕猴桃吗	六个半月能吃猕猴桃吗
设定闹钟六点	设置闹钟六点
你会一直对我好吗	你会永远对我好吗
八月一号是不是建军节	八月一日是不是建军节
成都到八宿多少公里	成都到八宿县多少公里
功用的近义词	功用的同义词
轻微烫伤怎么办	有点烫伤怎么办
津南区双港邮编	津南区双港镇邮编
哪个网贷额度最高	哪个网贷额度比较高
三七粉什么时候吃最好	三七粉什么时候吃更好
什么奇异的植物	什么奇特的植物
谁建造了长城	谁建造了万里长城
苹果设置没有了怎么办	iphone设置没有了怎么办
瓦房店有三甲医院吗	瓦房店市有三甲医院吗
为什么嘴巴总起泡	为什么嘴巴老是起泡
炒菜都放什么调料	做菜都放什么调料
珠海唐家湾属于什么区	珠海唐家湾镇属于什么区
形容风景美丽的成语	形容风景漂亮的成语
收废品怎么喊	收废品怎么叫
什么车型开着比较舒服	什么车型开着最舒服
九个月宝宝拉肚子怎么办	九月宝宝拉肚子怎么办
朝阳南磨房书记	朝阳南磨房乡书记
形容人比较酷的句子	形容人很酷的句子
宣化城上城售楼处电话	宣化城上城售楼部电话
怎么变得更瘦	怎么变得很瘦
胎儿羊水偏少怎么办	胎儿羊水太少怎么办
雁门关景区在哪里	雁门关在哪里
福田区停车场收费标准	福田停车场收费标准
昆明去泸西	昆明去泸西县
耐克的标怎么画	nike的标怎么画
长沙有名的律师	长沙县有名的律师
核酸检查能不能吃饭	核酸检测能不能吃饭
惠安有动车站吗	惠安县有动车站吗
哈姆莱特在丹麦宫廷的感受	哈姆雷特在丹麦宫廷的感受
宣布谈恋爱的	公布谈恋爱的
河南博物院开馆了吗	河南博物馆开馆了吗
尿路感染老复发	尿路感染老是复发
今天忙不忙	最近忙不忙
井水不犯河水同义词	井水不犯河水近义词
内蒙古很长的地名	内蒙古最长的地名
现在该干嘛	目前该干嘛
杭州妇科医院哪家比较好	杭州妇科医院哪家最好
鸡蛋怎么存放在冰箱	鸡蛋怎么保存在冰箱
豺狼虎豹同义词	豺狼虎豹近义词
学习有好处	读书有好处
增城公租房申请条件	增城区公租房申请条件
曲沃邮政编码	曲沃县邮政编码
如何保存干蒜	如何存放干蒜
酒吧销售发的	酒吧营销发的
南山有多少人口	南山镇有多少人口
万力轮胎和佳通哪个好	万力轮胎和佳通轮胎哪个好
如何证明自来水中有细菌	如何证实自来水中有细菌
苹果如何调亮度	iphone如何调亮度
学习安排计划	读书安排计划
哪一个快递最便宜	哪一个快递更便宜
白菜怎么做才好吃	白菜怎么做更好吃
降血压的药一般什么时候吃最好	降血压的药一般什么时候吃比较好
设置两点的闹铃	设置两点钟的闹铃
同学们说得很高兴扩句	同学们说得很开心扩句
两个多月宝宝睡觉摇头怎么回事	两个半月宝宝睡觉摇头怎么回事
为什么受伤的总是我	为什么受伤的老是我
怎么烧螃蟹才好吃	怎么烧螃蟹最好吃
关闭明天早上六点的闹钟	关闭明天早上六点钟的闹钟
长三角的气候特征	长三角地区的气候特征
菲律宾最有名的景点	菲律宾最著名的景点
长沙有名的律师	长沙著名的律师
女生说你还小怎么回复	女生说你太小怎么回复
可以用很热的水泡脚吗	可以用太热的水泡脚吗
清冷孤傲的近义词	清冷孤傲的同义词
tiffany项链真假	蒂芙尼项链真假
台湾有哪些名胜古迹	台湾岛有哪些名胜古迹
苹果无法发现此人	iphone无法发现此人
九月九日忆山东兄弟是哪个节日的	九月九忆山东兄弟是哪个节日的
梦见蛇入裤腿	梦见蛇进裤腿
新华国税电话	新华国税局电话
碧桂园集团法人代表	碧桂园法人代表
上海信访局地址	上海信访办地址
我的手机快没电了	我的手机马上没电了
延吉到内蒙古	延吉到内蒙
腿上汗毛太长怎么办	腿上汗毛很长怎么办
什么果汁可以减肥	什么果汁可以减脂
额头较短适合什么刘海	额头太短适合什么刘海
平安老板是哪里人	平安集团老板是哪里人
沈阳专业不孕不育医院选择	沈阳正规不孕不育医院选择
青岛有哪些有名的建筑	青岛有哪些著名的建筑
交强险大概多少钱一年	交强险大约多少钱一年
华峰氨纶股价	华峰集团股价
西游记里面最有名的三个故事	西游记里面最著名的三个故事
小孩睡觉老哭	小孩睡觉老是哭
宝洁公司待遇	宝洁待遇
最近比较潮的歌	最近最潮的歌
怀孕会老想尿尿吗	怀孕会老是想尿尿吗
形容人非常感动的成语	形容人很感动的成语
子宫偏大怎么办	子宫太大怎么办
陆丰碣石面积	陆丰碣石镇面积
湿气较重有什么表现	湿气很重有什么表现
月经迟迟不来怎么办	月经总是不来怎么办
苹果独特功能	iphone独特功能
减肥晚上可以吃鸡蛋吗	减脂晚上可以吃鸡蛋吗
民政局星期六上班吗	县民政局星期六上班吗
武汉有什么特殊的地方	武汉有什么特别的地方
怎么检查低血糖	怎么检测低血糖
世界上到底有多少种语言	世界上一共有多少种语言
北京西站到顺义地铁	北京西站到顺义区地铁
上海哪个医院眼科比较好	上海哪个医院眼科最好
开心的心字	高兴的心字
人的最佳睡眠方向	人的最佳睡觉方向
板栗怎么做才好吃	板栗怎么做最好吃
虾不能和什么一起吃	虾不能和什么同时吃
形容非常疼的比喻句	形容很疼的比喻句
昆明白颠如何治疗信任复美m	昆明白颠如何治疗信赖复美m
设置一个明天早上六点的闹钟	设置一个明天早上六点钟的闹钟
梦见自己老流鼻涕	梦见自己老是流鼻涕
两个多月宝宝拉奶瓣	两个半月宝宝拉奶瓣
三灶有什么好玩的	三灶镇有什么好玩的
为什么突然间会特别想一个人	为什么有时候会特别想一个人
北京电力电话	北京电力局电话
舒适同义词	舒服同义词
毛孔特别粗大怎么办	毛孔较粗大怎么办
我们一句话也没有说	我们一句话都没有说
泰国信奉的宗教	泰国信仰的宗教
八十九乘七十八等有些	八十九乘七十八等稍微
入乡随俗的近义词	入乡随俗的同义词
白毫银针茶饼怎么存放	白毫银针茶饼怎么保存
肚子老饿是怎么回事	肚子总是饿是怎么回事
北京到莒南火车票	北京到莒南县火车票
比较虐的电视剧	较虐的电视剧
武汉治白癜风最好的医院	武汉治白癜风更好的医院
老淌鼻血怎么办	老是淌鼻血怎么办
苹果十一怎么安卡	iphone十一怎么安卡
扬州钟点工多少钱一小时	扬州小时工多少钱一小时
大连有名的桥	大连著名的桥
什么牌子的卫生巾最好	什么牌子的卫生巾更好
鲁迅先生关于魏晋风度的演讲	鲁迅关于魏晋风度的演讲
骨密度检查多少钱	骨密度检测多少钱
形容光影优美的句子	形容光影柔美的句子
太谷离平遥古城有多远	太谷县离平遥古城有多远
世界有名的学校	世界著名的学校
减肥能吃茶叶蛋吗	减脂能吃茶叶蛋吗
游泳游多久可以减肥	游泳游多久可以减脂
距离十二月三十一号还有多少天	距离十二月三十一日还有多少天
喝哪种茶可以减肥	喝哪种茶可以减脂
湖北有名人物	湖北著名人物
杨幂为什么叫沈腾二舅	杨幂为什么喊沈腾二舅
贵阳到锦屏多少公里	贵阳到锦屏县多少公里
玫瑰花可以和菊花一起泡水喝吗	玫瑰花可以和菊花同时泡水喝吗
比较软的石头	较软的石头
脚为什么总臭	脚为什么很臭
八月份去哪旅游最好	八月去哪旅游最好
集美有几所中学	集美区有几所中学
艰难困苦的近义词	艰难困苦的同义词
桐乡到常州	桐乡市到常州
你天天吃什么	你每天吃什么
中药和牛奶可以一起喝吗	中药和牛奶可以同时喝吗
为什么吃完饭特别想抽烟	为什么吃完饭就想抽烟
特别的歌词	非常的歌词
晚上总睡不好	晚上都睡不好
祝福销售业绩好的词语	祝贺销售业绩好的词语
ff十四怎么拍照	ff十四怎么照相
表示果断的字	表示坚决的字
为什么我手机充电很慢	为什么我手机充电太慢
今天是秋天还是冬天	现在是秋天还是冬天
一百三十斤肚子特别大	一百三十斤肚子很大
什么游戏最好玩	什么游戏都好玩
黄金那种最好	黄金那种比较好
十月二十八号是星期几	十月二十八日是星期几
呼吸比较困难怎么回事	呼吸很困难怎么回事
牙齿快磨平了怎么办	牙齿都磨平了怎么办
路桥电力营业厅电话	路桥电力公司营业厅电话
治疗白癜风大概多少钱	治疗白癜风大约多少钱
毕节华为售后在哪里	毕节市华为售后在哪里
window十突然特别卡	window十突然非常卡
怎样装修房子才好看	怎样装修房子最好看
香蕉存放时间	香蕉保存时间
比较新颖的生日礼物	比较新奇的生日礼物
正月十五喝什么好	一月十五喝什么好
如何保存干海参	如何存放干海参
意大利最著名的景点	意大利最有名的景点
小龙虾买回家怎么保存	小龙虾买回家怎么存放
关机还关不了	关机都关不了
今年九月适合结婚的日子	今年九月份适合结婚的日子
昌吉汽配城在哪里	昌吉市汽配城在哪里
辛集市周边集市时间表	辛集周边集市时间表
中兴通讯怎么样	中兴通信怎么样
初中历史重要战役	初中历史重要战争
徐州医学院好吗	徐州医科大学好吗
泗洪到蚌埠多少公里	泗洪县到蚌埠多少公里
苹果怎么录音	mac怎么录音
二十年十一月份哪天结婚好	二十年十一月哪天结婚好
去过朝阳区回河北需要隔离吗	去过朝阳回河北需要隔离吗
最近比较火的儿歌	最近很火的儿歌
最好的速溶咖啡	比较好的速溶咖啡
查看未来几天的天气	查看这几天的天气
山西考公告什么时候出	山西省考公告什么时候出
今天风有多大	现在风有多大
最近几天有雪吗	这几天有雪吗
南昌著名的景点	南昌有名的景点
山西面积排名	山西市面积排名
什么菜降火效果最好	什么菜败火效果最好
眼睁睁的同义词	眼睁睁的近义词
苹果屏幕变得特别大	苹果屏幕变得很大
睡近义词	睡同义词
王源今年几岁	王源现在几岁
刚怀孕可以吃烧烤吗	才怀孕可以吃烧烤吗
中位线判断定理	中位线判定定理
万科集团好进吗	万科好进吗
转交的近义词	转交的同义词
女人都喜欢听什么话	女人最喜欢听什么话
苹果录歌软件	ios录歌软件
民政局有哪些部门	县民政局有哪些部门
舒适的什么填词语	舒服的什么填词语
形容黄花美丽的诗句	形容黄花优美的诗句
梦见好大的鲤鱼	梦见非常大的鲤鱼
冷水江市属于哪个省哪个市	冷水江属于哪个省哪个市
怎样在百度里下载小说	怎样在百度公司里下载小说
枸杞怎么吃最好	枸杞怎么吃更好
华夏航空安全吗	华夏安全吗
你是不是很笨	你是不是特别笨
常常咳嗽有痰	时常咳嗽有痰
关于重阳节日的古诗	关于重阳节的古诗
怎么才能让男朋友更爱我	怎么才能让男朋友很爱我
世界上最美丽的鹦鹉	世界上最漂亮的鹦鹉
苹果如何使用安装包	ios如何使用安装包
怎么减肥最快	怎么减肥更快
现在是早上还是中午	现在是早晨还是中午
尖子的近义词	尖子的同义词
苹果怎么添加本地音乐	iphone怎么添加本地音乐
青大校长什么级别	青岛大学校长什么级别
苹果怎么查订单	mac怎么查订单
什么游戏最好玩	什么游戏才好玩
团结合作近义词	团结合作同义词
尧都古镇最近开门吗	尧都古镇今天开门吗
太康到郑州多少公里	太康到郑州区多少公里
皮肤真菌检查怎么做	皮肤真菌检测怎么做
中国有哪些著名的桥	中国有哪些有名的桥
什么单机游戏最好玩	什么单机游戏很好玩
小米的创立时间	小米公司的创立时间
九十三年正月二十六是阳历多少	九十三年一月二十六是阳历多少
杭州垫鼻子哪家好都去艺兴	杭州垫鼻子哪家好都往艺兴
六个月婴儿喊爸爸妈妈	六个月婴儿叫爸爸妈妈
特别五笔怎么打字	非常五笔怎么打字
什么摩托车最好	什么摩托车更好
刚刚在干嘛	刚才在干嘛
数量近义词	数量同义词
西瓜和梨可以一起吃吗	西瓜和梨可以同时吃吗
神华集团董事长是谁	中国神华董事长是谁
菠菜和虾能一起吃吗	菠菜和虾能同时吃吗
赤壁市gdp	赤壁gdp
西藏有名的旅游景点	西藏著名的旅游景点
日本豆腐保存方法	日本豆腐储藏方法
西北师范大学具体地址	西北师范大学详细地址
三月两日什么星座	三月二什么星座
峨眉山有什么好吃的	峨眉山景区有什么好吃的
后台打开网易云	后台打开网易云音乐
衡阳有哪些学院	衡阳有哪些大学
葡萄酒保存多久	葡萄酒存放多久
你有哪些优点	你有哪些长处
今天几度	现在几度
黄果树瀑布路线图	黄果树瀑布景区路线图
怀孕会老想尿尿吗	怀孕会一直想尿尿吗
设置早上六点的闹钟	设置早上六点钟的闹钟
a七十二导航键设定	a七十二导航键设置
怎么检测不孕不育	怎么检查不孕不育
为什么经常放屁	为什么常常放屁
不打开网易云	不打开网易云音乐
凋谢的近义词	凋谢的同义词
为什么总放屁	为什么都放屁
美的集团电话	美的电话
未来几天会不会下雨	这几天会不会下雨
射手座今天运势	射手座今日运势
合阳有多少个乡镇	合阳县有多少个乡镇
南票区多少人口	南票多少人口
夜间是指什么时间段	晚上是指什么时间段
蚕豆病检查多少钱	蚕豆病检测多少钱
中国的专业银行有哪些	中国的正规银行有哪些
