水浒传作者	水浒转作者
券养的意思	劵养的意思
额头长痘痘是什么原因	额头张痘痘是什么原因
猕猴桃能和酸奶一起吃吗	弥猴桃能和酸奶一起吃吗
甲醛有气味吗	甲荃有气味吗
腰骶部酸痛怎么回事	腰底部酸痛怎么回事
心率快吃什么药	心率块吃什么药
经期能喝茶吗	经期能喝茶马
哺乳期能贴膏药吗	哺乳期能帖膏药吗
脚后跟疼是什么原因	脚后跟疼是什么愿因
指甲上有竖纹是怎么回事	指甲上有竖文是怎么回事
慢性肠胃炎吃什么药	漫性肠胃炎吃什么药
哪里有免费电影	那里有免费电影
哪种猫好养	那种猫好养
企业帐户怎么开通	企业账户怎么开通
甲状腺结节有什么症状	甲状腺结节有什么证状
尖锐湿疣如何治疗	尖锐湿尤如何治疗
尖锐湿疣传播途径	尖锐湿疣传播途经
眼睛胀疼怎么办	眼睛帐疼怎么办
来月经可以运动吗	来月经可以动动吗
脚趾甲有瘀血怎么办	脚趾甲有淤血怎么办
法令纹怎么去除	法令纹怎么祛除
小腿酸胀是怎么回事	小腿酸帐是怎么回事
孕妇能吃牛油果吗	孕妇能吃牛油果妈
马克思和恩格斯是哪国人	马克思和恩格斯是那国人
过敏性鼻炎怎么治	过敏星鼻炎怎么治
带状疱疹的症状	带壮疱疹的症状
你他妈是什么意思	你她妈是什么意思
小孩长湿疹怎么办	小孩张湿疹怎么办
甲状腺结节	甲妆腺结节
右肋骨下方疼痛是什么原因	有肋骨下方疼痛是什么原因
脂肪肝有什么症状	脂肪肝有什么正状
排列五复式价格	排列五复试价格
芦荟胶的功效与作用	芦荟交的功效与作用
哪里批发服装最便宜	那里批发服装最便宜
中暑会拉肚子吗	中暑会啦肚子吗
腿为什么会抽筋	退为什么会抽筋
嘴巴周围长痘	嘴巴周围张痘
参麦注射液的作用	参麦注射夜的作用
人工授精的孩子健康吗	人工受精的孩子健康吗
急性白血病有哪些症状	急性白血病有那些症状
怎么绑鱼钩子线	怎么邦鱼钩子线
我在马路边捡到一分钱	我在吗路边捡到一分钱
安阳有那些县	安阳有哪些县
那种减肥药最好最有效	哪种减肥药最好最有效
武大郎那里人	武大郎哪里人
王子怡是谁	汪子怡是谁
回来吧大叔结局	回来把大叔结局
右脚大拇指发麻	右脚大母指发麻
怎样消除打嗝	怎样消除打隔
怎样改转述句	怎样改传述句
眼睛进沙子怎么办	眼睛进砂子怎么办
胃下垂的症状	胃下垂的症壮
甲亢不能吃什么	甲抗不能吃什么
血小板偏高	血小版偏高
大拇指甲上有黑色竖纹是怎么回事	大姆指甲上有黑色竖纹是怎么回事
鸡肉痛风可以吃吗	鸡肉通风可以吃吗
新生儿脑缺氧	新生儿恼缺氧
如何去痘坑	如何去逗坑
如何有效祛除蟑螂	如何有效去除蟑螂
关节积液怎么治疗	关节积夜怎么治疗
指南针是哪个国家发明的	指南针是那个国家发明的
脸上长了脂肪粒怎么办	脸上张了脂肪粒怎么办
带状疱疹看什么科	带状疱诊看什么科
女性尿道口长好多肉芽	女性尿道口长好多肉牙
哺乳期可以吃薏米吗	哺乳期可以吃薏米马
荨麻疹能吃橙子吗	寻麻疹能吃橙子吗
怎样勾鱼夫帽	怎样钩鱼夫帽
账户密码	帐户密码
长水豆能洗澡吗	长水逗能洗澡吗
有痰咳不出来吃什么药	有谈咳不出来吃什么药
震动环怎么用	振动环怎么用
怎样注销支付宝账户	怎样注消支付宝账户
感冒了鼻子不通气怎么办	感冒了鼻子不痛气怎么办
带状疱疹的症状	带状疱疹的正状
为什么老是拉肚子	为什么老是啦肚子
来大姨妈可以吃香蕉吗	来大姨吗可以吃香蕉吗
身上长猴子是什么原因	身上张猴子是什么原因
身上长猴子怎么去掉	身上长瘊子怎么去掉
怀孕多久可以测出来	怀孕多久可以侧出来
解脲支原体阳性好治吗	解尿支原体阳性好治吗
为什么会长痤疮	为什么会张痤疮
怀不了孕做哪些检查	怀不了孕做那些检查
宝宝换奶粉拉肚子怎么办	宝宝换奶粉啦肚子怎么办
大乐透六种口诀	大乐透六种口决
脚底长水疱很痒怎么办	脚底长水泡很痒怎么办
慢性胃炎怎么调理	漫性胃炎怎么调理
营养不良的症状	营养不良的证状
为什么手机收不到验证码	为什么手机收不到验正码
中兴通讯怎么样	中兴通迅怎么样
长针眼怎么办	张针眼怎么办
胃胀气怎么回事	胃长气怎么回事
怎样快速长高	怎样快速张高
男性性病怎么治	男性姓病怎么治
结婚戒指戴哪个手指	结婚戒指戴那个手指
平均血小板体积偏低	评均血小板体积偏低
尿毒症有什么症状	尿毒症有什么证状
来月经可以泡脚吗	来月经可以跑脚吗
苹果手机的录音在哪里	苹果手机的录音在那里
早餐卖什么赚钱	早餐买什么赚钱
他达拉非片是性药吗	他达拉菲片是性药吗
肾结石要注意什么	肾结石要主意什么
甲亢的症状有哪些	甲亢的症状有那些
个人简历自我评价怎么写	个人简力自我评价怎么写
西葫芦怎么做好吃	西胡芦怎么做好吃
坐月子拉肚子怎么办	座月子拉肚子怎么办
怀孕能不能泡温泉	怀孕能不能跑温泉
痔疮一般长在哪里	痔疮一般长在那里
舌头有裂纹是怎么回事	舌头有列纹是怎么回事
甲状腺的症状有哪些	甲状腺的症状有那些
身上青一块紫一块怎么回事	身上清一块紫一块怎么回事
甲减是什么病	胛减是什么病
下巴长粉刺的原因	下巴张粉刺的原因
活血化瘀的食物有哪些	活血化瘀的食物有那些
经常打嗝是什么病	经常打隔是什么病
艾滋病的传播途径有哪些	艾滋病的传播途径有那些
甲状腺癌能吃豆制品吗	甲壮腺癌能吃豆制品吗
取环后要注意什么	取环后要主意什么
肺热的症状	肺热的正状
肺结核有什么症状	肺结核有什么症壮
肝不好吃什么食物	干不好吃什么食物
来月经可以喝蜂蜜水吗	来月经可以喝峰蜜水吗
月经期间可以洗澡吗	月经其间可以洗澡吗
豆浆补羊水吗	豆浆补羊水妈
胃糜烂有哪些症状	胃糜烂有那些症状
耳朵里长痘痘是怎么回事	耳朵里张痘痘是怎么回事
脑动脉硬化	脑动脉硬花
菠萝上火吗	菠罗上火吗
膀胱炎有什么症状	膀胱炎有什么症壮
无线路由器怎么设置	无线露由器怎么设置
嗓子发炎吃什么药	桑子发炎吃什么药
扁桃体发炎挂哪个科	扁桃体发炎挂那个科
如何预防青春痘	如何预防青春豆
心脏早搏如何治疗	心脏早博如何治疗
牙齿疼怎么办	芽齿疼怎么办
燃气灶打不着火是什么原因	然气灶打不着火是什么原因
药品怎么读	药品怎么卖
蜜蜂蛰了怎么处理	蜜峰蛰了怎么处理
心脏供血不足吃什么药	心赃供血不足吃什么药
痛风病人能吃菠菜吗	痛风病人能吃波菜吗
经期可以泡脚吗	经期可以跑脚吗
来大姨妈能喝酒吗	来大姨吗能喝酒吗
胃胀气怎么回事	胃帐气怎么回事
髋关节积液的治疗方法	宽关节积液的治疗方法
美容养颜喝什么茶	美蓉养颜喝什么茶
咳嗽的原因有哪些	咳嗽的原因有那些
性刘的女明星有哪些人	姓刘的女明星有哪些人
梅毒的症状有哪些	梅毒的症状有那些
肝不好的症状有哪些	干不好的症状有哪些
右边腰疼是什么原因	右边要疼是什么原因
经常用开塞露有什么副作用	经常用开赛露有什么副作用
神经官能症吃什么药	神经官能证吃什么药
甲沟炎用什么药膏	甲钩炎用什么药膏
宁波属于哪个市	宁波属于那个市
心脏供血不足怎么调理	心脏共血不足怎么调理
乙肝有哪些症状	艺肝有哪些症状
脚浮肿怎么办	脚俘肿怎么办
慢性咽炎的症状	慢性咽炎的证状
宫颈癌前期有什么症状	宫颈癌前期有什么证状
微信零钱通和支付宝余额宝哪个收益高	微信零钱痛和支付宝余额宝哪个收益高
糖尿病的症状有哪些	糖尿病的证状有哪些
湿气重的食物有哪些	湿气重的食物有那些
淋巴瘤有什么症状	淋巴瘤有什么证状
背上长痘痘的原因	背上张痘痘的原因
浙江会在哪里	浙江会在那里
皮肤发痒怎么回事	皮夫发痒怎么回事
汗疱疹怎样根治	汗泡疹怎样根治
熏艾条的功效与作用	薰艾条的功效与作用
老是放臭屁是怎么回事	老是防臭屁是怎么回事
搪瓷锅可以熬中药吗	唐瓷锅可以熬中药吗
0六年是闰哪个月	0六年是润哪个月
六味地黄丸哪个牌子好	六味地黄丸那个牌子好
双氯芬酸钠栓的作用与功效	双氯芬酸纳栓的作用与功效
板面汤怎么做	版面汤怎么做
打开付款吗	打开付款码
妊娠糖尿病能吃什么水果	任娠糖尿病能吃什么水果
苹果手机怎么设置来电铃声	平果手机怎么设置来电铃声
艺伎线条多少钱	艺妓线条多少钱
虾不能和什么一起吃	吓不能和什么一起吃
支付宝可以转账到信用卡吗	支付宝可以转帐到信用卡吗
杭州哪里有摩托车卖	杭州哪里有摩托车买
肚脐眼痛是怎么回事	肚齐眼痛是怎么回事
脉搏一分钟九十下正常吗	脉博一分钟九十下正常吗
哪里治疗鼻炎好	那里治疗鼻炎好
系统性红斑狼疮	系统性红斑琅疮
长痘痘的原因是什么	张痘痘的原因是什么
颈椎痛怎么缓解	劲椎痛怎么缓解
梅毒的症状	梅毒的证状
荨麻疹吃什么药	寻麻疹吃什么药
喉咙有痰怎么办	侯咙有痰怎么办
刘亚的拼音	刘娅的拼音
神经性头痛怎么治疗	神经性头通怎么治疗
宝宝感冒鼻塞怎么办	宝宝感冒鼻赛怎么办
带状泡疹最佳治疗方法	带状疱疹最佳治疗方法
炉石传说哪些牌可以分解	炉石传说那些牌可以分解
哪个网站买书便宜	哪个网站卖书便宜
女性更年期年龄	女姓更年期年龄
痛风能吃冰淇淋吗	通风能吃冰淇淋吗
精神分裂症吃什么药好	精神分列症吃什么药好
在哪里学宠物美容	在那里学宠物美容
怎样预防新生儿黄疸	怎样预防新生儿黄胆
甲硝唑栓的作用与用途	甲硝坐栓的作用与用途
哪个牌子的奶油好	那个牌子的奶油好
支气管哮喘	支气官哮喘
下巴上长痘痘是什么原因	下吧上长痘痘是什么原因
双肺纹理增多增粗是什么意思	双肺文理增多增粗是什么意思
荨麻疹能吃鸡肉吗	荨麻诊能吃鸡肉吗
喉咙滤泡增生怎么办	喉咙虑泡增生怎么办
如何治疗抑郁症	如何治疗抑郁证
肌肝高是什么意思	几肝高是什么意思
功能性消化不良怎么治	功能性销化不良怎么治
微信号怎么注销	微信号怎么注消
新生儿肺炎的症状有哪些	新生儿肺炎的症状有那些
a七十二支持面容解锁吗	a七十二支持面容解锁码
孕妇可以吃料酒吗	孕妇可以吃料酒马
肚子痛拉肚子怎么办	肚子痛啦肚子怎么办
霉菌性阴道炎怎么治疗	霉菌性阴道炎怎么治了
鸡蛋能和菠萝一起吃吗	鸡蛋能和波萝一起吃吗
我当阴阳先生的那几年	我当阴阳先生的哪几年
做肠镜需要多长时间	做肠境需要多长时间
消费者有哪些权益	消费者有那些权益
微信把好友删了对方知道吗	微信吧好友删了对方知道吗
哺乳期可以烫发吗	哺乳期可以汤发吗
苦瓜的功效有哪些	苦瓜的功效有那些
拉血怎么回事	啦血怎么回事
左下腹痛怎么回事	左下复痛怎么回事
扁平疣的治疗方法	扁平尤的治疗方法
胃癌都有哪些症状	胃癌都有那些症状
水痘症状图片	水逗症状图片
荨麻疹的有效治疗方法	寻麻疹的有效治疗方法
郑州是属于哪个省	郑州是属于那个省
喜帖街的歌词	喜贴街的歌词
孕妇吃哪些食物容易流产	孕妇吃那些食物容易流产
吃海鲜荨麻疹	吃海鲜寻麻疹
怀孕几个月长妊娠纹	怀孕几个月长任娠纹
坐骨神经痛症状	坐骨神经痛症壮
脚扭伤肿了怎么办	脚纽伤肿了怎么办
龟头炎的症状	龟头炎的证状
什么是阳光	什么是日光
干眼症如何治疗	干眼证如何治疗
泌乳素高怎么办	必乳素高怎么办
莲耦怎么做才好吃	莲藕怎么做才好吃
哪里烧烤最好吃	那里烧烤最好吃
小米粥糖分高吗	小米粥糖份高吗
偏头痛是怎么引起的	遍头痛是怎么引起的
滴虫性阴道炎的症状	滴虫性阴道炎的证状
双眼皮做哪种好	双眼皮做那种好
频发房性早搏严重吗	频发房性早博严重吗
多囊卵巢综合症	多馕卵巢综合症
肠炎的症状有哪些	肠炎的症状有那些
重庆哪些是三甲医院	重庆那些是三甲医院
吃完榴莲可以喝牛奶吗	吃完榴连可以喝牛奶吗
苹果手机怎么格式化	苹果手机怎么各式化
嘴唇上长泡怎么办	嘴唇上张泡怎么办
降尿酸的药有哪些	降尿酸的药有那些
淋巴细胞百分比偏高	琳巴细胞百分比偏高
坐月子吃什么好	座月子吃什么好
喉咙长息肉有什么症状	喉咙张息肉有什么症状
治疗白癜风的药物有哪些	治疗白殿风的药物有哪些
女孩子取什么名字好听	女孩子娶什么名字好听
怎么在微店上买东西	怎么在微店上卖东西
如何治疗荨麻疹	如何治疗寻麻疹
民政局有哪些部门	民政局有那些部门
长智齿疼怎么办	张智齿疼怎么办
舌苔白是怎么回事	舌台白是怎么回事
人为什么会梦游	认为什么会梦游
无锡站在哪里	无锡站在那里
牙齿有裂痕是什么原因	牙齿有列痕是什么原因
坐骨神经痛看什么科	座骨神经痛看什么科
甘油三酯偏高怎么办	甘油三指偏高怎么办
湿气重吃什么药	湿汽重吃什么药
苹果手机通讯录怎么批量删除	苹果手机通迅录怎么批量删除
逍遥丸能治黄褐斑吗	消遥丸能治黄褐斑吗
云南哪里可以捡到玉石	云南哪里可以捡到宝石
绿萝的营养液怎么配	绿箩的营养液怎么配
前列腺增生有什么症状	前列腺增生有什么症壮
王健林哪里人	王健林那里人
脸上长斑是什么原因	脸上张斑是什么原因
电饼铛哪个牌子好	电饼挡哪个牌子好
香蕉和酸奶可以一起吃吗	香焦和酸奶可以一起吃吗
经常放屁是什么原因	经常放屁是什么愿因
龟头炎的症状有哪些	龟头炎的症状有那些
哮喘有哪些症状	哮喘有那些症状
减肥期间不能吃什么	减肥其间不能吃什么
怎么在淘宝上开网店	怎么在陶宝上开网店
狂犬病传播途径	狂犬病传播途经
荨麻疹注意事项	荨麻诊注意事项
测血糖需要空腹吗	侧血糖需要空腹吗
肝钙化是什么意思	肝丐化是什么意思
灰指甲传染吗	灰指甲转染吗
多西他赛副作用	多西他塞副作用
淋巴结肿大是什么原因	淋疤结肿大是什么原因
脉搏八十五正常吗	脉博八十五正常吗
肝不好有哪些症状	肝不好有哪些症壮
脸上一直长痘痘是什么原因	脸上一直张痘痘是什么原因
吸烟有哪些危害	吸烟有那些危害
胳膊扭伤怎么办	胳膊纽伤怎么办
哪一种减肥药效果好	那一种减肥药效果好
水痘和疱疹的区别	水逗和疱疹的区别
哪个叫什么	那个叫什么
怎样申请低保	怎样伸请低保
湿气重怎么治疗	湿汽重怎么治疗
熬夜喝什么好	敖夜喝什么好
古人背景怎么画	古人背影怎么画
毛囊炎症状	毛囊炎证状
阜阳属于哪里	阜阳属于那里
脚痒脱皮怎么办	脚氧脱皮怎么办
慢性咽炎有哪些症状	慢性咽炎有那些症状
尖锐湿疣的初期症状	尖锐湿尤的初期症状
胰腺炎的症状有哪些	胰腺炎的症状有那些
洛阳晚上哪里好玩	洛阳晚上那里好玩
赵云出反甲还是不详	赵云出反甲还是不祥
雷克萨斯产自哪个国家	雷克萨斯产自那个国家
补血的药物有哪些	补血的药物有那些
荨麻疹不能吃什么	寻麻疹不能吃什么
一岁宝宝呕吐	一岁宝宝欧吐
带清的昵称	带青的昵称
咽炎会咳嗽吗	咽炎会咳嗽妈
带状疱疹会自愈吗	带状泡疹会自愈吗
转基因食品有哪些	转基因食品有那些
脸上长小疙瘩怎么办	脸上张小疙瘩怎么办
放疗和化疗有什么区别	方疗和化疗有什么区别
绝经前的症状	绝经前的证状
生理期可以洗头发吗	生理期可以冼头发吗
中联重科董事长是谁	中联重科懂事长是谁
心肌缺血的症状	心肌缺血的证状
产妇能吃菠萝蜜吗	产妇能吃波萝蜜吗
糖尿病人能喝牛奶吗	糖脲病人能喝牛奶吗
右边腰疼是怎么回事	有边腰疼是怎么回事
小番茄糖分多吗	小番茄糖份多吗
荨麻疹能吹空调吗	寻麻疹能吹空调吗
佳木斯是哪个省的	佳木斯是那个省的
怎么注册微信账号	怎么注册微信帐号
女生要怎么动	女性要怎么动
石英砂用途	石英沙用途
脸上长脂肪粒怎么回事	脸上张脂肪粒怎么回事
怎么还原魔方	怎么还原摩方
膝盖内侧疼是怎么回事	膝盖内测疼是怎么回事
肝右叶小囊肿	肝右叶小囊中
宫颈炎症状	宫颈炎正状
怎么买电影票	怎么卖电影票
淋巴细胞偏低	琳巴细胞偏低
感冒吃什么水果好	感帽吃什么水果好
怀孕初期吃什么好	坏孕初期吃什么好
盐酸普萘洛尔片的作用	盐酸普奈洛尔片的作用
抑郁症怎么治疗	抑郁症怎么治辽
胚胎生化有那些前兆	胚胎生化有哪些前兆
肠梗阻怎么治疗	肠梗组怎么治疗
智能手机怎么用	知能手机怎么用
温州有哪些区	温州有那些区
减肥可以吃葡萄吗	减肥可以吃葡萄妈
小腹胀痛是怎么回事	小腹长痛是怎么回事
慢性萎缩性胃炎症状	慢性萎缩性胃炎证状
哮喘病的症状	哮喘病的证状
下奶的食物有哪些	下奶的食物有那些
结肠炎有那些症状	结肠炎有那些正状
孕妇可以吃冰激凌吗	孕妇可以吃冰激凌马
来月经可以刮痧吗	来月经可以括痧吗
嘉兴是哪个省的	嘉兴是那个省的
难以想象的意思	难以想像的意思
精囊炎有哪些症状	精囊炎有那些症状
什么的锦缎	什么的锦锻
哺乳期可以吃阿莫西林胶囊吗	哺乳期可以吃啊莫西林胶囊吗
有痰咳不出来怎么办	有谈咳不出来怎么办
左上腹疼痛	左上复疼痛
舌苔发黑是什么原因	舌苔发嘿是什么原因
朱元漳为什么要大杀功臣	朱元璋为什么要大杀功臣
腿疼是什么原因	腿疼是什么愿因
痛风不能吃哪些食物	痛风不能吃那些食物
弟是什么意思	悌是什么意思
西红柿首富在哪拍的	西红柿首富在那拍的
唐嫣哪里人	唐嫣那里人
湿疣怎么治疗	湿尤怎么治疗
怎么去除痘印	怎么去除逗印
浙江是哪个省的	浙江是那个省的
人流后多久来月经	人流后多久莱月经
拉肚子可以打预防针吗	啦肚子可以打预防针吗
来月经腰酸怎么回事	来月经要酸怎么回事
脖子后面长痘	脖子后面张痘
哪些人不适合吃蜂蜜	那些人不适合吃蜂蜜
月经期间可以吃山竹吗	月经其间可以吃山竹吗
喝牛奶拉肚子怎么办	喝牛奶啦肚子怎么办
肾虚脱发怎么治疗	肾虚脱发怎么治辽
尿液混浊是怎么回事	尿夜混浊是怎么回事
人流挂哪个科	人流挂那个科
南通在哪个省	南通在那个省
支付宝可以买充值卡吗	支付宝可以卖充值卡吗
吃榴莲能喝酒吗	吃榴连能喝酒吗
脚底长鸡眼	脚底张鸡眼
活血化瘀中成药有哪些	活血化瘀中成药有那些
买房子上什么网	卖房子上什么网
便血有哪些原因	便血有那些原因
经常放屁是怎么回事	经常方屁是怎么回事
焦虑症的症状	焦虑症的症壮
打饱嗝是什么原因	打饱隔是什么原因
慢性胃炎可以吃苹果吗	漫性胃炎可以吃苹果吗
双侧肾盂未见明显分离是什么意思	双测肾盂未见明显分离是什么意思
小鸟叼生日	小鸟刁生日
家常菜都有哪些	家常菜都有那些
孕晚期能吃方便面吗	孕晚期能吃放便面吗
补脾胃的食物有哪些	补脾胃的食物有那些
怎样提高免疫力	怎样题高免疫力
湿气重的症状有哪些	湿气重的症状有那些
古代四大美女那几个	古代四大美女哪几个
拉的屎是黑色的	啦的屎是黑色的
孕妇可以吃泡面吗	孕妇可以吃泡面妈
怎么种白萝卜	怎么种白罗卜
吃什么长卵泡	吃什么张卵泡
常州是属于哪个省	常州是属于那个省
尖锐湿疣症状	尖锐湿尤症状
暑湿感冒吃什么药	署湿感冒吃什么药
红塔山香烟哪里有买的	红塔山香烟哪里有卖的
小腿痒是怎么回事	小腿氧是怎么回事
额头上长小疙瘩	额头上张小疙瘩
落枕脖子疼怎么办	洛枕脖子疼怎么办
世界人口最多的国家是哪个	世界人口最多的国家是那个
慢性荨麻疹吃什么好	慢性寻麻疹吃什么好
王俊凯在重庆哪里	王俊凯在重庆那里
什么样的阳光	什么样的日光
菱形块怎么切	菱形快怎么切
连云港是哪个省	连云港是那个省
掉头发是什么原因	掉头发是什么愿因
心情不好怎么办	心请不好怎么办
怎么去螨虫	怎么去满虫
尿酸多少算痛风	尿酸多少算通风
天猫京东哪个好	天猫京东那个好
内分泌失调是什么	内分必失调是什么
手指上长小水泡	手指上张小水泡
八月二十七日是什么星座	八月二十七日是什么星坐
舌头俩侧发麻	舌头两侧发麻
甲亢会传染吗	甲亢会转染吗
什么是躁郁症	什么是躁郁证
怀孕一周的征兆	还孕一周的征兆
慢性浅表性胃炎伴糜烂	漫性浅表性胃炎伴糜烂
小孩长痱子怎么办	小孩张痱子怎么办
西葫芦成份	西葫芦成分
尿液有泡沫是怎么回事	尿液有泡末是怎么回事
感冒嗓子哑	感冒桑子哑
胃疼还打嗝是怎么回事	胃疼还打隔是怎么回事
荨麻疹一到晚上就痒	寻麻疹一到晚上就痒
尿液发红怎么办	尿夜发红怎么办
心脏病的早期症状有哪些	心脏病的早期症状有那些
尿毒症的症状有哪些	尿毒症的症状有那些
脚水肿是怎么回事	脚水中是怎么回事
脂肪肝是什么症状	脂肪肝是什么证状
小孩几个月长牙	小孩几个月长呀
荨麻疹不能吃什么	荨麻诊不能吃什么
希腊属于哪个州	希腊属于那个州
宝宝贫血有什么症状	宝宝贫血有什么证状
四川在哪个地震带	四川在那个地震带
荨麻疹是啥样的	寻麻疹是啥样的
结肠炎什么症状	结肠炎什么证状
经期可以喝菊花茶吗	经期可以喝菊花茶马
胀气的食物有哪些	帐气的食物有哪些
脸上皮肤痒是怎么回事	脸上皮肤庠是怎么回事
大拇指甲有竖纹是怎么回事	大姆指甲有竖纹是怎么回事
经常腹泻是什么原因	经常复泻是什么原因
做完双眼皮注意事项	做玩双眼皮注意事项
紫癜有什么症状	紫殿有什么症状
室性早搏算不算心脏病	室性早博算不算心脏病
有痰咳不出怎么办	有谈咳不出怎么办
牛黄上清片的功效与作用	牛黄上青片的功效与作用
带状疱疹是怎么引起的	带壮疱疹是怎么引起的
减肥药有哪些危害	减肥药有那些危害
不可想象不能理解的成语	不可想像不能理解的成语
糖尿病并发症有哪些	糖尿病屏发症有哪些
买理财产品有风险吗	卖理财产品有风险吗
湖南大学那些专业比较好	湖南大学哪些专业比较好
梦见下大雪	梦见吓大雪
蛋白质食物有哪些	蛋白质食物有那些
怀孕肚子胀怎么回事	怀孕肚子帐怎么回事
小孩腿抽筋	小孩退抽筋
怎么删除淘宝订单	怎么删除陶宝订单
中暑会肚子疼吗	中署会肚子疼吗
重庆都有哪些好玩的地方	重庆都有那些好玩的地方
皮肤癌有哪些症状	皮肤癌有那些症状
胰腺炎的症状是什么	胰腺炎的证状是什么
血清阳性是什么意思	血青阳性是什么意思
尖锐湿疣的症状	尖锐湿疣的正状
华山是哪个市	华山是那个市
坐骨神经痛症状	坐骨神经痛证状
病毒性疱疹怎么治疗	病毒性泡疹怎么治疗
胃炎有什么症状	胃炎有什么证状
经常腹泻是怎么回事	经常复泻是怎么回事
谷歌怎么注册账号	谷歌怎么注册帐号
胃食管反流吃什么药	胃食馆反流吃什么药
先有鸡还是先有蛋	先右鸡还是先有蛋
青霉素和头孢那个好	青霉素和头孢哪个好
腊七腊八冻死寒鸦的意思	蜡七腊八冻死寒鸦的意思
张杰她老婆是谁	张杰他老婆是谁
双侧卵巢多囊	双测卵巢多囊
身上长红痣是怎么回事	身上张红痣是怎么回事
芦荟可以直接擦脸吗	芦会可以直接擦脸吗
星座按阴历还是阳历算	星座安阴历还是阳历算
淘宝运费险怎么买	淘宝运费险怎么卖
脚底长刺猴怎么治	脚底长刺瘊怎么治
你长什么样	您长什么样
转氨酶高的原因	转安酶高的原因
前列腺增生吃什么药	前裂腺增生吃什么药
行车记录仪什么牌子好	行车纪录仪什么牌子好
无痛人流要多少钱	无通人流要多少钱
嘴唇上长泡怎么办	嘴唇上长疱怎么办
精神分裂症吃什么药最好	精神分裂证吃什么药最好
支气管炎怎么治疗	支气官炎怎么治疗
神经官能症的治疗	神经管能症的治疗
俩腿之间有疙瘩	两腿之间有疙瘩
小孩几岁换牙	小骇几岁换牙
月经期能吃芒果吗	月经期能吃忙果吗
尿毒症有什么症状	尿毒证有什么症状
信用卡哪个银行的最好	信用卡那个银行的最好
支原体感染是什么意思	支愿体感染是什么意思
糖尿病可以吃胡萝卜吗	糖尿病可以吃胡罗卜吗
哪些动物是气象员	那些动物是气象员
月经期间可以打消炎针吗	月经其间可以打消炎针吗
吃什么能提高免疫力	吃什么能提高勉疫力
王健林哪里人	王建林哪里人
宫颈糜烂有哪些症状	宫颈糜烂有那些症状
做散瞳对眼睛有伤害吗	做散童对眼睛有伤害吗
豆浆机什么牌子的好	豆将机什么牌子的好
胆汁反流性胃炎的症状	胆汁反流性胃炎的证状
微信怎么查聊天记录	微信怎么查聊天纪录
猫一年生几胎	猫一年生几台
中国最大的鱼具市场	中国最大的渔具市场
孕妇可以拔罐吗	孕妇可以拔罐妈
老年性皮肤瘙痒症	老年性皮肤瘙痒证
补气血的药有哪些	补气血的药有那些
对男生的赞美	对男性的赞美
子宫肌瘤能吃鸡肉吗	子宫几瘤能吃鸡肉吗
菠菜和鸡蛋能一起吃吗	波菜和鸡蛋能一起吃吗
逍遥丸什么时候吃好	消遥丸什么时候吃好
夏桑菊颗粒的作用	夏嗓菊颗粒的作用
喝阿莫西林能喝酒吗	喝啊莫西林能喝酒吗
胸部胀痛是不是怀孕了	胸部帐痛是不是怀孕了
梦中的婚礼简谱	梦中的婚礼间谱
膀胱炎有什么症状	旁胱炎有什么症状
胡萝卜怎么做好吃	胡罗卜怎么做好吃
慢性浅表性胃炎伴糜烂	慢性浅表性胃炎半糜烂
咽喉癌的症状	咽喉癌的证状
痛风可以喝豆奶吗	通风可以喝豆奶吗
怎么去除地板上的乳胶漆	怎么祛除地板上的乳胶漆
朦拼音带组词	蒙拼音带组词
人生是什么	认生是什么
眼皮上长麦粒肿怎么办	眼皮上张麦粒肿怎么办
新生儿打嗝怎么办	新生儿打隔怎么办
怎样去皱纹	怎样去绉纹
血管性头痛吃什么药	血官性头痛吃什么药
查过敏源怎么查	查过敏原怎么查
幽门螺旋杆菌传染吗	幽门螺旋杆菌转染吗
为什么坐车脚会肿	为什么座车脚会肿
皮肤过敏的症状	皮肤过敏的正状
怎么在微信上卖东西	怎么在微信上买东西
哪个星座男人最好	那个星座男人最好
膝关节韧带损伤	膝关节忍带损伤
额头和下巴长痘是什么原因	额头和下巴长豆是什么原因
微信密码忘记了怎么办	薇信密码忘记了怎么办
开塞露可以擦脸吗	开塞路可以擦脸吗
有哪些好看的动漫电影	有那些好看的动漫电影
哺乳期可以吃桃子吗	哺乳期可以吃桃子妈
孕妇可以吃生蚝吗	孕妇可以吃生蚝妈
女性内分泌失调吃什么药	女姓内分泌失调吃什么药
下肢静脉曲张的治疗	下支静脉曲张的治疗
党员有哪些权利	党员有那些权利
胃溃疡的症状有哪些	胃溃疡的证状有哪些
肝脏不好有什么症状	肝脏不好有什么正状
咳嗽有黄痰吃什么药	咳嗽有黄谈吃什么药
颈部淋巴结肿大	颈部琳巴结肿大
嘉兴哪里有好玩的地方	嘉兴那里有好玩的地方
下腹痛怎么回事	下复痛怎么回事
关节松动术的适应证	关节松动术的适应症
淋巴在哪个位置	淋巴在那个位置
长痘痘可以敷面膜吗	张痘痘可以敷面膜吗
冼衣机多少瓦	洗衣机多少瓦
甲状腺球蛋白抗体高是什么意思	甲壮腺球蛋白抗体高是什么意思
肩周炎看哪个科室	肩周炎看那个科室
身体水分低怎么回事	身体水份低怎么回事
怎样去疤痕	怎样去巴痕
促甲状腺激素受体抗体	促甲壮腺激素受体抗体
女生为主角的电视剧	女性为主角的电视剧
绍兴有哪些高中	绍兴有那些高中
竖折折钩怎么写	竖折折勾怎么写
卡莎哪个皮肤	卡沙哪个皮肤
长春搬家公司哪家好	长春搬家公司那家好
银行一般几点上班	银行一搬几点上班
两月二十七日是什么星座	两月二十七日是什么星坐
前额胀痛是什么原因	前额帐痛是什么原因
粉底液哪个牌子好	粉底液那个牌子好
包皮手术多少钱	抱皮手术多少钱
倒瓜子脸适合什么发型	到瓜子脸适合什么发型
眼睛上长针眼	眼睛上张针眼
肾囊肿是什么	肾馕肿是什么
三个月宝宝流清鼻涕怎么办	三个月宝宝流青鼻涕怎么办
高血压怎么治疗	高血压怎么治辽
北京的区号	背京的区号
脂肪肝有什么症状	脂防肝有什么症状
怀男孩的症状	怀男孩的证状
膀胱癌的症状	膀胱癌的证状
抑郁症如何治疗	抑郁正如何治疗
脸上长痤疮怎么治疗	脸上张痤疮怎么治疗
怀孕多久能测出来	还孕多久能测出来
下巴长痘痘的原因	下疤长痘痘的原因
淋巴结怎么治疗	淋吧结怎么治疗
员工请假条怎么写	员工清假条怎么写
芦荟可以直接涂在脸上吗	芦会可以直接涂在脸上吗
乳房疼是怎么回事	乳妨疼是怎么回事
南京哪最好玩	南京那最好玩
抑郁症能治愈吗	抑郁证能治愈吗
新生儿黄疸值多少正常	新生儿黄疸直多少正常
宫寒的症状有哪些	宫寒的症状有那些
青岛和大连哪个好	青岛和大连那个好
哺乳期可以吃李子吗	哺乳期可以吃李子妈
开塞露怎么用	开赛露怎么用
舌苔厚腻是怎么回事	舌台厚腻是怎么回事
上腹胀是什么原因	上腹帐是什么原因
甲状腺结节钙化是怎么回事	甲状腺结节丐化是怎么回事
荨麻疹是怎么引起来的	寻麻疹是怎么引起来的
左胸下方是什么器官	左胸下放是什么器官
甲状腺癌术后能活多久	胛状腺癌术后能活多久
哪些网站可以免费发布信息	那些网站可以免费发布信息
家用血压计哪种好	家用血压计那种好
咳嗽艾灸哪个穴位	咳嗽艾灸那个穴位
冬天荨麻疹	冬天寻麻疹
橙子糖分高吗	橙子糖粉高吗
扁桃体发炎化脓吃什么药	扁桃体发炎化浓吃什么药
女性尿结石的症状	女姓尿结石的症状
深圳有什么好玩的地方	深圳有什么好完的地方
荨麻疹不能吃什么食物	荨麻诊不能吃什么食物
月经淋漓不尽怎么办	月经淋离不尽怎么办
支气管发炎怎么办	支汽管发炎怎么办
小孩出水痘怎么办	小孩出水逗怎么办
吃方便面好吗	吃放便面好吗
什么是更年期综合症	什么是更年期综合证
孕妇拉肚子怎么办	孕妇啦肚子怎么办
流产后的注意事项	流产后的住意事项
面膜过敏怎么办	面莫过敏怎么办
什么是甲状腺结节	什么是胛状腺结节
脚痒脱皮起水疱是怎么回事	脚痒脱皮起水泡是怎么回事
肚子涨是什么原因	肚子涨是什么愿因
气缸垫有哪些类型	汽缸垫有哪些类型
月经推迟多久能测出怀孕	月经推迟多久能侧出怀孕
那里批发服装便宜	哪里批发服装便宜
脚底蜕皮怎么回事	脚底脱皮怎么回事
伤口化脓怎么处理	伤口化浓怎么处理
大拇指疼怎么办	大姆指疼怎么办
甲状腺球蛋白抗体高是怎么回事	甲壮腺球蛋白抗体高是怎么回事
幼儿舌头长泡疹图	幼儿舌头长疱疹图
吃什么增强免疫力	吃什么增强勉疫力
对月贴怎么写	对月帖怎么写
南州是什么地方	南洲是什么地方
青春痘疤痕怎么消除	青春豆疤痕怎么消除
皮肤晒伤怎么办	皮夫晒伤怎么办
榴莲有哪些品种	榴莲有那些品种
怎么申请支付宝账号	怎么申请支付宝帐号
如何注册淘宝账号	如何注册淘宝帐号
猕猴桃会上火吗	弥猴桃会上火吗
小孩得了荨麻疹怎么办	小孩得了寻麻疹怎么办
新鲜莲子的功效与作用	新鲜连子的功效与作用
耳朵后面长疙瘩	耳朵后面长疙搭
怎样申请微信号	怎样伸请微信号
下巴疼是怎么回事	下把疼是怎么回事
拉肚子可以喝茶吗	啦肚子可以喝茶吗
脚底长水泡是什么原因	脚底长水疱是什么原因
哪种减肥药安全有效	那种减肥药安全有效
嘴巴周围长痘	嘴吧周围长痘
做仰卧起坐能减肥吗	做仰卧起座能减肥吗
血小板低是怎么回事	血小版低是怎么回事
小孩扁桃体发炎咳嗽	小孩篇桃体发炎咳嗽
糖尿病早期症状	糖尿病早期症壮
健脾胃的食物	建脾胃的食物
迈凯伦汽车标志	迈凯轮汽车标志
低血压症状	低血压证状
侧柏叶的功效	则柏叶的功效
免疫球蛋白多少钱一针	免疫求蛋白多少钱一针
手发抖是什么原因引起的	手发斗是什么原因引起的
有跳蚤怎么弄	有跳骚怎么弄
衡阳在哪里	衡阳在那里
怎么折爱心	怎么哲爱心
来月经腰痛	来月经要痛
如何一夜暴富	如何一夜爆富
北京站在哪个区	北京站在那个区
神经衰弱有哪些症状	神经衰弱有那些症状
怎么看苹果手机真假	怎么看平果手机真假
晚上吃香蕉有什么好处	晚上吃香焦有什么好处
高铁股票有哪些	高铁股票有那些
内眼角痒是怎么回事	内眼角庠是怎么回事
脚爆皮是怎么回事	脚暴皮是怎么回事
红薯糖分高吗	红署糖分高吗
小腿酸痛是什么原因	小退酸痛是什么原因
什么是硬下疳	什么是硬下甘
解脲支原体阳性怎么办	解尿支原体阳性怎么办
小腿胀痛怎么办	小腿张痛怎么办
大姨妈来了要注意什么	大姨妈来了要主意什么
做肠镜多少钱	做肠竟多少钱
颈椎压迫神经的症状	颈椎压迫神经的证状
怎样腌罗卜干	怎样淹罗卜干
一寸等多少厘米	一寸等多少里米
膀胱过度活动症的症状	膀胱过度活动证的症状
肝硬化晚期症状	肝硬化晚期正状
哪个牌子拖把好	那个牌子拖把好
水状白带是怎么回事	水壮白带是怎么回事
六大行动台帐	六大行动台账
心脏早搏是怎么引起的	心脏早博是怎么引起的
纪念碑谷第九关怎么过	记念碑谷第九关怎么过
高锰酸钾能治脚气吗	高锰酸钾能治脚气马
被猫抓了要打针吗	被猫爪了要打针吗
长治二甲医院有那些	长治二甲医院有哪些
被开水烫伤起泡怎么办	被开水汤伤起泡怎么办
肾结石什么症状	肾结石什么证状
抑郁症治疗方法	抑郁证治疗方法
孝感哪个厂工资高	孝感那个厂工资高
脚底板痒是怎么回事	脚底版痒是怎么回事
红薯长芽了还能吃吗	红署长芽了还能吃吗
包皮手术有哪几种	包皮手术有那几种
头孢是消炎药吗	头胞是消炎药吗
放屁臭是什么原因	防屁臭是什么原因
淋巴结肿大严重吗	林巴结肿大严重吗
洗牙的好处	洗呀的好处
普洱茶能减肥吗	谱洱茶能减肥吗
撒的多音字组字	散的多音字组字
一万公积金能贷款多少	一万公积金能代款多少
湿疹的发病原因	湿诊的发病原因
性病的症状有哪些	性病的症状有那些
血糖高可以吃红薯吗	血糖高可以吃红署吗
蓝牙耳机怎么用	蓝呀耳机怎么用
乙肝小三阳会传染吗	乙干小三阳会传染吗
一安培等多少库仑	一安培等多少库伦
脚受伤了吃哪些食物恢复得快	脚受伤了吃那些食物恢复得快
荨麻疹可以吃鸡翅吗	寻麻疹可以吃鸡翅吗
肾虚是什么症状	肾虚是什么证状
催月经来的方法	崔月经来的方法
中暑了吃什么药	中署了吃什么药
内痔有什么症状	内痔有什么证状
宫腔积液吃什么药	宫腔积夜吃什么药
怎么去除扁平疣	怎么去除扁平尤
黄疸有哪些症状	黄疸有那些症状
手上长鸡眼	手上张鸡眼
车架号是什么	车加号是什么
如何申请小号	如何申清小号
什么食物降血糖	什么食物绛血糖
肝脏血管瘤注意什么	肝脏血官瘤注意什么
支付宝如何解绑手机号	支付宝如何解邦手机号
甲状腺病传染吗	甲壮腺病传染吗
老是长口腔溃疡是什么原因	老是张口腔溃疡是什么原因
小三阳和大三阳哪个严重	小三阳和大三阳那个严重
说话结巴怎么办	说话结吧怎么办
孕妇可以吃冰激凌吗	孕妇可以吃冰激凌妈
奥美拉唑饭前吃还是饭后吃	奥美啦唑饭前吃还是饭后吃
耳朵痒是怎么回事	耳朵庠是怎么回事
膀胱炎有什么症状	膀胱炎有什么证状
经常打嗝是怎么回事	经常打隔是怎么回事
心脏彩超多少钱	心赃彩超多少钱
苹果平板电脑可以打电话吗	平果平板电脑可以打电话吗
月经期间能拔牙吗	月经其间能拔牙吗
慢性胃炎的症状	慢性胃炎的证状
荨麻疹能吃姜	寻麻疹能吃姜
哪些人不适合吃阿胶	那些人不适合吃阿胶
韩国化妆品有哪些品牌	韩国化妆品有那些品牌
早上空腹可以吃苹果吗	早上空复可以吃苹果吗
一把青哪里可以看	一把青那里可以看
腰椎间盘突出正确睡姿	腰椎间盘突出正确睡资
颈椎病的症状有哪些	颈椎病的证状有哪些
小肚子胀怎么回事	小肚子帐怎么回事
拉肚子能打预防针吗	啦肚子能打预防针吗
月经期间怎么减肥	月经其间怎么减肥
梅尼埃病是什么病	梅尼挨病是什么病
什么时候清明节	什么时候青明节
转氨酶高有什么症状	转氨酶高有什么证状
腰左侧疼是怎么回事	要左侧疼是怎么回事
甲状腺球蛋白偏高	甲状腺求蛋白偏高
嘴唇长疱疹是什么原因	嘴唇长泡疹是什么原因
拉屎拉不出来怎么办	拉屎啦不出来怎么办
甲状腺球蛋白高	甲壮腺球蛋白高
拔罐出水泡是怎么回事	拔罐出水疱是怎么回事
糖尿病人可以吃莲藕吗	糖尿病人可以吃连藕吗
氯化钾注射液可以口服吗	氯化钾注射夜可以口服吗
静脉曲张有哪些危害	静脉曲张有那些危害
微信转账多久到账	微信转帐多久到账
脚背痛是不是痛风	脚背痛是不是通风
服用逍遥丸的副作用	服用消遥丸的副作用
硫磺皂洗脸好吗	流磺皂洗脸好吗
牛奶和香蕉可以同时吃吗	牛奶和香焦可以同时吃吗
腋下淋巴结肿大怎么办	夜下淋巴结肿大怎么办
怀孕能吃牛肉吗	怀孕能吃牛肉妈
电信移动联通哪个好	电信移动联通那个好
脚气水泡怎么治疗	脚气水疱怎么治疗
盆腔积液是什么	盆腔积夜是什么
经期可以洗牙吗	经期可以洗呀吗
健身能长高吗	建身能长高吗
新生儿喉咙有痰怎么办	新生儿喉咙有谈怎么办
肩膀长痘痘是什么原因	肩膀张痘痘是什么原因
左下腹痛是怎么回事	左下复痛是怎么回事
经常头痛是什么原因	经常头痛是什么愿因
怎样才能去除脸上的痘印	怎样才能祛除脸上的痘印
丙氨酸转氨酶偏高是什么原因	丙氨酸转安酶偏高是什么原因
感冒喉咙痛吃什么药好	感帽喉咙痛吃什么药好
腰肌劳损怎么治疗	腰肌劳损怎么治辽
姜和白醋能去斑吗	姜和白醋能祛斑吗
老放屁怎么办	老方屁怎么办
北京属于哪个省	北京属于那个省
宝宝腹泻怎么办	宝宝复泻怎么办
宝宝老是揉眼睛是怎么回事	宝宝老是柔眼睛是怎么回事
脂肪肝怎么治	脂方肝怎么治
小腿痒是怎么回事	小退痒是怎么回事
福州哪家装修公司好	福州那家装修公司好
被虫子咬了起水泡	被虫子咬了起水疱
南京属于哪里	南京属于那里
沪是哪里的简称	沪是那里的简称
燃气热水器怎么安装	燃汽热水器怎么安装
震楼器会影响楼下吗	振楼器会影响楼下吗
白癜风会传染吗	白殿风会传染吗
手哆嗦是什么原因	手多嗦是什么原因
男性尿血是怎么回事	男姓尿血是怎么回事
孕妇能吃海参吗	孕妇能吃海参妈
去肝火的食物	去干火的食物
肺结核的传播途径	肺结核的传播途经
佝偻病是什么	佝楼病是什么
哪些昆虫是害虫	那些昆虫是害虫
注意力不集中	主意力不集中
宝宝几个月可以坐	宝宝几个月可以座
荨麻疹检查过敏源	寻麻疹检查过敏源
发烧挂哪个科	发烧挂那个科
右胸口疼是怎么回事	友胸口疼是怎么回事
面瘫怎样按摩	面滩怎样按摩
孕期长斑怎么办	孕期张斑怎么办
过渡性是什么意思	过度性是什么意思
百度在哪里提问	百度在那里提问
宫外孕早期有哪些症状	宫外孕早期有那些症状
猕猴桃果汁怎么做	弥猴桃果汁怎么做
转氨酶高是什么原因	转按酶高是什么原因
湿疹有什么症状	湿诊有什么症状
碳水化合物食物有哪些	碳水化合物食物有那些
新生儿为什么老打嗝	新生儿为什么老打隔
微信怎么群发	微信怎么裙发
淘宝买手机靠谱吗	淘宝卖手机靠谱吗
北京那个医院皮肤科最好	北京哪个医院皮肤科最好
陈薇院士研究的疫苗属于哪类疫苗	陈微院士研究的疫苗属于哪类疫苗
拔罐出水泡是怎么回事	拔灌出水泡是怎么回事
希腊属于哪个州	希腊属于哪个洲
月经期间可以健身吗	月经期间可以建身吗
暗度陈仓的上一句	暗渡陈仓的上一句
肝痛是在哪个位置	肝痛是在那个位置
手机通讯录如何备份	手机通迅录如何备份
骨质疏松的症状	骨质疏松的证状
麦滋林饭前吃还是饭后吃	麦兹林饭前吃还是饭后吃
刮痧后多久可以洗澡	刮莎后多久可以洗澡
肾结石有什么症状	肾洁石有什么症状
怎样才能让腿变细	怎样才能让退变细
放疗一次多少钱	放了一次多少钱
打狂犬疫苗注意事项	打狂犬疫苗主意事项
鼻塞流鼻涕吃什么药	鼻赛流鼻涕吃什么药
强直性脊椎炎的症状	强直性脊椎炎的症壮
手上起小水泡是怎么回事	手上起小水疱是怎么回事
桔子糖分高吗	桔子糖份高吗
慢性宫颈炎怎么治	曼性宫颈炎怎么治
软化血管的食物有哪些	软化血管的食物有那些
咽喉炎怎么治疗	咽喉炎怎么治了
男人大腿根部内侧瘙痒	男人大腿根部内测瘙痒
如何去除牙结石	如何去除牙洁石
卵巢多囊综合症能怀孕吗	卵巢多囊综合证能怀孕吗
如何判断幼儿急疹	如何判断幼儿急诊
坐骨神经痛症状	座骨神经痛症状
心脏早搏的药	心脏早博的药
空腹可以喝柠檬蜂蜜水吗	空复可以喝柠檬蜂蜜水吗
最强nba钻石艾弗森怎么加点	最强nba钻石艾佛森怎么加点
肝胆湿热的症状	肝胆湿热的正状
新生儿要准备哪些东西	新生儿要准备那些东西
荨麻疹的治疗方法	寻麻疹的治疗方法
消防拴漏水	消防栓漏水
碳酸钠是什么	炭酸钠是什么
淤血淤青怎么消除	瘀血淤青怎么消除
心肌梗塞有哪些症状	心肌梗塞有那些症状
吃完榴莲不能吃什么	吃完榴连不能吃什么
高蛋白食物有哪些	高蛋白食物有那些
肺部衣原体感染症状	肺部依原体感染症状
大拇指腱鞘炎的治疗	大姆指腱鞘炎的治疗
小米账号怎么注销	小米帐号怎么注销
肩膀痛是什么原因	肩旁痛是什么原因
什么样的嘴巴	什么样的嘴吧
宝宝拉肚子怎么办	宝宝啦肚子怎么办
尼泊尔是那个国家	尼泊尔是哪个国家
花呗账单怎么删除	花呗张单怎么删除
纸船怎么折	纸船怎么哲
中国哪个男明星最帅	中国那个男明星最帅
尿频尿急是怎么回事	尿濒尿急是怎么回事
心理医生哪里有	心理医生那里有
淋巴细胞百分比偏低	琳巴细胞百分比偏低
平安车险和人保车险哪个好	平安车险和人保车险那个好
剖腹产多久可以洗澡	剖复产多久可以洗澡
尿毒症的症状有哪些	尿毒证的症状有哪些
糖醋里脊怎么做	糖错里脊怎么做
月子可以吃桃子吗	月子可以吃桃子妈
组织机构代码证在哪里办理	组织机构代码证在那里办理
绘画形式有那些	绘画形式有哪些
手上长水泡怎么办	手上张水泡怎么办
骨质疏松的症状	骨质疏松的症壮
脑梗塞的症状有哪些	脑梗塞的症状有那些
生理期可以吃菠萝吗	生理期可以吃波萝吗
世界上最小的国家是哪个国家	世界上最小的国家是那个国家
东莞火车站在哪里	东莞火车站在那里
如何祛草莓印	如何去草莓印
颧骨高怎么办	颧骨搞怎么办
肾结石能吃豆芽吗	肾结石能吃豆牙吗
老放屁是怎么回事	老房屁是怎么回事
吃完避孕药多久可以吃东西	吃玩避孕药多久可以吃东西
怎样清洗羽绒服	怎样请洗羽绒服
脑梗塞的症状有哪些	脑梗赛的症状有哪些
脑膜炎后遗症能治好吗	脑莫炎后遗症能治好吗
孟鲁司特钠要吃多久	孟鲁司特纳要吃多久
偏头痛是什么原因	翩头痛是什么原因
泡疹的症状	泡诊的症状
湿疹怎么办	湿诊怎么办
爱心怎么折	爱心怎么哲
身上长水泡是怎么回事	身上张水泡是怎么回事
种牙多少钱一颗	种呀多少钱一颗
湖洲到徐州高铁时刻表	湖州到徐州高铁时刻表
中国古代的文房四宝是什么	中国古代的文防四宝是什么
骨癌的症状	骨癌的症壮
治疗灰指甲的药有哪些	治疗灰指甲的药有那些
湿疹是什么引起的	湿诊是什么引起的
肠镜检查前应注意什么	肠境检查前应注意什么
黑芝麻的功效与作用	嘿芝麻的功效与作用
肩周炎的症状	肩周炎的正状
那里有二手摩托车买	那里有二手摩托车卖
新生儿打嗝怎么回事	新生儿打隔怎么回事
如何治疗荨麻疹	如何治疗荨麻诊
肚子胀拉不出大便怎么回事	肚子帐拉不出大便怎么回事
皮肤瘙痒吃什么药	皮夫瘙痒吃什么药
怎么治好荨麻疹	怎么治好寻麻疹
血常规挂哪个科	血常规挂那个科
足浴器哪个牌子好	足浴器那个牌子好
荨麻疹中医如何治疗	寻麻疹中医如何治疗
石家庄是几线城市	石家庄是几线成市
怀孕可以泡温泉吗	怀孕可以跑温泉吗
什么是内分泌失调	什么是内分必失调
最小公倍数怎么求	最小公倍数怎么球
如何渡过奥德赛岁月	如何度过奥德赛岁月
健脾的食物	建脾的食物
脚底长水疱是湿气吗	脚底长水泡是湿气吗
怎么死不痛	怎么死不通
羊奶和牛奶哪个好	羊奶和牛奶那个好
什么人不适合吃芒果	什么人不适合吃忙果
脸上长螨虫怎么办	脸上长满虫怎么办
布艺沙发哪个品牌好	布艺沙发那个品牌好
疱疹几天能好	泡疹几天能好
湿疹与痱子的区别	湿诊与痱子的区别
有几种荨麻疹	有几种寻麻疹
小三阳会传染吗	小三阳会转染吗
太阳穴长痘痘是怎么回事	太阳穴张痘痘是怎么回事
上环后注意事项	上环后主意事项
试管婴儿多少钱	试官婴儿多少钱
慢性荨麻疹怎么根治	慢性荨麻诊怎么根治
哺乳期吃什么好	捕乳期吃什么好
牛仔裤怎么洗不褪色	牛仔裤怎么冼不褪色
带状泡疹最佳治疗方法	带壮泡疹最佳治疗方法
男人可以吃逍遥丸吗	男人可以吃消遥丸吗
婴儿打嗝是什么原因	婴儿打隔是什么原因
孕妇能吃阿莫西林胶囊吗	孕妇能吃啊莫西林胶囊吗
租房都有哪些网站	租房都有那些网站
身体长红痣是什么原因	身体张红痣是什么原因
大拇指指甲凹凸不平是怎么回事	大母指指甲凹凸不平是怎么回事
舌苔有裂纹是怎么回事	舌台有裂纹是怎么回事
胃溃疡的症状有哪些	胃溃疡的症状有那些
逍遥丸和加味逍遥丸有什么区别	消遥丸和加味逍遥丸有什么区别
营口在哪里	营口在那里
小儿肺炎有哪些症状	小儿肺炎有那些症状
郎朗为什么出名	朗朗为什么出名
荨麻疹是什么症状	荨麻诊是什么症状
淘宝买家客服	淘宝卖家客服
沪是哪里的车牌	沪是那里的车牌
精神分列症可以痊愈吗	精神分裂症可以痊愈吗
迷你世界蘑菇怎么繁殖	迷你世界磨菇怎么繁殖
刚出生的婴儿打嗝怎么办	刚出生的婴儿打隔怎么办
开塞露有副作用吗	开赛露有副作用吗
八十后女星名字	八十后女性名字
被蜱虫咬了有什么症状	被脾虫咬了有什么症状
指甲出现竖纹是什么原因	指甲出现竖文是什么原因
电蚊香对孕妇有影响吗	电文香对孕妇有影响吗
荨麻疹会不会传染	荨麻诊会不会传染
什么是心脏早搏	什么是心脏早博
荨麻疹可以吃海苔吗	寻麻疹可以吃海苔吗
我的座右铭是什么意思	我的坐右铭是什么意思
双肺纹理增多紊乱	双肺文理增多紊乱
肾虚什么症状	肾虚什么证状
尖锐湿疣怎么治疗	尖锐湿疣怎么治了
节育环哪种最好	节育环那种最好
不锈钢锅可以熬中药吗	不绣钢锅可以熬中药吗
脂肪肝有什么症状	脂肪肝有什么证状
葛根粉的作用与功效	葛根分的作用与功效
痛风可以吃薯片吗	通风可以吃薯片吗
我的世界怎么防蜘蛛	我的世界怎么放蜘蛛
电饼铛什么牌子的好	电饼挡什么牌子的好
地中海贫血有什么症状	地中海贫血有什么正状
水痘和疱疹的区别	水豆和疱疹的区别
痛风能吃生蚝吗	通风能吃生蚝吗
经常胃胀是什么原因	经常胃帐是什么原因
酷暑难挡是什么意思	酷暑难当是什么意思
什么是美尼尔氏综合症	什么是美尼尔氏综合证
痛风能吃菠菜么	通风能吃菠菜么
咳嗽有痰怎么办	咳嗽有谈怎么办
后背疼是怎么回事	后北疼是怎么回事
满月黄疸正常值	满月黄胆正常值
交感神经型颈椎病症状	交感神经型颈椎病证状
被蚂蚁咬了怎么办	被吗蚁咬了怎么办
刺激性食物有哪些	刺激性食物有那些
脸上汗毛多怎么去除	脸上汗毛多怎么祛除
你有性命吗	你有生命吗
二郎神属什么生肖	二朗神属什么生肖
蚊子会传播艾滋病吗	蚊子会转播艾滋病吗
腹腔淋巴结肿大的症状	腹腔淋巴结肿大的证状
六味地黄丸和逍遥丸可以一起吃吗	六味地黄丸和消遥丸可以一起吃吗
婴儿退烧药有哪些	婴儿退烧药有那些
内分泌失调是什么症状	内分泌失调是什么证状
老人补钙哪个牌子好	老人补钙那个牌子好
膀胱炎的症状	膀胱炎的证状
疱疹和湿疹	泡疹和湿疹
猫为什么舔爪子	猫为什么添爪子
腰椎管狭窄的治疗方法	腰椎管侠窄的治疗方法
肚子胀是什么原因	肚子帐是什么原因
脸上突然长斑是什么原因	脸上突然张斑是什么原因
孕妇可以吃银耳吗	孕妇可以吃银耳妈
