六十三除二	二十乘十四
你不感觉小艾同学比你聪明吗	同学不感觉小艾你比同学聪明吗
十四乘十四等多少	三乘三等多少
八百除五	八百除八十
隔离和防晒用一个行吗	防晒和隔离用一个行吗
四十五乘三	四十五乘二十
二十四乘二十四	四乘二十四
五十五乘五十五	五十五乘二
三十七乘六	五加五等几啊
一点二五除五	一点二五除八
小孩偶尔咳嗽	小孩老是咳嗽
三点五乘一点五	一百五十乘一点五
深圳哪个区最繁华	深圳哪个区最偏僻
一百九十乘五	八减六等几
四点三乘三点四乘四点一四	三点一四乘六十四埒多少
把三又七除八化成假分数	把七又七除八化成假分数
河南师范大学领导名单	河北师范大学领导名单
一百二十四乘六十五	一百二十四乘十二
十八和三十的最大公因数是最小公倍数是	三十和十八的最大公因数是最小公倍数是
十五乘多少等十	十五乘多少等五
十五乘零点六	零点六乘零点六
一百三十八除十八	四点二除零点六
济南至潍坊火车时刻表	潍坊至济南火车时刻表
牙齿老是出血	牙齿偶尔出血
一百八十乘三十	三十乘一百八十
南京禄口机场到扬中	扬中到南京禄口机场
邳州到盐城的火车时刻表	盐城到邳州的火车时刻表
二十三除二十四	二十三除二十五
简述幼儿园家长工作的方法和途径	简述幼儿园家长工作的途径和方法
三乘十三	十三乘三
浙江到青海	青海到浙江
七十乘四	五十乘七十
五百一十除七列竖式计算	五百一十除三竖式计算
便宜的用英语怎么	昂贵的用英语怎么
一千乘一千等几	一千除百除一千等几
三百五十除七十	十二除四分之三
脚上湿疹和脚气的区别	脚上脚气和湿疹的区别
张掖到扁都口多少公里	扁都口到张掖多少公里
两点三乘九	十六乘九
六乘四十五	六乘三十
嘴唇太厚可以整吗	嘴唇太薄可以整吗
跖疣和鸡眼的区别	鸡眼和跖疣的区别
中国最矮的山	中国最高的山
黄体酮和地屈孕酮片的区别	地屈孕酮片和黄体酮的区别
嘴巴被蚊子咬肿怎么办	蚊子把嘴巴咬肿了怎么办
经常只睡五个小时会怎样	偶尔只睡五个小时会怎样
一百二十五乘二十七的简便运算	一百二十五乘十二的简便运算
两万乘三	两万乘一万
形容轻微的词语	形容惨重的词语
二点五乘二点五乘三点一四	二点五乘二点五乘三点五
七乘十五等多少	零点八除零点五
二百八十除十二等多少	二百八十除七等多少
三十乘十三	十三乘十三
五除二十四	二十四除五
二百九十乘四	三十六加九
手脚经常发抖是什么病	手脚偶尔发抖是什么病
二百五十乘三十	十除六十
五十点九六除六点五	十六点五除五
十二加二等几	十二加十二等几
经常的反义词和经常的近义词	经常的近义词和经常的反义词
九百一十除十四	十四除七
一百零八乘二十五	四十七除四
小兔关掉手机电筒	小兔打开手机电筒
经常便血是什么情况	偶尔便血是什么情况
一百二十除四	六点八乘四
怎样保存手机数据	怎样删除手机数据
四十二乘三等多少	三点一四乘三十
三点六除零点零九	五乘一点五
五十六除七	十二点五六乘四
饭后胃疼是怎么回事	饭前胃疼是怎么回事
三十一除一百一十九	三十一除三
十五乘六等	十五乘十五等
血压一百四十六除七十二正常吗	血压一百三十六除七十二正常吗
手和脚发麻是什么原因	脚和手发麻是什么原因
二十四除十五	十五除二十四
一百三十乘十等	十五乘十等
怎么追一个比自己小的男生	怎么追一个比自己大的男生
三十五乘八	五百五十六减三百七十九
三点五乘二点四	二点五乘四
广州到珠海多少钱	珠海到广州多少钱
咸的意思	淡的意思
二百一十除七	二百一十除三十
冬虫夏草粗支价格	冬虫夏草细支价格
蛀牙轻微疼痛	蛀牙剧烈疼痛
商丘到民权汽车	民权到商丘汽车
二百四十除十二	十九乘五十等多少
六除十化成小数	五除十化成小数
二点五乘零点四	四乘二百五十
五十四除九等几	请问零除零等多少
睡觉老是手麻	睡觉偶尔手麻
她的爱好是画画和跳舞英语怎么说	她的爱好是跳舞和画画英语怎么说
三乘八	八乘三
佳木斯到青岛的火车	青岛到佳木斯的火车
九十六乘四	一百减七十二
十五除六	零点二五除四
七十八乘九	六点五除一点三
一百六十乘五十	一百六十乘八十
八十八乘一百二十五	五百乘六
四点一乘一百	四点一乘四点一
一乘二	四加八
心脏跳动慢怎么治疗	心脏跳动快怎么治疗
十五乘十八	十八乘十五
怎么设置前台运行	怎么设置后台运行
mg和pg哪个好	pg和mg哪个好
沈阳到庐山	庐山到沈阳
五十乘十七	十七乘十七
九乘四等多少	零点三六除零点六
什么克制格斗系	格斗系被什么克制
五百乘五	十二点五乘八等多少
零点二七除九	零点二七除零点零三
一百二十五除三十等几	一百二十五除六等几
五加五加五加五等几	五加五等几啊
七乘三	三乘七
零点零八乘零点两	零点一乘零点两
零点零五乘零点零四等多少	六乘零点零四等多少
十二和十七最小公倍数	十七和十二最小公倍数
六十四除三十二	六十四除三
五乘六	六乘五
二十七乘五	二十七乘十五
四百二十除六等多少	十减四等几
六点二八乘三	六点二八乘二十
五十一乘五十	四十一乘五十
小燕子什么时候从南方飞回北方	小燕子什么时候从北方飞回南方
二百五十一点二除三点一四	一点二乘五
五十七除三	五十七除十九
十五除二十最简分数	五除二十最简分数
四十五乘四十五	五十五乘五十五
七点零九除零点五二等多少	十三乘八等几
一百二十五乘八等多少	九十一除二
一百二十五乘七	八乘一百二十五
五乘十三	十三乘十三
亳州至宣城火车票	宣城至亳州火车票
三十乘四	二十加二十等多少
四十九乘二	五除十一
二百五十乘八十	十乘八等多少
一点五乘三	一点五乘五
四十五除七的竖式	十三除七的竖式
五十九乘六	六乘六乘六
十五除七化成小数	十一除七化成小数
二百除四十等多少	四十除二等多少
四点五乘三百零二等多少	四点五乘五十等多少
二百五十除二十五	四百五十除二十五
二十五乘三十六	二十五加三十六
中国的新冠患者比其他国家都少吗	其他国家新冠肺炎患者比我国都多吗
一百二十除十六	七加一等多少
十五乘三点一四	十五乘十五乘三点一四
五点一除零点五	五除零点一
七十八点六除十一	六除十一
二点五乘零点四	零点九四乘二点五
二百零八乘三	二百零八减一百二十九
经常干呕想吐是怎么回事	偶尔干呕想吐是怎么回事
五百四十除九十的竖式	五百四十除四十五的竖式
一百二十乘二十五怎算	一百二十除二十五怎列
抚州到金溪有多少公里	金溪到抚州有多少公里
三十七乘四	十五乘十五等多少
六百三十二除八竖式计算	六百三十四除八竖式计算
三点一四乘一百四十四等多少	八加八等
无足轻重的反义词	人命关天的反义词
雅安到永川有多少公里	永川到雅安有多少公里
四点五乘三百零二	四点五乘一百
十七加十九	十七加十三
一百四十乘五十	七十乘一百四十
比中国慢半个小时的国家	比中国快半个小时的国家
十七乘十七	十五乘十七
四点九除七	四除七
七十二乘九	七百五十除二
四十五除十五	十五除四十五
二百四十除六十等多少	二百四十除六等多少
三十乘十二怎算	十二乘三十二怎乘
三百六十乘二十五	三百六十乘二十
十二加五等多少	十二加十二等多少
南宁到湖州快递要多久	湖州到南宁快递要多久
胸小的原因	胸大的原因
成都到资阳拼车多少钱	资阳到成都拼车多少钱
九百加九百等几	九百除三等几
为什么男生的头比女生的大	为什么女人的头比男的小
七十七除四等多少	七除四等多少
一百六十除四等多少	七减八等几
二百七十除三等多少	四百乘三
王者最高冷却	王者最低冷却
二十五除二	十万加十万等多少
十六减四等几	零除零等多少
九除四等几分之几	九除十二等几分之几
八十八除六的竖式怎么列	八十八除五的竖式怎么列
晚上喝酸奶会胖吗	晚上喝酸奶会瘦吗
益阳到深圳火车	深圳到益阳火车
四点三十九乘十	十五乘十
天蝎座女和双鱼座男配吗	双鱼座女和天蝎座男配吗
偶尔便血是怎么回事	老是便血是怎么回事
把歌曲关闭	把歌曲打开
舌厚是什么原因	舌薄是什么原因
四十二乘二	四十二乘六
一百二十五乘十二	六十八乘六
昆明到广南顺风车	广南到昆明顺风车
心跳过快是什么病	心跳过慢是什么病
紫外线几点到几点最弱	紫外线几点到几点最强
吃槟榔有什么好处和坏处	吃槟榔有什么坏处和好处
一百加一百加一百	三点一四乘一点二
三十九乘七	三点一四乘三十九
三百八十乘二	四百五十乘二
九加十等几	九加十四等几
十六乘五等几	零加一等多少
什么是弱周期	什么是强周期
男生见到暗恋女生反应	女生见到暗恋男生反应
一百六十除四十八等多少	七除四十八等多少
拉肚子会瘦吗	拉肚子会胖吗
六乘十吧	十乘六
二百五十除五	五除五等几
九十二除三	九十二除四
三十二乘十二的验算怎么写	二十四乘十二的验算怎么写
一百一十四除二	五点九八除零点二三
十六除十	十六除二十四
三个水是什么字	三个火是什么字
三十四除六	零点四乘八
一百零五除三	一乘零等多少
白财神心咒的功德利益	黑财神心咒的功德利益
卵巢囊肿和巧克力囊肿的区别	巧克力囊肿和卵巢囊肿的区别
七十五除三	一点五乘六
新县到许昌有多少公里	许昌到新县有多少公里
三千七百除二十五除四简便运算	三千七百除二十五除四简便计算
一百六十加一百六十	一百八十加一百八十
睡觉老是做梦是什么原因	睡觉偶尔做梦是什么原因
潍坊到洛阳高铁时刻表查询	洛阳到潍坊高铁时刻表查询
三分之一加五分之两	四分之一加五分之两
巨蟹座和天蝎座配吗	天蝎座和巨蟹座配吗
节奏慢的英语	节奏快的英语
胃疼经常打嗝怎么回事	胃疼偶尔打嗝怎么回事
富平至西安多少公里	西安至富平多少公里
一百二十乘三	六十乘一百二十
三十二除十六	十六乘三十二
枸杞能和茶一起泡吗	茶能和枸杞一起泡吗
九点八乘十五等多少	九点八乘一千等多少
五十四除六等多少	九加五等多少
八除十五加一除六等几分之几	八除十二加一除六等几分之几
往往和常常有什么区别	常常和往往有什么区别
八除零点四	零点四除零点八
怎么用手机和电脑共享网络	怎么用电脑和手机共享网络
一百五十除十	十一乘五十
河南师范大学招美术生吗	河北师范大学招美术生吗
十六除十	十八除十
一减七除十二等几	一减十除十二等几
矛盾的同一性和斗争性	矛盾的斗争性和同一性
十三点七十八减零点七十八加零点五简便运算	十三点七十八减零点七十八加零点五简便计算
二十四除二等多少	五乘六等几
四百八十除八	六百四十除八
二十五乘五	二乘六等几
赤壁到洪湖班车	洪湖到赤壁班车
可爱用英语怎么说	可恨用英语怎么说
三百五十除一千等多少	三百五十除二十五等多少
二乘几等六	二乘几等十四
一除零等多少	一除十一等多少
三百乘五	四百乘五
二百一十除七等多少	一除三
二百四十五除三估算	二百四十五除八估算
四十八除二	四十八除二点三
攸县到衡阳高铁站	衡阳高铁站到攸县
婴儿身高矮	婴儿身高高
太康到郑州多少公里	郑州到太康多少公里
零乘零等多少	零点六除四
二百一十除十等多少	七除十等多少
二十二除四	六点二八乘四
饭后跑步好吗	饭前跑步好吗
二点七乘四	二点五乘四
绍兴和杭州距离多远	杭州和绍兴距离多远
瑞安到台州	台州到瑞安
阳历七月初九是什么星座	阴历七月初九是什么星座
荆州到南通	南通到荆州
一百九十六除七	六除零点二
七百六十除八的竖式怎么写	七百六十除七的竖式怎么写
描写男生的穿着	描写女生的穿着
二百零五乘三	七十二除三等多少
三除十的通分	四除十的通分
四百乘三	四除二点五
一除两除三减两除三除	一除一除三减一除三除
审核凭证相关说法错误的是	审核凭证相关说法正确的是
邓超和孙丽离婚了吗	孙丽和邓超离婚了吗
四十七乘七十九	四十七乘八
二十四乘二等几	十五除十五
内存大好玩的游戏	内存小好玩的游戏
一百三十乘四	零乘零
小孩急性肺炎严重吗	小孩慢性肺炎严重吗
小红书怎么复制长链接	小红书怎么复制短链接
形容柔软的	形容坚硬的
一百八十八除二	二百四十八除二
十乘十乘八当几	十十乘八等多少
轻薄的成语	稳重的成语
三十六乘一点一四	三点四乘三十六等多少
北京到九华山	九华山到北京
二十四除六的带分数	七除六的带分数
三点一四乘八	八乘三点一四
一百减五十怎么算	一百减五十等几百
六十四乘三点一四等略	六十四乘三点三等几
二十七乘九	二十七除九
轻五笔怎么打	重五笔怎么打
十五乘五等多少	十五乘十五等多少
八分之三乘三分之一	八分之三乘八分之一
二里面有几个一除六	三里面有几个一除六
经常牙龈肿痛是什么原因	偶尔牙龈肿痛是什么原因
四十五乘八	四十五乘六
健儿消食口服液和健胃消食口服液的区别	健胃消食口服液和健儿消食口服液的区别
厦门北站到高崎机场t四	高崎机场t四到厦门北站
反复发烧是什么原因	偶尔发烧是什么原因
一百除二等多少	一百除十五等多少
妈妈一定比儿子矮吗	儿子一定比妈妈高吗
四千加四千等多少	一千加四千加四千等多少
toonboom怎么导入图片	toonboom怎么导出图片
十二乘二十八	十二乘十七
三十六乘八	四十九除四
手背血管细是什么原因	手背血管粗是什么原因
一百三十二除八等	二十除八等
十三乘八十五	十三乘三十三
三除六怎么约分	八除六怎么约分
二点五乘二点五	二点五乘五
三百五十除五等几	九点六除零点四
四点五除零点九	四百加四百等多少
六十六点六除一点八	一点六除八
十六加几等二十五	十三加几等二十五
三除七等多少	一百除七等多少
四除七等多少小数	一除七等多少小数
三除七等多少	三除三十等多少
四十九点二除四点一	十七除二等多少
心率过慢怎么调节	心率过快怎么调节
张无忌和张三丰谁厉害	张三丰和张无忌谁厉害
你和谁结婚了	谁和你结婚了
浑浊的拼音怎么拼写	清澈的拼音怎么拼写
五百四十六除七等多少	五除七等多少
血压一百四十六除七十二正常吗	血压九十除七十二正常吗
便秘有什么好办法	腹泻有什么好办法
二十五乘三十六	三十六乘二十五
涉县到林州多少公里	林州到涉县多少公里
七点二除零点零八	五点六除零点零八
六点五乘零点四	四乘零点五
结肠腺瘤低级别	结肠腺瘤高级别
急性肝炎症状	慢性肝炎症状
西瓜和梨可以一起吃吗	梨和西瓜可以一起吃吗
路虎被谁收购了	谁收购了路虎
三分之一加二分之一	三分之一加二分之五
麦当劳和肯德基那个早	肯德基和麦当劳那个早
五点二五除零点二五	四点五除零点二五
义乌至武义	武义至义乌
四百二十除六等多少	九乘九等几
九点六除四	六点四除四
十四乘五十	零点七百五十六除零点一八
月经完第二天是安全期吗	月经完第二天是危险期吗
二十二乘三	四加七等多少
形容枪法差的词语	形容枪法好的词语
十九乘三	十九乘十九
六除六是什么星座	三除三是什么星座
一点二五乘零点八	八乘一点二五
盐城到潍坊高铁时刻表	潍坊到盐城高铁时刻表
四十九乘七	九百乘六
芒果和牛奶能一起吃吗	牛奶和芒果能一起吃吗
血压一百三十除一百正常吗	血压九十除一百正常吗
二百五十乘四	七十二除二十四
三百二十五除十三等多少	三百二十五除五等多少
二百七十除五	十七乘三十
十三乘三	十三除三
三乘十八等多少	五乘三等多少
怎么关闭word安全模式	怎么打开word安全模式
十五乘十五	十五乘四十
三点一四乘十六对	十六点一四乘十六
一百二十八加一百二十八等几	十加十等几
呼兰到天津火车时刻表	天津到呼兰火车时刻表
一百五十除二十五	四百五十除二十五
银川和西宁哪个繁华	西宁和银川哪个繁华
八十三乘五十五	八十三乘零
赞美老师的名言和诗句	赞美老师的诗句和名言
八十乘五	六乘七等几
女人幼稚的表现	女人成熟的表现
属鸡和属蛇的配吗	属蛇和属鸡的配吗
脖子短的动物有哪些	脖子长的动物有哪些
荥阳去郑州怎么坐车	郑州去荥阳怎么坐车
五百四十除二十	五百四十除五
走路会让腿变粗吗	走路会让腿变细吗
三乘二	二乘三
哈士奇大的多少钱	哈士奇小的多少钱
快速排序最坏时间复杂度	快速排序最好时间复杂度
二十七除四	二十七除四点五
大乐透六加两中零加两多少钱奖金	大乐透六加两中三加两多少钱奖金
五百五十除六的竖式	一除六的竖式
怎么区分湿疹和痱子	怎么区分痱子和湿疹
六百四十八乘六	十乘六
雌性激素高是怎么回事	雌性激素低是怎么回事
五十七乘五	五乘五乘五
十二点五乘六	零除一百等几
四加二十八等几	四加一百等几
六百二十五除二十五等多少	六百二十五除二十五等小
六百三十除七等多少	七乘八等几
九十除七	九十除九
八百四十除二	三十加三十
十七加十九	十七加十二
七十除十五	八点四除零点二
缝纫机不吃厚	缝纫机不吃薄
六除三	三除六
五十二除三	五十二除十三
二百四十倍二百四十乘十五	二百四十乘五等多少
北方人比南方人长寿吗	南方人比北方人长寿吗
晚上吃苹果会胖吗	晚上吃苹果会瘦吗
二百四十六点四除十三	三十六乘八
三点八乘十六	一百六十乘十六
五分之四除十	五分之四除十二
五百二十六除七等多少	四除七等多少
小橘猫多少钱	大橘猫多少钱
颈椎和腰椎不好怎么办	腰椎和颈椎不好怎么办
七十除二	七点二除一点六
二十五乘六十四	八十五乘六十四
一百二十乘七十三的简便方法	一百二十除七十三等多少
沣河森林公园到咸阳火车站	咸阳火车站到沣河森林公园
吃冰激凌会胖吗	吃冰激凌会瘦吗
一百五十乘六十五等多少	五乘六十五等多少
五百五十除六的竖式	五除六的竖式
三百七十乘四十的竖式	四乘四十的竖式
六百除二十	六百除五
三点0七十二除六点四	三点六除四
指甲长到肉里怎么办	肉长到指甲里怎么办
尿少是什么原因	尿多是什么原因
零点三百七十五除三除八等多少	一除三除八等多少
四十一乘二	五点零一减一点九
济南到西安火车	西安到济南火车
荔枝皮是干垃圾吗	荔枝皮是湿垃圾吗
二十五乘一百二十五	二十九乘四
二十一乘二十八怎么算	二十八乘二十一等几乘几
三除五	九百除四
二百五十乘三等多少	二百五十乘四十等多少
一点五乘八	一点八乘五
六百零三除六约	六百零二除六约
五十三乘十七	十六乘十七
六十六除六等多少	五乘一等几
十六乘一千二百五十	十六乘十九
例假来之前胸部胀痛	例假来之后胸部胀痛
大乐透十二加五复式多少钱	大乐透十加五复式多少钱
一百二十三乘三十二	四十乘三十二
三乘几等十八	十八除三等几
四十五除五	八除五
什么什么无事	什么什么有事
扁钢和扁铁的区别	扁铁和扁钢的区别
三乘八百等多少	三乘二十五等多少
七十五除十二	七十五除四
三点八乘十六	三点八乘六
微信转账到银行卡要手续费吗	银行卡转账到微信要手续费吗
七乘十七	八乘一点五
一个月瘦了五斤正常吗	一个月胖了五斤正常吗
九十九乘九十九	四百除五等
五千乘五千等多少	八乘八等多少
三百三十六除三	十三减五分之三
四十八乘三十的竖式计算	四十八乘四十九的竖式计算
三十六乘四等多少	四乘八等
指甲软是什么原因	指甲硬是什么原因
十七乘三十八的竖式	十七乘十三的竖式
九加几等十七	九加十七等几
一点二五除零点五	一点五除零点二五
长沙到延安多少公里	延安到长沙多少公里
二百九十四除十四	二百九十四除二十八
三百乘九	三百加三百
三十五除五读作	三除五读作
二十三除四等几	四乘二十三怎算的
安徽到广西快递多少钱	广西到安徽快递多少钱
七除五十六	七除二十
八十三乘五十五	八十三乘八十
二十乘五十	五十乘二十
笔画少的二字词语	笔画多的二字词语
第一个残的成语	第一个全的成语
晚什么结构	早什么结构
四百二十乘三	二点七除零点九
形容说话很多的四字词语	形容说话很少的四字词语
大繁体字	小繁体字
四百四十八除四	二点四除零点零四
三十一点四除三点一四	一点八乘二
四百五十九除三等多少	零除三等多少
三乘十三	十二点四除二
二十五乘四十对等几	四乘二十五等多少
蓝牙耳机太大了怎么办	蓝牙耳机太小了怎么办
山竹可以和榴莲一起吃吗	榴莲可以和山竹一起吃吗
梦见蛇被别人打死了	梦见别人把蛇打死了
八减十四怎么过	十四减八怎么过
求阴影部分的周长和面积	求阴影部分的面积和周长
驶的拼音和组词怎么写	驶的组词和拼音怎么写
北京比上海gdp高吗	上海比北京gdp低吗
三点0七十二除六点四	四点八乘零点九
四乘零点二	零点四乘二点四
六百除三竖式	六百除七竖式
三十九乘四十一	四十三乘四十一
血压一百三十除一百正常吗	血压一百三十一除一百正常吗
五十八除两x十六的竖式	五十八除九的竖式
七十除八	十六除八
铁力到沈阳的火车时刻表	沈阳到铁力的火车时刻表
六乘五等小	六乘五等多少
六百四十二除八≈	六百三十七除八≈
三十二除八怎算	三十二除八等多多少少
八乘四	十七乘二
三十加三十	四十加四十
二十五除二十五	二十五除五
五除八化成百分数	一除八化成百分数
六除多少等四	四除多少等六
二十乘一点五	五乘一点五
重庆到广西高铁多少钱	广西到重庆高铁多少钱
宝妈断奶后会瘦吗	宝妈断奶后会胖吗
四点八乘零点三十五的竖式	四点八乘一点两的竖式
三十八乘五十怎么列竖式	三十八乘四十怎么列竖式
一百三十八除六	一百四十四除六
十八乘四	四乘十八
一点二五乘零点八	零点二五乘八
七十六除二	八点四除零点四
重庆到西安火车票	西安到重庆火车票
二百一十乘三十	二百一十乘五
清原到梅河口火车	梅河口到清原火车
西峰到崇信汽车时刻表	崇信到西峰汽车时刻表
二百五十乘八	四除三十七
三十二乘三	三十二乘八
十四加十四等几	十四除二等几
总蛋白高说明什么	总蛋白低说明什么
二氧化硫和二氧化氮的反应	二氧化氮和二氧化硫的反应
二乘四	四乘二
月经多怎么办	月经少怎么办
五乘八	十三除五
低脂肪高碳水	低脂肪低碳水
学硕可以调剂到专硕吗	专硕可以调剂到学硕吗
五十一乘五十	五十一乘零
爷爷一定比奶奶身体好吗	奶奶一定比爷爷身体差吗
一百四十乘十二	零点五乘零点二
经常打嗝怎么办	偶尔打嗝怎么办
十除零点二五	十除零点五
黄瓜有什么功效和作用	黄瓜有什么作用和功效
四百零六除七十八	一百减七十二等多少
童话故事是假的吗	童话故事是真的吗
九乘十八	六百除六十
六十六乘三	六十六除三
血压一百三十除一百正常吗	血压一百六十除一百正常吗
三加三等几啊	五加五等几啊
五乘九等多少	零点六四除四
零除五十五	五十五除零
巴中到万州火车时刻表	万州到巴中火车时刻表
六十乘二十五	零点七五除五
三百加五百等多少	四十乘三
五百二十除五的竖式怎么列	二百一十除五的竖式怎么列
七点五乘四	四点五乘五
三十二加二十	二十加二十
你会说广东话吗	你会说广西话吗
食材嫩玉米窍门	食材老玉米窍门
乳胶和凝胶床垫哪个好	凝胶和乳胶床垫哪个好
什么水果脂肪低	什么水果脂肪高
生病会胖吗	生病会瘦吗
上海顺丰到深圳多少钱	深圳顺丰到上海多少钱
两百乘两百	十六乘二等多少
一百七十除二	三点八四除零点八
三十四乘三	十五乘八
二千八百除十二	十七乘八等多少
乌鲁木齐到张家口的火车时刻表	张家口到乌鲁木齐的火车时刻表
六十八乘六除三	四乘六除三
五十一乘八十七	八十八乘八十七
平罗到榆林多少公里	榆林到平罗多少公里
九十除六等多少	八乘二点五
五乘一点五	十三点五乘一点五百七十五
二加二十等几	二十加二十等几
江苏的排名比浙江高吗	浙江的排名比江苏低吗
六乘十	八乘十
r十一乘五	r十一乘四十
四十除六十等多少	四十除三等多少
五百四十六除七等多少	二十除七等多少
一点五除三十	六十乘三
血小板低怎样治疗	血小板高怎样治疗
本溪到敦化高铁时刻表	敦化到本溪高铁时刻表
为什么怀孕肚子那么大	为什么怀孕肚子那么小
病毒感冒和风寒感冒的区别	风寒感冒和病毒感冒的区别
眼睛小和什么有关	眼睛大和什么有关
一百四十四除八	一百四十四除十八
四除十五加一除十五	九除十五加一除十五
九十一点二除三点八	一百乘六
新生儿老是吐奶怎么回事	新生儿偶尔吐奶怎么回事
十五除七化成小数是多少	十五除七化成小数是加多少
cad填充三百乘六百地砖	cad填充三百乘三百地砖
七十二除十五	七十二除十六
白萝卜可以和芝麻一起吃吗	芝麻可以和白萝卜一起吃吗
舌头发白口苦是什么原因	舌头发黑口苦是什么原因
美食小广场	美食大广场
小儿导赤片和小儿七星茶的区别	小儿七星茶和小儿导赤片的区别
三百一十二除十三等多少	三百一十二除六等多少
巴南到沙坪坝	沙坪坝到巴南
十二十乘十八等多少	十八乘十二怎算
r十一除七	一点四除零点七
十七乘四相当十七	十七除四等多少
异分母分数加减算理	同分母分数加减算理
十八乘二十是什么	八十二乘十八等几
三十二乘四十	六十九乘七
四百五十除九等多少	十六乘三等几
七十二乘一百零一减七十二用简便方法计算	六十二乘一百零一减六十二用简便方法计算
七十除五	七十除十
一百五十七除二	一千除一百五十七
微信怎么关掉通讯录	微信怎么开通讯录
三十八乘九	一乘三等几
八十四乘三	九点六除一点五
老是发烧怎么回事	偶尔发烧怎么回事
形容高兴的词语有哪一些	形容悲伤的词语有哪一些
一百八十除九	二点五除二
胎儿大四周怎么办	胎儿小四周怎么办
一百二十八除八等多少	一除八等多少
十二除一点五	十二除二点五
一点六乘四	四除十
梦到清澈的水里有鱼	梦到浑浊的水里有鱼
重庆到金城江	金城江到重庆
女性反复尿频是怎么回事	女性偶尔尿频是怎么回事
一百三十二除六	一百三十二除十二
三千六百除二十五乘四	一除二十五乘四
一百二十五除二十五	二十四乘十八
橄榄核上色快	橄榄核上色慢
鸡蛋和牛奶能一起吃吗	牛奶和鸡蛋能一起吃吗
二十四乘十	三加一等多少
老是吐痰是怎么回事	偶尔吐痰是怎么回事
一百乘二百	二百加二百
单纯甲状腺素高	单纯甲状腺素低
河北到德州多少公里	德州到河北多少公里
十四加七等多少	十四加十四等几
三点一四乘五	五乘三点一四
心脏跳的慢是怎么回事	心脏跳的快是怎么回事
一百零二点五除零点五	十四乘三等多少
二十乘七等多少	二十乘二十等多少
十七除三等多少	四除三等多少
一百一十加一百一十等几	六除三
阳历两．二十号是什么星座	阴历两．二十号是什么星座
镇江到南京禄口机场大巴	南京禄口机场到镇江大巴
朝阳离天安门远吗	朝阳离天安门近吗
皮炎和湿疹的区别是什么	湿疹和皮炎的区别是什么
五除四十五	五除十二
十二减六加五	十二减六加七
闻喜到临汾高铁时刻表	临汾到闻喜高铁时刻表
咸鸭蛋腌得太淡了怎么办	咸鸭蛋腌得太咸了怎么办
r十一乘九	九乘九乘九
二百六十除四	二百六十除五
泗水到兖州火车	兖州到泗水火车
三点十四乘七点八	三点十四乘五
大理到昆明过路费多少钱	昆明到大理过路费多少钱
广阔的反义词是什么	狭窄的反义词是什么
霍邱到安庆多少公里	安庆到霍邱多少公里
剑与远征二十二减十一怎么过	剑与远征二十二减四十六怎么过
二十二乘二十	七百二十除九十
牛肉可不可以和海带一起煮	海带可不可以和牛肉一起煮
四十五乘九	四十五乘二十
武汉至石首商务车电话	石首至武汉商务车电话
一点二十五乘八	七十乘四十
深圳去广州有多远	广州去深圳有多远
关闭微信后台	打开微信后台
零点四八除六	零点四八除四
五除八	八点五除五
四十九乘七	四十九除七
广州到上海自驾游攻略	上海到广州自驾游攻略
三乘七	四乘七
二乘五等几	十二乘三十二
六又一除四的平方根	六十一除四的平方根
三万乘三万等多少	三乘三等多少
三乘十八等多少	十八乘十八等多少
九除九百六十三的商是多少	九除九的商是多少
六除五等多少	六除十二等多少
九除四	四除九
十五乘三十	十五乘十三
六乘七等多少	十二除零点七五
三十六乘十一	三乘九等多少
三点一四乘九等多少	三点一四乘九当多少
四十除六十等多少	四十除零等多少
密集反义词	零星反义词
九百除一点五	九百除五百
经常耳鸣是什么原因	偶尔耳鸣是什么原因
六除五	六除七
什么英雄克制司马懿	司马懿被什么英雄克制
纽约飞中国机票	中国飞纽约机票
小风炮加什么油	大风炮加什么油
大姨妈后几天是安全期	大姨妈后几天是危险期
一百加二百	二百加二百
宝鸡到云南多少公里	云南到宝鸡多少公里
一百二十乘三	十二乘十八
四十五减三十五	三十五减四十五
五十点二四除四	零点二四除零点四
三点一四乘九	九乘三点一四
三十六乘十五	十五乘三十六
移动和联通哪个信号好	联通和移动哪个信号好
五乘十三埒几	十三乘五怎样算
新陈代谢慢是什么原因	新陈代谢快是什么原因
五十乘二	五十乘五十
七分之四除三	七分之四除六
六点四除一点六	零点六四除一点六
四十二乘十九约等多少	四十二乘三约等多少
宿迁至上海高铁时刻表	上海至宿迁高铁时刻表
河北中医院科室列表	河南中医院科室列表
十一乘四十	四十乘四十
六十乘九	四百加四百等几
福州到芒市	芒市到福州
中国和西班牙的关系	西班牙和中国的关系
一除零点二	一除零点零二
小孩子晚上哭闹是怎么回事	小孩子早上哭闹是怎么回事
早上起来嘴苦怎么回事	早上起来嘴甜怎么回事
眼皮太厚怎么办	眼皮太薄怎么办
伟大同义词是什么	平凡同义词是什么
商洛到城南客运站	城南客运站到商洛
四百八十除八	那二加二呢
四十五乘四十五	四十五乘零点八
十六加几等二十五	九加几等二十五
一百乘三十二怎么列竖式	十二乘三十二怎么列竖式
六百三十除七十	七十除十四
一点八除六	一点六除八
今天最低气温多少度	今天最高气温多少度
什么是急性肝炎	什么是慢性肝炎
六百除小等二十五	六百除二十五等几
三点一四乘九等几	九乘三点四加九乘四点三
二十五乘八十	二十五乘十六
适合女生唱的高音歌曲	适合女生唱的低音歌曲
哥哥一定比妹妹年纪大吗	妹妹一定比哥哥年纪小吗
身体热脚凉怎么回事	身体冷脚凉怎么回事
一点五除九点九	九除一点五
隧道最高限速	隧道最低限速
一百除十五	十五乘八等多少
三十六乘三十六乘三十六等几	三十六乘十二的简便方
二十除四十	四十除二十
四十五乘六等多少	一点二五乘八十
一百六十九除十三	三十九乘八
一百除五	十九加十四
怀孕胸部会变大吗	怀孕胸部会变小吗
二十三乘二十三	二十三乘六十
二百五十乘三十	三百二十乘三十
低级别恶性程度高吗	高级别恶性程度高吗
美团比饿了么便宜吗	饿了么比美团贵吗
三十三乘三	三十三乘三十
女生最少的专业	女生最多的专业
八乘二等多少	十二除二十
九千九百九十九乘九十九等多少	八乘九十九等多少
九点五除五	十四乘七
血压高怎么办	血压低怎么办
小布一万加一万	小布一千加一千
一除八的通分	六除八的通分
二百八十乘七	十五乘五十六
聪明的英文单词怎么读	愚蠢的英文单词怎么读
牛奶和桔子可以一起吃吗	桔子和牛奶可以一起吃吗
三百六十除十五哪边计算	三百六十除十五等多少
美金最高汇率	美金最低汇率
青岛大学和武大哪个好	武大和青岛大学哪个好
浙江到广州需要隔离吗	广州到浙江需要隔离吗
榆中到兰州的车最早几点	兰州到榆中的车最早几点
二十五乘四十	二分之一减二等多少
四十三乘五十二竖式计算	四十三乘三十八竖式计算
血压九十除五十正常吗	血压一百三十除五十正常吗
一除二	二除一
八除三分之一	八除八分之一
九百除八等几	六除八等几
心跳快憋得慌	心跳慢憋得慌
血小板高是什么原因	血小板低是什么原因
借贷利息最高多少	借贷利息最低多少
贵阳观山湖区公立小学有哪些	贵阳观山湖区私立小学有哪些
十七乘三十八的竖式	十七乘二十七的竖式
焦距越大越好吗	焦距越小越好吗
oppowatch关机	oppowatch开机
五百三十二除七的竖式怎么列	五百三十三除七的竖式怎么列
梦见小女孩输液	梦见小男孩输液
你能帮我找个女朋友吗	你能帮我找个男朋友吗
四十九乘十三	十一乘十三
属于深感觉检查的是	属于浅感觉检查的是
三十三乘三	三点一四乘三十三
近视最高度数	近视最低度数
遵义到保定火车票	保定到遵义火车票
五乘十二	十二点五乘四
一百三十二除二	一百三十二除六
幸福爱人和加油爱人有什么区别	加油爱人和幸福爱人有什么区别
一点八乘五	八乘一点五
八点五乘一千等多少	八点五乘六等多少
一点四除七	一点四除零点七
逍遥丸能和消乳散结胶囊一起吃吗	消乳散结胶囊能和逍遥丸一起吃吗
世界上最穷的国家是什么国家	世界上最富的国家是什么国家
六十五乘三	一点五乘六十
二十四乘二十四	五百零六乘二十四
带有异字的成语有哪些	带有同字的成语有哪些
舌头发白怎么办	舌头发黑怎么办
太原到大同汽车多少钱	大同到太原汽车多少钱
一加七是什么字	一加八是什么字
八乘零点二十五等多少	八乘六等多少
风女和亚索什么关系	亚索和风女什么关系
四除七除两等几分之几	六除七除两等几分之几
胃溃疡和十二指肠溃疡的区别	十二指肠溃疡和胃溃疡的区别
二百一十六除六	三点一四乘十一
湿疹和热疹的区别	热疹和湿疹的区别
鸭腿鸡腿哪个贵	鸭腿鸡腿哪个便宜
五加八等多少	四十乘十
小型打谷机价格	大型打谷机价格
好看的女孩子名字	好看的男孩子名字
七点八除二点六	六百除四
七乘十五	十五乘七
商丘到廊坊的火车票	廊坊到商丘的火车票
一周瘦五斤正常吗	一周胖五斤正常吗
三点四乘九相等多少	三点四乘九等几
二十四除三	二十四除九
风寒感冒和风热感冒的区别	风热感冒和风寒感冒的区别
三十九乘四十一	三十九乘十九
a型血和o型血生的孩子是什么血型	o型血和a型血生的孩子是什么血型
九十六减七等几	五减七等几
黑河到嫩江市多少公里	嫩江市到黑河多少公里
四十五乘三	四十五乘二
全身疲惫是什么原因	全身亢奋是什么原因
三点六除零点九	六点三除零点九
威少最高得分	威少最低得分
fecl三和ki反应方程式	ki和fecl三反应方程式
李治廷和范冰冰什么关系	范冰冰和李治廷什么关系
两百除五	两百除四
婴儿指甲发白怎么回事	婴儿指甲发黑怎么回事
二十五乘二等几乘几	二十五乘二怎么算
千岛酱和沙拉酱热量	沙拉酱和千岛酱热量
一百零五除三	一百零五除五
零点六乘一点三	零点六乘三
十一乘十二	十九加十九
月经前一天是安全期吗	月经后一天是安全期吗
七除五十六	七除一
安阳到偃师	偃师到安阳
商业用地和工业用地价格差多少	工业用地和商业用地价格差多少
马克思和恩格斯是哪国人	恩格斯和马克思是哪国人
五百五十乘三十	一乘三十
张俊才和科森身高吧	科森和张俊才身高吧
r十一乘九	r十一乘五
一百三十乘十等	五乘十等
四点五乘三百零二等多少	四点五乘十八等多少
长城站的纬度位置	长城站的经度位置
扬州机场到仪征大巴	仪征到扬州机场大巴
一点四乘三点两	一点四乘十八
最便宜洗衣机	最贵洗衣机
十五乘四百	四百加四百
小孩经常咳嗽	小孩偶尔咳嗽
六百四十除四等多少	三除四等多少
多乐士避孕套厚吗	多乐士避孕套薄吗
大便颜色发黑	大便颜色发亮
珠海怎么去深圳	深圳怎么去珠海
八十五乘二	八十五除二
十加十六等几	十加六等几
二百乘一百五十乘六的方管一米多少多重	二百乘二百乘六的方管一米多少多重
九十除六十	二乘十四
零点八百六十四除零点二七等多少	零点二七除三
怀孕初期热正常吗	怀孕初期冷正常吗
九十九除七	九十九除五
六十四乘八	六十四除八
二百四十除三的竖式计算怎么写	二百四十三除三的竖式计算怎么写
五十一除三等多少	四点五除零点三
轻微痔疮怎么办	严重痔疮怎么办
福州到秦皇岛多少公里	秦皇岛到福州多少公里
爷爷和孙子的关系叫什么	孙子和爷爷的关系叫什么
八十五点五除三点三	七十乘五
中国最好的大学	中国最坏的大学
心跳过快什么原因引起的	心跳过慢什么原因引起的
六百五十除五十	七除五
皮肤经常过敏怎么办	皮肤偶尔过敏怎么办
六百一十九除五等多少	六除五等多少
七百二十除六当多少	七百二十除六等几
十二点二十五除六点二	十五点六除十二点四等多少
我能把你喊出来吗	你会被我喊出来吗
夸张句的例子夸小	夸张句的例子夸大
脸上长小疙瘩怎么办	脸上长大疙瘩怎么办
三十六除四等多少	十六加十六等几
一点二五乘四	零点四乘一点二五
七除四减三除八等几分之几	七除四减一除八等几分之几
一百二十四除四	十八加十五
什么是高碘食物有哪些	什么是低碘食物有哪些
小型货车使用年限是多少年	大型货车使用年限是多少年
南京到唐山的火车票	唐山到南京的火车票
八除十一	十二点一除十一
宁波到信阳火车	信阳到宁波火车
一百一十一除零点三等多少	一万六千加一万六千
五十除十	五十除五
八百一十七除九约等多少	十一除九约等多少
ofree四加六十四多少钱	六乘八等多少
三十九乘二	零点三五除五
七十五乘一百零二	七十五乘十
七十九乘三	十乘三
什么东西含糖低	什么东西含糖高
一百五十乘八	一百五十乘十二
小布三加三	小布三加五
十一个一乘十一个一等多少	十一乘十一等多少
九百减七百三十五	九百减七百
七除七	零除零
二十二乘二十	八十五除十七
西部证券是大券商吗	西部证券是小券商吗
三乘十五等多多少少	十五乘三等几
三乘七等几	八点七除三
一百乘一百等几	八加十二
血压一百三十除一百正常吗	血压一百二十除一百正常吗
二十一除三	六十四乘二
一百二十乘二	一百二十除二
孕囊八乘八mm	孕囊五乘五mm
五百五十除六的竖式	八除六的竖式
甘油三酯高怎么办	甘油三酯低怎么办
四分之三乘五	四分之三乘一百
五百五十乘三十	零乘三十
迈巴赫被奔驰收购了吗	奔驰把迈巴赫收购了吗
一百五十除六	六十除二点五
宝宝风热感冒和风寒感冒的区别	宝宝风寒感冒和风热感冒的区别
三百乘六	六百乘三
美伢和小新的关系	小新和美伢的关系
床单六乘七是多大尺寸	床单五乘七是多大尺寸
二十五乘三十等多少	五百四十除十二
零点四乘五	零点四乘零点五
五十五乘五十五	五十五乘七
背部部位名称	腹部部位名称
二加六	六加二
四除五乘五除四	五除五乘五除五
三十六乘十一	十一乘十一
二十三乘五十等多少	二十三乘四等多少
成都伊莱克斯空调售后网点四百减一百一十六减六千二百一十九	成都美的空调售后网点四百减一百一十六减六千二百一十九
临颍到郑州火车	郑州到临颍火车
一又三除七等多少小数	三又一除七等多少小数
重庆到呼和浩特火车时刻表	呼和浩特到重庆火车时刻表
你实在是没有什么法子能帮到我	我实在是没有什么法子能帮到你
雌二醇低怎么办	雌二醇高怎么办
八百四十除六十	九百六十除六十
十五乘九等多少	十五乘十五等多少
消化不良容易胖吗	消化不良容易瘦吗
零除九等多少	零除十等多少
年龄小腰疼	年龄大腰疼
六和二十四的最小公倍数	二十四和六的最小公倍数
六十二点八除三点一四除二	十四乘十四等多少
瓦房店到菏泽火车时刻表	菏泽到瓦房店火车时刻表
二十四减六	二十四除六
你难道不可以直接被我叫出来吗	我可以直接把你叫出来吗
包粽子的简单步骤	包粽子的详细步骤
二十二除二	五十乘十二
世界上最小的国家是哪个国家	世界上最大的国家是哪个国家
身份证年龄怎么改小	身份证年龄怎么改大
八十二乘五	八十二除二
九十一除三	九十五乘三
新都桥到雅安多少公里	雅安到新都桥多少公里
二十二乘二十二	二十二加二十二
被蚊子咬了起疙瘩	被蚊子咬了不起疙瘩
四点八乘一点两等几	六十乘一点两等几
二分之一减三分之二	三分之二减二分之一
肚子太大怎么办	肚子太小怎么办
三乘五	五乘三
十五乘一除四	十乘一除四
上环后月经量少怎么办	上环后月经量多怎么办
九百零七除四的竖式	十除四的竖式
心率过慢的危害	心率过快的危害
五乘四	四乘五
二十六乘四除三十九	二十六乘两除三十九
女人梦见玉米和西瓜	女人梦见西瓜和玉米
八乘十吧	十乘八
三十二乘二十四乘几	三十二乘二十四怎么算
难什么成语大全	易什么成语大全
三点五乘五点四	三点五乘三点五
二十三乘三等多少	三十乘十二
三点五除七	八乘八等多少
甘油三酯高说明什么	甘油三酯低说明什么
从铜仁到贵阳	从贵阳到铜仁
四十七点一除二	四十七除二
三除十	十点五除三
二十九乘三十五	二十五乘三十五
八十五除一百	八十五除二
孑然一身反义词是什么	形单影只反义词是什么
杭州和天津哪个发达	天津和杭州哪个发达
四十六乘十三	三十四乘十三
崇州市到成都火车站怎么坐车	成都火车站到崇州市怎么坐车
二十五乘十二	二十五乘二十五
四除五是什么拍子	八除五是什么拍子
九百除八等几	九百除十等几
二百二十四乘三十	二点五乘二点五等多少
晚上喝酸奶会瘦吗	晚上喝酸奶会胖吗
香蕉和酸奶可以一起吃吗	酸奶和香蕉可以一起吃吗
杞人忧天的出处和意思	杞人忧天的意思和出处
二十四乘二十	九十六除八
十二除四	零点四乘零点三
产后恶露少是怎么回事	产后恶露多是怎么回事
十七加十九等几	十七加九等几
胆固醇高的症状	胆固醇低的症状
脚底麻木是什么原因	脚底敏感是什么原因
火星情报局薛之谦把沈梦辰唱哭是哪一期	火星情报局沈梦辰被薛之谦唱哭是哪一期
台前到莘县的客车时刻表	莘县到台前的客车时刻表
二十四乘三点一四等不怎么	二十四乘三点四等多少
二十五x四加八的简便计算	二十五x八加四的简便计算
今天最低气温	今天最高气温
数学乘法结合律和分配律	数学乘法分配律和结合律
漂亮的的英文单词怎么写	丑陋的的英文单词怎么写
五十五乘二十七	五十五乘二十二
舌苔发白怎么办	舌苔发黑怎么办
四十乘六	十乘六
二十五乘二十五等多少	六除十一
避孕药对身体有害吗	避孕药对身体有益吗
形容很冷清的四字成语	形容很热闹的四字成语
太原到上海飞机航线图	上海到太原飞机航线图
四十点五除零点五	四点五除零点五
二百七十除十五等多少	七点二乘零点四
小肚子大是怎么回事	小肚子小是怎么回事
四十二除二	四十二除五
六百除八竖式计算	六十除八竖式计算
安徽警官职业学院女生多吗	安徽警官职业学院女生少吗
老是打嗝怎么办	偶尔打嗝怎么办
注册小公司流程及费用	注册大公司流程及费用
花甲和豆腐能一起吃吗	豆腐和花甲能一起吃吗
十加二十等多少	十加十等多少
孕妇血糖低怎么回事	孕妇血糖高怎么回事
四十五加十九等几	四十五加八等几
昆山到成都的高铁	成都到昆山的高铁
严重颈椎病怎么办	轻微颈椎病怎么办
三十二点五除二点五	三百除五十
邢台到济南汽车时刻表查询	济南到邢台汽车时刻表查询
四十乘六等	一乘六等
三十二除零点八	一点七乘零点五
十八乘九十	十八乘十八
南航就业方向	北航就业方向
九百三十六除十二	三乘九
十五除八	四加四呢
十五乘四	十五乘三
枣庄到黄山高铁时刻表	黄山到枣庄高铁时刻表
三十六乘三十	三十六乘四十
三点二除二点五	三除零点二五
二十三乘五十	二十三乘十
六百一十二除五列竖式计算	六百一十二除七竖式计算
手机外放音量大	手机外放音量小
二百五十乘四	二百五十除四
一百五十乘五十	三十二减八
关于热的诗句	关于冷的诗句
一千除二十八等几	一千除一等几
二十六乘十二乘略略	十二乘二十六等几
卵泡二十四乘二十三	卵泡二十四乘十九
一百四十四除三点六	五零除零等多少
二除零点五	零点二除零点五
一百零二乘十九简便计算	二十五乘十九简便计算
禁忌五除美国禁忌五	禁忌六除美国禁忌六
梦见雨水把路淹了	梦见路被雨水淹了
三分之二除七分之四	七分之四除三分之二
四点八乘一点两	二百乘一点两
孩子老是挤眼睛怎么办	孩子偶尔挤眼睛怎么办
一点二除零点五	零点二除零点五
我的世界中冒险和生存有什么区别	我的世界中生存和冒险有什么区别
八除四	四点八除四
十八乘二十七	十八乘十九
七十二乘三	七十二乘二
三点一四乘十八	零点九乘零点三
四除四	七点八除三
三百六十除十五	一百除五等几
三十乘十三	十三乘三十
反复发烧是怎么回事	偶尔发烧是怎么回事
人流后月经量多	人流后月经量小
一万加一	五除二十
三十五乘五	三十五除五
咸奶油蛋糕热量	淡奶油蛋糕热量
八十乘八十	八十乘四十
七除三分之一	七除九分之一
三十二乘零点二十五乘一点二十五简便运算	零点二十五乘三十二乘一点二十五简便运算
七十二除四	四乘十三
十八乘九十等几	十八乘九等几
心率慢怎么回事	心率快怎么回事
一百五十乘三十	一百六十五除五
阳历六月份出生的是什么星座	阴历六月份出生的是什么星座
十七减九	十七减八
广东公务员一年考几次	广西公务员一年考几次
葫芦岛至天津的火车票	天津至葫芦岛的火车票
七十五除十	七十五除一百五十
为什么要对政府权力进行监督和制约	为什么要对政府权力进行制约和监督
老师被人们比喻成什么	人们把老师比喻成什么
九百五十六除四的竖式	九百五十六除九的竖式
十五乘二等多少	十五乘十五等多少
长沙到株洲汽车时刻表查询	株洲到长沙汽车时刻表查询
形容人聪明的英语	形容人愚蠢的英语
六十乘六	六十乘十二
六十四乘八	六十四乘四
一万乘一万等几	三点一四乘二十四
三百六十五乘零点六	三百六十五乘四
四十八乘二十	五百除一百二十五
二十五乘二十五的竖式是什么	十三乘十三的竖式是什么
二百乘四	五乘一点二
一百乘一百	三百乘三百
左脚麻木是什么原因	左脚敏感是什么原因
三乘十五等多少	十五乘十五等多少
大的什么填词语	小的什么填词语
月经特别少	月经特别多
一百二十五除四十八的简便计算	四十八除一百二十五的简便计算
二十乘十七	十七乘二十
二乘六	六乘二
二十六乘六	三点一四乘零点二五
四百除五	四百除八
八加一等多少	四点五乘一点二
越大越好的东西	越小越好的东西
四十五乘二	四十五乘四
电脑字体怎么调粗	电脑字体怎么调细
今日山东卫视节目单	今日山西卫视节目单
沈阳到扬州飞机票	扬州到沈阳飞机票
七十八乘六等	七十八乘多少等六
芹菜和大蒜能一起炒吗	大蒜和芹菜能一起炒吗
零点四五除九	零点四五除零点九
三点五乘四	四点五乘五
孕期铁蛋白低是怎么回事	孕期铁蛋白高是怎么回事
十二乘十四	十四乘十二
三十乘十四	十二乘三十二
八点一乘一除九	五乘一除九
笔记本怎么分辨独立显卡和集成显卡	笔记本怎么分辨集成显卡和独立显卡
八十三乘五十五	七十乘五十五
八除三等几	小布一千加一千等多少
心跳过快是怎么回事	心跳过慢是怎么回事
但是有点瘦英语	但是有点胖英语
二十八乘一百	二十八乘二十二
哪个星座最聪明	哪个星座最愚蠢
移动和联通哪个好	联通和移动哪个好
七十除八等多少	九除八等多少
三点八乘四	零点七二除零点零六
一百八十除四十五	四百零五除四十五
九十六除三	九十六除四
十五除三十二等多少	三除三十二等多少
四十二乘三十	一百加一
六十除六等多少	六除一
四除十七等多少	十一除十七等多少
海拔越高温差越大	海拔越高温差越小
林志玲和言承旭为什么分手	言承旭和林志玲为什么分手
二百一十除七怎算	二百一十除七等多少
五加一	五加九
你真的不会离开我吗	我真的不会离开你吗
二百三十六除八等多少	二百三十六除四十等多少
三点一四除三点一四	五十点二四除三点一四
二百二十除四	六十四乘三
一点五乘四	一点四乘五
二十五加二十五	五十六乘十五
胆解脂酶高	胆解脂酶低
一百二十五乘四等多少	八十四除七
七十二乘一千	七十二乘一百零二
关掉手机淘宝	开手机淘宝
记忆力差怎么办	记忆力好怎么办
孩子越吃越胖怎么办	孩子越吃越瘦怎么办
四十四加四十四加四十四加四十五加四十四的简便算法	四十四加四十四等多少
苏州火车站到平江路	平江路到苏州火车站
发烧血小板低怎么回事	发烧血小板高怎么回事
北京到郑州的飞机票多少钱	郑州到北京的飞机票多少钱
南京比较好的美容医院	北京比较好的美容医院
二十二乘四	五点六除一点四
最便宜的网线	最贵的网线
二十四除六十	六十乘二十四
肖战和王一博很像的照片	王一博和肖战很像的照片
蒲公英泡水喝有什么功效和作用	蒲公英泡水喝有什么作用和功效
头发稀疏的原因	头发茂密的原因
为什么脸比脖子白	为什么脸比脖子黑
苏州的面积比南京大吗	南京的面积比苏州小吗
二十一乘三十四	二十一乘十
山东到贵州需要隔离吗	贵州到山东需要隔离吗
一点二除零点三	十五乘十六
长沙到杭州多少公里	杭州到长沙多少公里
三个月宝宝睡觉老是摇头怎么回事	三个月宝宝睡觉偶尔摇头怎么回事
血压一百四十六除七十二正常吗	血压一百四十五除七十二正常吗
二十四乘三点一四齐多少	二十四乘三点一四等
一百二十乘六十等	一百二十乘三十等
二百五十乘八	八点四除零点二
一百七十乘五	十六除二等多少
一百二十乘二十	一百二十乘六
八加八加八加八等几	八加八等多少
五十乘六等多少	五十乘一百等多少
郑州到苍溪多少公里	苍溪到郑州多少公里
一百五十六除四	二十七乘七
十二除四等多少	零点二乘零点二
零点二四除三	零点二四除四
三十二加九	十一加九
八点五除五	十八点九除五
三点一四乘六	六乘三点一四
七十和五十的公因数	五十和七十的公因数
三乘三乘三点一四怎么算	三乘四点二三
一百八十乘三十是稍微	一百八十乘三十等多少
世界上飞得最快的昆虫是什么	世界上飞得最慢的昆虫是什么
零点二五乘八	零点二五乘四
二十四除零点八	五百乘十
西安到洋县多少公里	洋县到西安多少公里
两分之五减两分之一	两分之一减两分之一
五十六乘四	七乘三点一四
三百除四十	一百除四十
一乘零等多少	小布零乘零等多少
贱换一个偏旁组词	贵换一个偏旁组词
√一除一百七十九等多少	√一除二十五等多少
深粉色代表什么	浅粉色代表什么
直接融资和间接融资的优缺点	间接融资和直接融资的优缺点
南阳到深圳的机票	深圳到南阳的机票
六除一点五等九分之几	一除一点五等九分之几
八十四除二	十三乘六
虾和鸡蛋能一起吃吗	鸡蛋和虾能一起吃吗
二十五除一百	一百除二十五
苍山到郯城多少公里	郯城到苍山多少公里
什么是有机化合物和有机化学	什么是有机化学和有机化合物
十九点六百二十五除二	十九除二
北京到庆阳	庆阳到北京
小孩子偶尔流鼻血是怎么回事	小孩子老是流鼻血是怎么回事
三十四乘七	十五乘二十一
形容舞台大	形容舞台小
七十五除二十	一千加一万
二十八乘一百	二十八乘十五
优秀学生和三好学生有什么区别	三好学生和优秀学生有什么区别
钙片和鱼肝油可以一起吃吗	鱼肝油和钙片可以一起吃吗
五十五乘三十八的竖式怎么列	五十五乘二十五的竖式怎么列
梦见别人买白衣服	梦见别人买黑衣服
五乘四等多少	五百乘四等多少
八分之三乘三分之一	八分之三乘三分之八
鼻子经常出血是什么原因	鼻子偶尔出血是什么原因
二百除五等多少	四十除二点四
三百九十除五	六十乘十八
双色球六加一多少钱	双色球三加一多少钱
一百二十五乘四当几	一百二十五乘四等价多少
一点八乘零点六	三点一四乘一点二
零点零一除零点一是多少	零点零一除零点一等多少等多少
零点二十六乘零点五	零点二十六乘二十四
十八减六等几	十八点二七除零点七
四十七除七	四十七除四
一百零五除二	一百零五除五
郑繁星和曹煜辰的关系	曹煜辰和郑繁星的关系
三点一四乘四除二	三点二除四
二十七除四	八十一除二十七
双色球十一加一中奖概率	双色球十加一中奖概率
长方形的面积和周长有什么规律	长方形的周长和面积有什么规律
九除四点五	四点五除九
五十乘零点八	零点八乘零点八
哈尔滨到双城的客车	双城到哈尔滨的客车
曼城和曼联谁厉害	曼联和曼城谁厉害
亮得什么填词语	黑得什么填词语
一万加一亿等多少	零点七除一点四
保定到邯郸高铁	邯郸到保定高铁
二点五乘八	八乘二点五
吃方便面会胖吗	吃方便面会瘦吗
二十除三十	二十除十二
一千加两百等几	一点零四除二
我可以直接把你叫出来吗	难道你不能被我直接叫出来吗
小腿和大腿连接处	大腿和小腿连接处
北京拖车到哈尔滨多少钱	哈尔滨拖车到北京多少钱
三除一	五百除三十
七点五乘二	三十加三十
四百五十九除三	四百五十九除四
怀化到重庆经过哪些站	重庆到怀化经过哪些站
遵化至唐山	唐山至遵化
六十四加十九	十四加六十四
甲亢吃药会胖吗	甲亢吃药会瘦吗
三十五除四十	三十五除二十五
五十除六除二十	五十除六等多少
十二乘三十六	十二乘二十四
大便干燥拉不出来怎么办	大便湿润拉不出来怎么办
反复发烧怎么回事	偶尔发烧怎么回事
宝宝老是干恶心怎么回事	宝宝偶尔干恶心怎么回事
咳白痰是怎么回事	咳黑痰是怎么回事
五十除四十	四十除五十
铁岭到沈阳多久	沈阳到铁岭多久
金寨到杭州火车时刻表	杭州到金寨火车时刻表
体彩大乐透九加四多少钱一注	体彩大乐透九加五多少钱一注
hcg低怎么办	hcg高怎么办
锡林浩特到上海飞机	上海到锡林浩特飞机
一百八十乘三	八除二等几
沙井新天虹在哪里	沙井旧天虹在哪里
三点八乘十六	一千二百八十乘十六
脚掌和脚面疼是怎么回事	脚掌和脚背疼是怎么回事
上海哪个地方最繁华	上海哪个地方最偏僻
谁是世界上最漂亮的人	谁是世界上最丑陋的人
九除九	十六乘六等几
四十二除二十一	零点七除零点四
一乘六	三乘四
七十除八等多少	七除八等多少
三十六减八等多少	零减八等多少
一百二十七乘十二	十五乘十二
四十五加十九等几	四十五加五等几
六除六是什么星座	七除七是什么星座
四十九乘三点三四	三点四乘四十九的竖式是啊
三点四除零点一七	十五除二十五
四千二百除二十五怎么简便计算	四千二百除二十五怎么简便运算
一百零四除二十六	一百零四除六十
五十六除三等多少	八十加六十四
零点五四除六	零点五四除零点六
早上醒来嘴巴苦	早上醒来嘴巴甜
经常头疼是什么问题	偶尔头疼是什么问题
十八乘二	十八乘十八
四十五除十五	零除二
甜芥菜怎么做好吃	苦芥菜怎么做好吃
一百除九十五	一百除十
身体代谢慢怎么办	身体代谢快怎么办
九十七年一月五日阳历	九十七年一月五日阴历
白蛋白高的症状有哪些	白蛋白低的症状有哪些
三十六乘十一	十五乘十一
中国哪里黑的最晚	中国哪里亮的最晚
七十除十四	十六乘一点五
二十八乘十五等	二十八乘十八等
三十八乘五	三十八乘八
三点十四乘零点零六百二十五	三点十四乘十一
很热的风怎么形容	很冷的风怎么形容
三乘几等十八	六乘三等几
一百四十乘七	一百四十乘二十
脚趾甲发白怎么回事	脚趾甲发黑怎么回事
一千减八等多少	五减八等多少
二十四乘二十五	二十五乘二十四
一百四十四减六十四等多少	三十乘二等多少
二十四除十八	十八除二十四
五除零点三六	零点三六除九
二十五除一千化成小数是多少	二十五除三十七化成小数是多少
月经前几天体温会升高吗	月经后几天体温会升高吗
一点二乘四点五	四除六等多少
尿频量少是什么原因	尿频量多是什么原因
二百零四乘五	三点六除二
三十三乘三	三十三乘二
一点六除零点八	四加四呢
杭州到九华山	九华山到杭州
十六除零点六四	零点六四除四
江阴客运站到无锡	无锡到江阴客运站
怎么区分细菌性感冒和病毒性感冒	怎么区分病毒性感冒和细菌性感冒
二十五除零点五	一百减六十二点五
三十五乘五	七百除十四
四十七除二	八乘一点五
一百除十八等多少	三加三等
沙盘模拟长期贷款什么时候还	沙盘模拟短期贷款什么时候还
如何把qq的钱转到微信上	如何把微信的钱转到qq上
九百除一百八十	四除四
八乘二十	四乘二点五等多少
五点二除十三	十三除五
一百六十除三十	一百六十除二十
经常拉肚子是什么原因	偶尔拉肚子是什么原因
四十二除十四等多少	十四除三等多少
二十乘二十七	二十乘八十
怎样区分热感冒和冷感冒	怎样区分冷感冒和热感冒
七除三分之一	七除十三
六百九十八除七约等多少	十二除七约等多少
武汉到哈尔滨要隔离吗	哈尔滨到武汉要隔离吗
三十二乘三等几	三乘几等十八
母猫发情会打滚吗	公猫发情会打滚吗
一百二十五加七十乘八简便运算	一百二十五加二十五乘八简便运算
十四除二点五	零点一五乘八
九十除八竖式	九十除五竖式
四十六乘八	九乘四等几
乌黑相反的词	雪白相反的词
什么血型最好	什么血型最差
如何正确理解政法机关首先是政治机关的本质和内涵	如何正确理解政法机关首先是政治机关的内涵和本质
孕三十九加四分泌物增多	孕四十加四分泌物增多
六乘五等几乘五乘五等六等几	六乘五等几
一百零八乘十二	一百零八除十二
七乘六	六乘七
五百零七除七的竖式计算	七除七的竖式计算
薄弱的词语	雄厚的词语
献血对身体有害吗	献血对身体有益吗
高碑店东到保定东	保定东到高碑店东
又厚又长的头发怎么扎	又厚又短的头发怎么扎
什么东西越吃越硬	什么东西越吃越软
五十五乘十二	五加一等多少
一百二十除十五	一百二十除十八
二十乘五十	十一乘三十
如何区分荣誉权和名誉权	如何区分名誉权和荣誉权
齐齐哈尔到牡丹江快递几天	牡丹江到齐齐哈尔快递几天
四十五乘七的竖式	四十五除七侔几
坏时光用英语怎么说	好时光用英语怎么说
不小心把电话号码给丢了怎么找回	请问手机号码被误删了怎么找回
宝鸡到兰州有多少公里	兰州到宝鸡有多少公里
通辽离长春	长春离通辽
一百五十除六十	十六除三等几
四十二除零点七	四十乘九
人胖胸小怎么选内衣	人胖胸大怎么选内衣
十五乘三	十五乘四
一点二五乘二点四	一点二五乘四
河南人为什么那么高	河南人为什么那么矮
一百二十除二十四等多少	一百二十除四等多少
一百二十五乘八十八	八十八乘八
下次世界杯冠军是哪个国家	上次世界杯冠军是哪个国家
迅速的组词是什么	缓慢的组词是什么
天水南站到秦安高铁时刻表	秦安到天水南站高铁时刻表
二十五乘八十	三十乘三
二十四除二十五	四十三乘七
三元减一元六角	三元减一元五角
二十五乘九除二十	十乘九除二十
眉眼距离宽怎么办	眉眼距离窄怎么办
四乘五等多少	四乘五等多多少少
善部首查字法	恶部首查字法
角的大小与什么无关与什么有关	角的大小与什么有关与什么有关
三十二除五十	三十二除十
息县到萧山大巴电话	萧山到息县大巴电话
女人和男人谁更容易忘记对方	男人和女人谁更容易忘记对方
一百二十八除八等多少	一千二百五十除五十等多少
湖南大学教育学研究生分数线	湖北大学教育学研究生分数线
猪肝能和西红柿一起吃吗	西红柿能和猪肝一起吃吗
鸡蛋能和猪肝一起吃吗	猪肝能和鸡蛋一起吃吗
武松被谁设计陷害	谁设计陷害武松
五十八乘二	五十八乘四
血小板低会不会是白血病	血小板高会不会是白血病
十二乘五等多少	十二乘十二等多少
攸县南站到广州东站	广州东站到攸县南站
十一乘十八的竖式怎么写	十一乘七十的竖式怎么写
久保田小型收割机多少钱一台	久保田大型收割机多少钱一台
四十八乘二十五	九点六除四
用蛮横造句	用和蔼造句
二十八点二十六乘三分之	二十八点二十六乘八
三百除四十等多少	八十除四十等多少
金鸡湖的面积比玄武湖大吗	玄武湖的面积比金鸡湖小吗
二十三乘五十等多少	十除三等几
二点五乘零点零八	四十乘三点一四
睡眠不足会血压高吗	睡眠不足会血压低吗
胸大怎么办	胸小怎么办
十八乘九等几	十八乘九等多多少少
六乘五	六点五乘五
ipadair内屏多少钱	ipadair外屏多少钱
好老师的特点	坏老师的特点
机械硬盘和固态硬盘哪个便宜	机械硬盘和固态硬盘哪个贵
三百六十除五	一乘五等多少
十五乘十怎么算	十五乘十五等
做梦梦到车被撞了	做梦梦到把车撞了
阿根廷牛肉和澳洲牛肉哪个好	澳洲牛肉和阿根廷牛肉哪个好
血压九十除六十正常吗	血压一百二十除六十正常吗
九除零点三	零点九除零点三
三十六乘三十八	三十三乘三十八
二十三乘三	二十三除三点三
六十二除五	六十二除三
零点三乘零点三	零点三乘零点五
二十二加三十三	二十二加二十二
二点八除零点二	十四乘十四
清宫后不用吃消炎药吗	清宫后必须吃消炎药吗
一百五十除二十五	十五乘十四
音响直流电和交流电的区别	音响交流电和直流电的区别
五十五乘十等多少	九乘十等多少
二十八乘一百	八十乘一百
孕后期胎儿偏小	孕后期胎儿偏大
三减减六	零减减六
一点二乘三点一四	二分之一乘三点一四
五乘三点一四等多少	八百乘五
很小用英语怎么读	很大用英语怎么读
三乘三加二	四点二乘三
姨妈只有两天量少	姨妈只有两天量多
一百乘五十	二百乘五十
密字行草书怎么写	疏字行草书怎么写
二十一乘二十四的竖式计算	三十乘二十四的竖式计算
新的拼音怎么写	旧的拼音怎么写
三百零六除三	一百除三
四十除八等	三除八等
一百五十八乘十二	一百五十八减六十
经常咳嗽有痰	偶尔咳嗽有痰
八十三乘五十五	八十三乘八
六百一十九除五	六百一十九除三
阳历和阴历的区别	阴历和阳历的区别
零点一百二十五除八等微	零点一百二十五除零点八埒几
直发和卷发哪个是显性基因	卷发和直发哪个是显性基因
三点一四乘十六相当几	三点一四乘六十二怎算
喝减肥咖啡会不会导致月经提前	喝减肥咖啡会不会导致月经推迟
邢台到泊头有多少公里	泊头到邢台有多少公里
八十五除二	四十乘三
四百九十五除六等多少	六除六等多少
一百六十除四十八等多少	一百六十除四等多少
十三减三等十	二加七
t值越大说明什么	t值越小说明什么
电脑和电磁炉哪个辐射大	电磁炉和电脑哪个辐射大
三百五十除五等多少	十八乘二
十一除七	零点四除五
八加七等几	四十乘七十五
一百九十二除二十四	十八乘十二
嘴巴苦是怎么了	嘴巴甜是怎么了
六十八乘八	零点三四乘五
十五乘十八	十八除十五
五十七乘七	五十七除三
牛奶和鸡蛋能一起吃吗	鸡蛋和牛奶能一起吃吗
二十四乘六十	六十乘二十四
永恒的近义词和反义词	永恒的反义词和近义词
旧电表怎么看度数	新电表怎么看度数
鹰潭到瑞金汽车时刻表	瑞金到鹰潭汽车时刻表
八百六十除八竖式计算	一除八竖式计算
乳头被宝宝咬破了怎么办	宝宝把乳头咬破了怎么办
二百零一乘八约	二百零一乘四约
二百八十除十二	二百六十除十二
零点一乘十	零点三乘十
陕西到郑州多少公里	郑州到陕西多少公里
胆红素高的原因	胆红素低的原因
五除五	五除六
三十六乘二等多少	四十五加四十五
二加九分之五	九加九分之五
小冰箱尺寸一般	大冰箱尺寸一般
河南大学声乐分数线	河北大学声乐分数线
白带少怎么回事	白带多怎么回事
豆腐和鸡蛋的家常做法	鸡蛋和豆腐的家常做法
三点一四乘四除二	三点二乘四
四十六乘八乘一百二十五的简便计算	二十五乘八乘一百二十五的简便计算
七十除三十五等	五除三十五等
六十乘三	六十乘十五
中国最大的淡水湖是哪个	中国最大的咸水湖是哪个
三千除六百等多少	一百除六百等多少
三乘一	九加九
粉刺和痤疮有什么区别	痤疮和粉刺有什么区别
九点零七减六点七等多少	八十乘一百二十
荆州离武汉有多远	武汉离荆州有多远
五十六乘四	十八加八
甘肃人口最多的市	甘肃人口最少的市
二十五乘九	三十除五
济南到成都高铁票	成都到济南高铁票
四百八十除九十六	四百八十除四
三十八乘五	两千加两千等多少
七除零点五	三点五除零点七
喝纯牛奶会胖吗	喝纯牛奶会瘦吗
六十九乘九十八	四百乘五等多少
七加两中六加一多少钱	九加两中六加一多少钱
一点五乘三	一除六
二十三除二十四	二十三除十八
七除三等多少	六点三除七等多少
六味地黄丸能和腰痛宁一起吃吗	腰痛宁能和六味地黄丸一起吃吗
贫血血压会低吗	贫血血压会高吗
五十乘二	十五乘二
三分之一加二分之一	三分之一加三分之一
关闭自动连点器	打开自动连点器
楷书和行书哪个先出现	行书和楷书哪个先出现
葫芦岛到建昌拼车	建昌到葫芦岛拼车
八分之五减八分之一	八分之五减三分之一
二十五乘二十五	二十五乘四十
九十六除二	九十八除二
二十五乘二十等多少	二十五乘五等多少
二十点八除四	四乘十八等多少
四点七十五乘九十九加四点七十五的简便运算怎么写	九十九乘九十九加九十九的简便运算怎么写
厨师工资低	厨师工资高
二百七十除十五怎算的	二百七十除十五等价几
八分之五减八分之一	八分之五减八分之三
四百五十乘三十怎样算	四百五十除三十怎么算
南阳到焦作的火车时刻表查询	焦作到南阳的火车时刻表查询
六百二十五除一百二十五	十三乘八等多少
轻型触探检测频率	重型触探检测频率
尿少尿黄是怎么回事	尿多尿黄是怎么回事
七十二乘一千	八百乘一千
四十五乘四十五	四十五乘三
四十五除零点九	六十三除七等多少
三千五百八十八除四	六十四乘九
五十六乘二十一的竖式怎么列	二十二乘二十一的竖式怎么列
西瓜和田螺可以一起吃吗	田螺和西瓜可以一起吃吗
河北距离广西多远	河北距离广东多远
柿子和香蕉能一起吃吗	香蕉和柿子能一起吃吗
九十一除七	十五减六
四十二乘七	三除五
四十五乘五	三除零点四
感觉嗓子有异物老是咳嗽	感觉嗓子有异物偶尔咳嗽
七除一千的最简分数	六百二十除一千的最简分数
一加一等五什么意思	一加一等四什么意思
二十五点二除六	十加二十等多少
史兰芽和李幼斌什么时候结婚的	李幼斌和史兰芽什么时候结婚的
形容富庶的诗词	形容贫穷的诗词
三千加三千等多少	六点三除零点零九
支付宝怎么转账到银行卡	银行卡怎么转账到支付宝
c语言一加到一百	c程序一加到一百
二加二等四	四点八除零点四等多少
北京去昆明需要隔离吗	昆明去北京需要隔离吗
下半身肥胖	下半身消瘦
零点二五乘三	零点二五乘十二
甲苯和溴水能反应吗	溴水和甲苯能反应吗
零点六乘零点三	零点六乘零点六
轻微食物中毒症状	严重食物中毒症状
让男人伤心的话	让男人高兴的话
化疗和放疗的区别	放疗和化疗的区别
没怀孕hcg低是什么原因	没怀孕hcg高是什么原因
吃瓜子会胖吗	吃瓜子会瘦吗
一点八乘一等多少	四乘一等多少
月经老是提前是什么原因	月经偶尔提前是什么原因
四十乘三十	三十乘四十
十八除二	零点六除零点四
美国独立战争之前的社会性质	美国独立战争之后的社会性质
三百除四十等多少	三百除五等多少
小米音响搜不到蓝牙	小米蓝牙搜不到音响
葡萄干的功效及作用	葡萄干的作用及功效
杨颖和黄晓明什么关系	黄晓明和杨颖什么关系
六百除二十	六百除四
头经常眩晕是怎么回事	头偶尔眩晕是怎么回事
四十六乘十三	九乘十三
商丘到无锡汽车票	无锡到商丘汽车票
十加五等多少	那九加九等几
分公司和子公司有什么区别	子公司和分公司有什么区别
三十二加二十等多少	九加二十等多少
八十七乘三	三乘三乘三点一四
鲁字的拼音和组词怎么写	鲁字的组词和拼音怎么写
六乘七等多少	零点零二乘零点五
零点五乘零点五	零点八乘零点五
月经少可以吃坤灵丸吗	月经多可以吃坤灵丸吗
泰安到黄山	黄山到泰安
交组词和拼音怎么写	交拼音和组词怎么写
一除八分之七	七点五乘零点四
八乘十五	十五乘八
七十一减十七	七十一减六十五
六十加六十	十一乘五十
八十加八十等几	八十除二等几
四十六乘二十三	四十六乘十二
七十八减十八	十减十八
一加七t拍照效果	一加八拍照效果
二十六除三	九千九百九十九减八千八百八十八
五百三十六除四的竖式	五百三十四除四的竖式
怎么样让照片模糊	怎么样让照片清晰
二百八十乘五十	二百八十乘十五
五乘三点八	四除三
天津人最少的地方	天津人最多的地方
重庆到海口机票价格查询	海口到重庆机票价格查询
一点六除零点二五	六除零点二五
达州距离遂宁多远	遂宁距离达州多远
山西离内蒙古远吗	山西离内蒙古近吗
五加几等十三怎么	七加几等十三怎么
三百二十除八十	三乘九等多少
一点二乘八	一点八乘二
四百八十除四十	三点一四乘九百
阳历七十三年一月九日是什么星座	阴历七十三年一月九日是什么星座
四十五除二	七除三等多少
五十一乘八十七	五十一乘二十一
十大唱功差的歌手	十大唱功好的歌手
一百二十乘五	三乘四十
一十一乘二十二	十二乘二十等多少
手机被锁死	锁死手机
四十五减三十等多少	一百二十减三十等多少
二十七乘二十七	二十七乘十五
三点一四乘零点七	零点一四乘零点三
一加六怎么换电池	一加三怎么换电池
十二乘七怎算	十二乘十七等几
五十乘五十	四乘五十
长乐机场到屏南多少公里	屏南到长乐机场多少公里
八减六	六减六
阳历十一月是什么星座	阴历十一月是什么星座
桂林离温州有多远	温州离桂林有多远
二百四十乘十五等多少	六万乘六万等多少
三十乘三十等多少	三十乘六等多少
十六加十六等几	十六除二等几
六十除八	六十除四
十五乘三等多少	十五乘十五等多少
荆州到岳阳多少公里	岳阳到荆州多少公里
二十四乘二	二十四除二
十二乘十三	十二乘十四
顺丰怎么快	顺丰怎么慢
四除十七	四除十六
四十九乘六十二	六十乘六十二
二点四乘二点五	五十乘二十五
两点三乘九	两点三乘一点五
一百二十五加五十乘八简便计算	一百二十五加二十五乘八简便计算
八十三减十九	十九减八十三
八十四除六等多少	零点九乘零点三
一百零一乘十一等多少	七乘十一等多少
偶尔便血是什么原因	老是便血是什么原因
十除六十等几分之几	十除二十等几分之几
一百除四十五等几分之几	一百除五等几分之几
白的颜色有哪些	黑的颜色有哪些
五十乘十二	十二乘十二
七十乘三点一四	三点一四乘三点一四
五百加一千五百等多少	五百加二百五十等多少
武汉至京山火车	京山至武汉火车
一点二五乘四	一点四乘一点四
十一点四除三	十二点四除四
长春到南通火车票	南通到长春火车票
六十五乘二十一	六十五乘五十
四除零点八	零点四除八
六除一点五	六除二点五
石家庄西广场到东广场怎么走	石家庄东广场到西广场怎么走
秦皇岛离石家庄有多少公里	石家庄离秦皇岛有多少公里
一百一十三点零四除二	一点零四除二
十五乘十三等	十五乘十二等
合肥到淮安汽车时刻表	淮安到合肥汽车时刻表
孕酮低怎么回事	孕酮高怎么回事
二十四点五七除七等多少	十二除零点四
双色球六加一多少钱	双色球五加一多少钱
小孩反复发烧	小孩偶尔发烧
七十二除十二等多少	十七乘二
丹霞山到韶关多少公里	韶关到丹霞山多少公里
崭新的近义词是	陈旧的近义词是
二十八乘四十	五十乘四
身体老是发麻	身体偶尔发麻
乳糖不耐受喝牛奶会瘦吗	乳糖不耐受喝牛奶会胖吗
九十三除四	三点一四乘七的平方
支付宝可以转账到信用卡吗	信用卡可以转账到支付宝吗
阿娇有多高	阿娇有多矮
六十五乘六十五	六十五乘三十
三十八乘五	三十八乘四
三十六x两除三等多少	五除三等多少
二千八百除十二	十二除十二
一百零二除十二	一百零二除四
血小板高是什么原因	血小板小是什么原因
奶水少回奶	奶水多回奶
零点一六除零点四	零点六除零点一六
十减一	十减十
花青素含量高的食物	花青素含量低的食物
郑州西站离荥阳有多远	荥阳离郑州西站有多远
八除九加一除九	一除九加一除九
三十六除二点五	七点五除零点一五
三点一四乘四十四	十八除五十
八点五十四乘十点一	十四乘十点一
三十二加三十二加三十二加三十二怎算	三十二加多少等三十二
九点六除八	六除九
二十四乘五十等多多少少	五十乘二十四怎样乘法
六十三乘八	一点五除九点九
杏和小龙虾能一起吃吗	小龙虾和杏能一起吃吗
高露和高圆圆什么关系	高圆圆和高露什么关系
南伞到云县有多少公里	云县到南伞有多少公里
四除十七等多少	四除八等多少
四十五除五等多少	四十五除十五等多少
一百四十四除二十四	一除一点二五
九百一十除十四等多少	十四除三等多少
怎么设置拼音和手写一起	怎么设置手写和拼音一起
六百加六百是稍加	六百加六百相等几百
月经量比较多	月经量比较小
字数最少的成语	字数最多的成语
德文和英文的区别	英文和德文的区别
二十五乘四十	四百零八乘二十五
三十乘八十等多少	三十八乘十八乘三十
二十五乘六十	六十乘二十五
一百二十五乘十六乘七的简便运算	一百二十五乘十六乘二十五的简便运算
三除八	十乘九
二十四乘四	十四乘三
二十四乘二十	十九乘五十
三百除六十	四乘零点二五
五乘四	四点五乘五
咳嗽有白痰怎么回事	咳嗽有黑痰怎么回事
十七乘四	十七除四
九百六十除七	一百除七
牛黄解毒片和银翘解毒片能一起吃吗	银翘解毒片和牛黄解毒片能一起吃吗
成都到林芝的飞机	林芝到成都的飞机
九点一二除三点八	十二加十二
小布九加九等几	那九加九等几
诸暨到景德镇高铁时刻表	景德镇到诸暨高铁时刻表
六十八除三列竖式	十除三列竖式
三百六十除九等几	一亿乘一等几
三百二十除八的竖式	三百二十除八等多少
五十除十	六除十
六十四除三	一百加二十等几
河北高考五百分难吗	河南高考五百分难吗
二百五十乘五	三百二十除八
三十五乘三十五	六十加六十
零加九等多少	十六加九等多少
苏打水坏处	苏打水好处
两千除五	五点五除五
四百八十乘二十	四百八十除二十
酒的度数低	酒的度数高
一点二六除二十八	四百除五等
四十二除十等	六除十等
二十四除六十	六十减二十四
小型地基打桩机多少钱一台	大型地基打桩机多少钱一台
减肥可以吃油和盐吗	减肥可以吃盐和油吗
一百零五乘七	四乘七
三十二除四等几	三十二除四等些许
十九乘三百	十五乘四百
一百九十八除二	二十四点六四除十三
双色球七加三中零加一多少钱	双色球七加三中五加一多少钱
四十八乘七	十乘四十
四百一十七除三的竖式计算	九除三的竖式计算
七十除五	七百除五
有机材料和无机材料的区别	无机材料和有机材料的区别
五十一点三除零点二七	零点二七除三
对头孢和青霉素都过敏	对青霉素和头孢都过敏
西瓜能和奶一起吃吗	奶能和西瓜一起吃吗
老虎和狮子谁厉害	狮子和老虎谁厉害
三十二乘十五乘多少	十五乘三十二等几
老是干呕想吐是怎么回事	偶尔干呕想吐是怎么回事
乌鲁木齐离塔城多远	塔城离乌鲁木齐多远
十乘四十	四十乘四十
马虎反义词是什么标准答案	认真反义词是什么标准答案
一百三十乘四	十九乘九
脚趾麻木怎么办	脚趾敏感怎么办
一点二乘四点五	五除十一等多少
怎么区分胃炎和肠炎	怎么区分肠炎和胃炎
三十六乘十五对等多少	十五乘三十六侔几
宜春到金溪多少公里	金溪到宜春多少公里
一百三十五除五	六十二乘三
四百四十四x十九减二百二十二x十八简便计算	四百四十四x十九减二百二十二x十八简便运算
二十五乘二	六百除四
轻微脑震荡怎么治疗	严重脑震荡怎么治疗
四十四乘五十六的竖式	三十四乘五十六的竖式
一百零八除六	二十乘四等多少
六十二乘三	六十二除三
一百六十除二	一百六十二除二
一百八十除九等多少	三十三乘三
人为什么会胖	人为什么会瘦
血压一百零五减七十五	血压一百三十减七十五
六十四乘九	六十四乘六
十二乘十二等多少	十二乘四等多少
三点一四乘十六	十六乘三点一四
亮度亮一点	亮度暗一点
一加五尺寸	一加三尺寸
形容女生个子矮的词语	形容女生个子高的词语
十六乘一千二百五十	十六乘六
一百八十乘三	一百八十乘四
心跳过快吃什么药	心跳过慢吃什么药
怀孕初期老是肚子疼怎么回事	怀孕初期偶尔肚子疼怎么回事
yep和yes的区别	yes和yep的区别
基金风险比股票小吗	基金风险比股票高吗
七百八十除三十	十二加十二等几
怎么折大皇冠	怎么折小皇冠
三十七乘四	七十七除七
三十六点八乘一千	三百乘一千
小布一百乘一百	小布一百加一百
一百二十除四等几	三点二加零点一二
奶粉和母乳间隔多久吃	母乳和奶粉间隔多久吃
四减十八什么星座	四减四什么星座
八十六乘三	八十六除三
血小板低怎么回事	血小板高怎么回事
如何关闭儿童空间	如何打开儿童空间
五十乘六等多少	五十乘十五等多少
电脑上怎么输入错号	电脑上怎么输入对号
含钾较低的食物有哪些	含钾较高的食物有哪些
七十乘二	五点七除三
二十二除六	一点八除一点五
表达忧郁的句子	表达畅快的句子
五除三百等多少	二百除三百等多少
excel复制文字到word	word复制文字到excel
一点二乘零点六	零点二乘六
经常咳嗽怎么办	偶尔咳嗽怎么办
一百除四	六百乘八
西北政法大学是不是九百八十五	西南政法大学是不是九百八十五
二乘四等几	四乘二等几乘几
三点一四乘二点四	二点四乘三点一四
一点二乘零点八	一点二加零点八
一加五重量	一加八重量
上海到米兰飞机	米兰到上海飞机
一除零等多少	一除五十等多少
生蚝和鸭蛋能一起吃吗	鸭蛋和生蚝能一起吃吗
三除七加三除七	六除七加六除七
十除六十	零点六乘一百
八百四十五除六十五	八百四十五除十三
十五乘十六等多少	十六乘三等多少
哥哥一定比弟弟高吗	弟弟一定比哥哥矮吗
金昌到新沂火车时刻表	新沂到金昌火车时刻表
二十八除四	一百点四八除三点一四
一百八十乘四十	一百八十乘一百二十五
二乘六等多少	六乘十五等多少
吉林到内蒙古有多远	内蒙古到吉林有多远
二百乘四	八百乘四
谢娜比张杰大几岁	张杰比谢娜小几岁
五除十二乘九等多少	五除十二乘十六等多少
经常肚子疼是怎么回事	偶尔肚子疼是怎么回事
三十六乘五	三加三呢
世界上脖子最细的人	世界上脖子最粗的人
六十四除四等几	一点五乘七
二十五乘六	二十五乘八
二百六十乘三十等多少	八百除二
南京到淮安的汽车时刻表	淮安到南京的汽车时刻表
四百五十除九等多少	五十一乘八
七加二等几	三点二减零点八
二千八百除十二	三点六除四
二十一乘二十四的竖式计算	二十三乘二十四的竖式计算
刘德华比张学友的年龄大几岁	张学友比刘德华岁数小多少
四乘三点一四	四乘四乘三点一四
把字体变大	把字体变小
六和十三的最小公倍数是	十三和六的最小公倍数是
嘴苦怎么回事	嘴甜怎么回事
男生比女生要勇敢吗	女的比男的要胆小吗
十加十六	十加二十一
四点五除零点一五	零点一五除五
小傻逼的英语	大傻逼的英语
太原到涉县的客车	涉县到太原的客车
三点六乘三	三点六乘六
厕所被纸巾堵了怎么办	纸巾把厕所堵了怎么办
二百五十六除二	二十乘一点五
六乘五	四除二
二十五点十二乘一百二十	二十五点十二乘十六
六点九除零点五四	零点五四除六
七点二除零点九等多少	二除九等多少
三十五乘十四	六十四除二
长兴至商丘火车时刻表	商丘至长兴火车时刻表
三点二乘五	五点一除一点七
一百三十四除六十七	六十七除二
宝宝老是摇头	宝宝偶尔摇头
蒲城到西安有多少公里	西安到蒲城有多少公里
二点四乘五	四乘二点五
关关闭手机	打开关闭手机
一加八的尺寸	一加五的尺寸
一点六十八乘五	一点六十八乘十二
马云和李嘉诚谁更有钱	李嘉诚和马云谁更有钱
宗旨和目的的区别	目的和宗旨的区别
四分之三乘五	四分之三乘九
上海到重庆火车票	重庆到上海火车票
一点四乘零点五	二点四乘零点五
三点五乘四点四乘三点五乘四点一乘一些一	四乘三点二四乘四点三四
三十乘五等几	三十乘十五等多少
十乘八	十乘十
三十一乘五	三十一点四乘二
三减减六	三减减三
怎样怀孕几率大	怎样怀孕几率低
狗肉可以和西瓜一起吃吗	西瓜可以和狗肉一起吃吗
三点六四除二点六	六点六四除三点三
六十四除八	二十乘四
指甲变厚分层是怎么回事	指甲变薄分层是怎么回事
手机白号是什么意思	手机黑号是什么意思
八减八等几	十四减八等几
整齐用英文怎么说	凌乱用英文怎么说
睢宁到贾汪的车次查询	贾汪到睢宁的车次查询
五十六乘三	四天加四天
四十七乘五	二乘八等多少
五十三乘十七等多少	五十三乘一百等多少
保温灯价格及图片	保温灯图片及价格
济南到济宁高速费多少	济宁到济南高速费多少
一百五十除五十	六除二点四
五十一乘五十	五十一乘三十一
十二生肖最聪明的动物是什么	十二生肖最愚蠢的动物是什么
四百五十乘三十	四百五十除三十
十三乘三	十三乘十三
零点三乘零点三	五乘一
五百四十除九	五百四十除九十
四乘二百八十等多少	四乘二十等多少
十二除三除些许	十二除三等几
五点两乘十六	五点两乘十二
十四乘十四等多少	一百乘一百等多少
七十二乘三点十四等多少	一乘三点十四等多少
三乘八百等多少	三乘十一等多少
五十七除三等多少	四点七除三点一四
二百五十乘四十等多少	八乘八等多少
二百一十乘四十	二百三十乘四十
二十一乘四	七百除十四
快手说说短句子热门	快手说说长句子热门
r十一乘七	r十一乘九
五加五等几	五加几等五
白带有点绿是什么原因	白带有点红是什么原因
六里桥地铁站到长阳地铁站	长阳地铁站到六里桥地铁站
怎么才能长胖	怎么才能长瘦
北京到安康机票	安康到北京机票
嘴老是苦的是怎么回事	嘴老是甜的是怎么回事
八十一除九	八十一除二
二十五乘三十二加四	二十五乘五加四
十七乘四等多少	零点四二除七
六乘十	六乘十一
零点二十六乘零点五	一乘零点五
人流后月经很少怎么办	人流后月经很多怎么办
有期限的时装可以合成吗	有期限的时装可以分解吗
七十九乘二	十二乘一百
女人比男人大四岁好吗	男人比女人大四岁好吗
五百四十除五	五百四十除六
三十除十二	十二乘三十
跑步机和椭圆机哪个更减肥	椭圆机和跑步机哪个更减肥
鼻子经常出血怎么办	鼻子偶尔出血怎么办
二十四乘九	三十二除零点八
七加三	七加八
九十年两月七日是什么星座阳历	九十年两月七日是什么星座阴历
六十一减十五等多少	六减十五等多少
扬州到镇江汽渡多少钱	镇江到扬州汽渡多少钱
一百乘二百	二百乘二百
唐山到沈阳北火车时刻表	沈阳到唐山北火车时刻表
七十二乘一千	七十二乘一百二十
六百四十乘二	六百四十除二
五十一乘八十七	八十乘八十七
二十乘八十	四乘八十
别克所有车型报价及图片	别克所有车型图片及报价
五百五十除六的竖式	一百八十六除六的竖式
七减五分之三	一减五分之三
达州到贵阳飞机	贵阳到达州飞机
山东师范大学历史系分数线	山西师范大学历史系分数线
三点一四乘八乘八	三点一四乘八等
血压九十五减一百三十六	血压九十减一百三十六
脚泡白了怎么办	脚泡黑了怎么办
十加十六	十加二十四
一百一十九除三	四十二除二等多少
俊俏怎么拼	丑陋怎么拼
一百减五十	一百减十五
一千六百乘三	一千六百乘一千六百
二十九乘二	五十六乘十五
腋下温度比口腔高	腋下温度比口腔低
四十八乘三十	一点二五除八
九百一十除十四除小	九百一十除十四等多多少少
肛周脓肿算大手术吗	肛周脓肿算小手术吗
以难开头的诗句	以易开头的诗句
一百二十八乘三	一百二十八乘二
八减三	八减四
二十乘四十的竖式计算	二十乘四的竖式计算
二十六乘二十六	零点二五乘一百
五加七等多少	八十加八等几
碧蓝航线五减四有什么船	碧蓝航线四减四有什么船
什么菜油少	什么菜油多
你在和谁通话	谁在和你通话
十八除四点五	十四除三点五
二百四十除三	四十七乘三
南方哪里最热	南方哪里最冷
二十五除一百	十二除四等几
十六乘一千二百五十	十六乘九
八乘零点二十五等多少	八乘七十六等多少
一百除七	五除七
一千加百分之十怎么算	一加百分之十怎么算
老是打嗝是什么原因	偶尔打嗝是什么原因
一点五乘四	十六除二十五
甲亢会月经提前吗	甲亢会月经推迟吗
花都到赣州火车时刻表	赣州到花都火车时刻表
一百除零等多少	一百除十一等多少
一百二十四乘三十二	一百二十四乘二
三乘九	九乘九
十二点二除零点八	三十六减九
六十四除六	七十六乘五
不被蚊子叮咬的原因	被蚊子叮咬的原因
十三除六十的最简分数	五十除六十的最简分数
一百六十除三十	七百四十五减六百七十九
晚上吃橘子会胖吗	晚上吃橘子会瘦吗
凑十法九加八	凑十法九加六
经常吃健胃消食片好吗	偶尔吃健胃消食片好吗
一百八十加一百八十减三十五怎么减	一百八十减三十五减三十五加三十五等些许
一点五乘四	六百除十
一百二十除二十四	十三乘六等多少
高钾心脏骤停	低钾心脏骤停
三百乘四十	四点八除零点一六
信用卡能转账到支付宝吗	支付宝能转账到信用卡吗
科威特穷吗	科威特富吗
愚蠢的动物指什么生肖	聪明的动物指什么生肖
五十二乘三十的竖式计算怎么写	三十乘三十的竖式计算怎么写
玻尿酸和脂肪填充哪个好	脂肪和玻尿酸填充哪个好
十五乘三点一四	十八乘三点一四
三十一除一百一十九	三十一除三十五
四百八十加三十等多少	六十加三十等多少
南京大学的排名比浙大高吗	浙大的排名比南京大学低吗
吃活血化瘀的药会瘦吗	吃活血化瘀的药会胖吗
八十乘七十	五十乘七十
一百三十乘五十	零点九除零点五
铜氨丝和莫代尔的区别	莫代尔和铜氨丝的区别
如何把照片像素调高	如何把照片像素调小
四点零点一四除一些二二	零点一二除零点四等多少
九十六除六等多少	四点八乘三点五
三点九除十三	十三除三
八十八除四等几	一百减五十五等多少
对我们有益的英语怎么写	对我们有害的英语怎么写
六十八除八	六十八除十七
五乘十二加五乘多少等多少	十二乘五等多少
树叶少怎么形容	树叶多怎么形容
接的拼音和组词怎么写的	接的组词和拼音怎么写的
八十乘四十	四十乘八十
三百六十乘二十五	四十七乘四
四十八乘二	四十八乘五
肠胃蠕动慢怎么办	肠胃蠕动快怎么办
郑州火车站到新密大巴	新密到郑州火车站大巴
一点七乘零点五	五十乘二十四
十乘二十五	二十除十五
大乐透最高中多少	大乐透最低中多少
舌苔白怎么回事	舌苔黑怎么回事
二十二乘二十二	四十五除九等多少
八乘十吧	十五乘十吧
杭州林内售后电话四百减一百一十八减一千零八十一	重庆林内售后电话四百减一百一十八减一千零八十一
六百四十加六百四十等几	七十五乘八
长方体和正方体的体积	正方体和长方体的体积
一百四十乘二十	一百四十除二十
二百四十除三的竖式计算怎么写	二百四十除五的竖式计算怎么写
三十二乘十五当几	十五乘三十二的简便易行计算
三乘六	六乘三
二十四乘二	二十七乘三十
内蒙古的大小是不是比新疆大	新疆的大小是不是比内蒙古小
一千乘一千	一千除一千
十二分之七除二十一	十二分之七除十二
r十一除二	九点六除三
为什么男生比女生有趣	为什么女生比男生无聊
一百除九十五	一百除四十
九百减七百三十五等几	一减七百三十五等几
世界上工资最高的人	世界上工资最低的人
一百加两百等多少	百加一百等多少
七十乘四十	零点八乘七
三十乘一百八十	零点四八除四
三点六除四	十八加五
八十加八十的数	八十加八十等多少
西安至重庆机票价格	重庆至西安机票价格
七十乘十二	五十乘七十
杨子和黄圣依什么关系	黄圣依和杨子什么关系
小米到华为一键换机	华为到小米一键换机
五除十二乘六十	五除十二乘一
六百四十八乘六	十二乘六
三十八点六乘一百	八百乘一百
九十三年正月二十六是阳历多少	九十三年正月二十六是阴历多少
老是干咳嗽是什么原因	偶尔干咳嗽是什么原因
二十三乘四等几	六十四加二十八
彰武到锦州客车时刻表	锦州到彰武客车时刻表
三十二乘八	一乘八
三百二十五除五	一万乘一万
湖南帅哥多不多	湖北帅哥多不多
一百八十乘四十	一百八十乘一百六十
形容人很胖的句子	形容人很瘦的句子
二千四百除五	十二除十三
佳木斯到西双版纳多少公里	西双版纳到佳木斯多少公里
小型混凝土搅拌机多少钱	大型混凝土搅拌机多少钱
冰箱线太长怎么办	冰箱线太短怎么办
芜湖到上饶高铁时刻表	上饶到芜湖高铁时刻表
丝芙兰的东西便宜吗	丝芙兰的东西贵吗
三十二除五十	三十二除十八
关闭儿童模式	打开儿童模式
一百二十五乘八十	三十除二十四
宜家装修贵吗	宜家装修便宜吗
微信视频和语音发不出去怎么回事	微信语音和视频发不出去怎么回事
二百四十乘二等多少	六十四乘二等多少
太阳和彩虹的位置	彩虹和太阳的位置
四十乘九	四十乘四十
八十七乘三	八十七除三
十乘零点零零一	十乘二十五
许昌至万州火车票	万州至许昌火车票
眼睛眼压低是怎么回事	眼睛眼压高是怎么回事
二十四除十六	三百二十八除十六
九乘六等几乘六	六乘九等多少
五乘八	八乘八
手机屏幕经常花屏	手机屏幕偶尔花屏
笨拙的近义词是什么	聪明的近义词是什么
天津到大连的船票	大连到天津的船票
九点九除三点三	二加十等几
抛物线准线和焦点的关系	抛物线焦点和准线的关系
八十五乘八	一点八乘五
十三乘十五乘十五	十三乘十五等多少
一百零二乘六	一百二十五乘六
二十五乘二十五	二十五乘十二
温岭离宁波有多少公里	宁波离温岭有多少公里
一点零八乘零点八	四十除二十四
五十四除六	六十八乘二
浪琴越走越快怎么办	浪琴越走越慢怎么办
石秀和武松谁厉害	武松和石秀谁厉害
三分之一加二分之一	三分之一加五分之一
四十七乘十五当几	四十七除五等多少
淮安到泗阳火车	泗阳到淮安火车
二十五点三除零点八八	三乘四等多少
属羊和属马婚姻相配吗	属马和属羊婚姻相配吗
六十四乘四十五竖式	六十四乘八十竖式
济南到厦门的飞机	厦门到济南的飞机
一点八乘零点六	七除八等几
兰州开车到西安几个小时	西安开车到兰州几个小时
三十五乘四等多少	四乘四乘四等多少
七百五十除五列竖式计算	七百五十除六竖式计算
一百七十乘三	一百七十乘三十
女人情商低的典型表现	女人情商高的典型表现
台州到临沂客车	临沂到台州客车
血小板高是怎么回事	血小板低是怎么回事
孩子经常流鼻血是什么原因	孩子偶尔流鼻血是什么原因
六除十八	十八除六
二加三	二加二
什么食物蛋白质含量高	什么食物蛋白质含量低
皮肤被太阳晒伤了怎么办	太阳把皮肤晒伤了怎么办
四百五十乘二	四百五十除二
一百六十除四十八等多少	十六除四十八等多少
十二除五	十二除零点五
钠低有什么症状	钠高有什么症状
四十五加四十五等多少	四点五乘零点二
十五除五	十五除零点五
三十乘三百二十	三十乘四十五
怎么让视频清晰一点	怎么让视频模糊一点
十六乘十六等	零除二
睡眠差是什么原因	睡眠好是什么原因
北京到南京高铁多长时间	南京到北京高铁多长时间
胰岛素高是什么原因	胰岛素低是什么原因
怀孕的肚子是硬的吗	怀孕的肚子是软的吗
一除七	十四除十六
三十二除五十	三十二除十六
二十乘七十七	七乘十七乘七乘十二十等多少
五千乘五千等多少	六乘六等多少
四十五乘十五	四十点六除十四
一点七五除二	零点七五除二点五
商丘到延安有多少公里	延安到商丘有多少公里
八十乘一百二十	十除十五等多少
四十除四的竖式计算	八除四的竖式计算
大五岁的姐姐比弟弟矮正常吗	小五岁的弟弟比姐姐还高正常吗
本溪到武汉	武汉到本溪
五十五除二	八乘五
八点五乘六	八点四乘五
十八乘二十七	十一乘二十七
论文摘要和关键词格式	论文关键词和摘要格式
重庆至杭州特价机票	杭州至重庆特价机票
怀孕前三个月会瘦吗	怀孕前三个月会胖吗
九十除三十	九十除十八
一点二乘五等多少	二乘五等
柬埔寨人口和面积	柬埔寨面积和人口
慢性肠胃炎和急性肠胃炎的区别	急性肠胃炎和慢性肠胃炎的区别
如何错误的套路一个魔教教主广播剧	如何正确的套路一个魔教教主广播剧
大便难解是怎么回事	小便难解是怎么回事
折射率越小波长	折射率越高波长
二十四乘七	三百五十乘六
五百零六乘二十四等多少	二十乘二
三百乘九	三百除九
一百零五乘八	六百除三
血压九十除六十正常吗	血压一百九十除六十正常吗
零点九除零点九除零十二	七点九除零点二等多少怎么计算
六十三乘二十五列竖式怎么列	十四乘二十五列竖式怎么列
怎样把胳膊练细	怎样把胳膊练粗
感冒头痛发热吃什么药	感冒头痛发冷吃什么药
七加四	四加七
你可以做我女朋友吗	你可以做我男朋友吗
男的什么样的掌纹最好	男的什么样的掌纹最差
三点一四乘六点二五	六点二五乘三点一四
二十六除零点一三	零点一三除零点一七
急性肝炎的症状	慢性肝炎的症状
身高矮怎么办	身高高怎么办
七点二乘零点五	六乘四等
八十八除九	八十八除八
肌酐高的症状	肌酐低的症状
如何唱高音简易方法	如何唱低音简易方法
新生儿经常呛奶正常吗	新生儿偶尔呛奶正常吗
衣原体和支原体症状	支原体和衣原体症状
石家庄至芜湖	芜湖至石家庄
零点一百七十五除零点二十五庸算	两点一百七十五除零点二五等几
八乘五	八乘八
五十点二十除三点一四	十七乘四
痛风急性发作怎么治疗	痛风慢性发作怎么治疗
九乘四等多少	九十乘四等多少
地级市最少的省份	地级市最多的省份
上海到西雅图的机票	西雅图到上海的机票
五除零点三六	零点三六除零点九
五点五除十一	十一除五
东北的九百八十五大学	西北的九百八十五大学
李子吃多了会胖吗	李子吃多了会瘦吗
移动和联通哪个网速好	联通和移动哪个网速好
三十乘十二	十二乘三十
四乘四乘三点十四乘一点两	三点十四乘四乘四乘一点两
十加二十等多少	十加五等多少
四除十三等几分之几	十三除四等几分之几
离广东最近的草原	离广西最近的草原
虾和香菇能不能一起吃	香菇和虾能不能一起吃
一百乘八十	零点二五乘四十
一百八十减三十五等多少	二十除八
二百乘二百	二百除四十
脚指甲变白怎么回事	脚指甲变黑怎么回事
四十七乘二	八十除十二
十九除三	十五除九
一百二十五加五十x八的简便计算	一百二十五加九x八的简便计算
二十五除十	四点八除四
七除零点三五	零点七除零点三五
玉米可以和西红柿炒吗	西红柿可以和玉米炒吗
四十三除二	五减七分之三等多少
六十七乘六	十二点五乘零点八
一千除一千	一千除二
八十六乘三	三点一四乘一点七
三点八除一百等多少	五十除一百等多少
三十一乘二等略为	三十一除二怎写
肌酸激酶高怎么办	肌酸激酶低怎么办
四十九乘多少埒七	四十九除七等不怎么
木地板被蚊香烧黑了怎么办	蚊香把木地板烧黑了怎么办
十七乘三十八的竖式	十七乘二十四的竖式
耳壁上有硬的片状耳屎	耳壁上有软的片状耳屎
四十五除六十	四十五除十五
澄澈的近义词和反义词是什么	混浊的近义词和反义词是什么
九十三除五等几余几	九除五等几余几
肾衰竭一千零二肾衰竭减百度	口角炎一千零二口角炎减百度
一百二十乘九	三点二除四
八加三专项整治是什么	一加三专项整治是什么
胖人遗传吗	瘦人遗传吗
一百七十六除二	一百九十除二
一千是奇数吗	一千是偶数吗
五乘十六	十六乘五
五十四除三等多少	零点四乘五
一百加二十等几	二除九
早上好的长句子	早上好的短句子
二十一乘二十一	二十八乘二十一
八分之七乘四等多少	五乘四等多少
一百乘五	六十除二十五
一减二	五乘三
四十五减三十	十减三十
急性气管炎的症状	慢性气管炎的症状
六乘二等多少	零点三五除五
宝宝经常咳嗽什么原因	宝宝偶尔咳嗽什么原因
牙齿经常出血是什么原因	牙齿偶尔出血是什么原因
二十二乘四十三的竖式	四十三乘四十三的竖式
种大蒜的时间和方法	种大蒜的方法和时间
七十五除十五	十四加七等多少
湖南大学文科优势专业	湖北大学文科优势专业
福建到江苏火车票多少钱	江苏到福建火车票多少钱
三点一四乘六十四等	八除九等多少
二十二乘二	九十六除七
五十五乘十	十二乘十
六十一减十五	十五减十五
二十五乘二十五	四十五加十五
四十五乘九	九十乘十二
三十四乘五十八列竖式计算	四十四乘五十八列竖式计算
轻色调是什么颜色	重色调是什么颜色
喀什到长沙	长沙到喀什
三点一四乘五乘五	三点五乘三点五等多少
六十四加十八当多少	六十四加十八等几
东北大学详细地址	西北大学详细地址
经常梦到一个人代表什么	偶尔梦到一个人代表什么
怎样区分肾阳虚和肾阴虚	怎样区分肾阴虚和肾阳虚
五百除二	五百除六十
十二除十二	十二除四分之三
十八乘十八等多少	四乘十八等多少
六十三除七等几	四点五除零点零九
伤口愈合慢怎么回事	伤口愈合快怎么回事
八十六年阳历十一月二十六日是什么星座	八十六年阴历十一月二十六日是什么星座
三十除四百	三百除三十
两点三乘九	两点三乘两点四
二十乘三十等多少	二十乘三等多少
三十六乘二	三十六乘五
一点二五除二点五	二点二九除一点一
太原至莱阳火车时刻表	莱阳至太原火车时刻表
奶糖和奶酪的区别	奶酪和奶糖的区别
二十六乘十四	二十六乘十九
六十二乘六	六乘六乘六
鄱阳湖的蓄水量比洞庭湖多吗	洞庭湖蓄水总量比鄱阳湖要少吗
二加六加六	六加二加几
十二乘三十六等多少	十二乘零等多少
一除零	零除零
三十点一除三十三	零点六除零点三
二十七乘五	八点一除九
就业率高的学校	就业率低的学校
大乐透十二加五复式多少钱	大乐透十二加六多少钱
小的用英语怎么说	大的用英语怎么说
女方提出离婚男方不同意	男方提出离婚女方不同意
六点四除三点二	十六乘十六
一百二十乘六十等	六乘六十等
吃麦片会胖吗	吃麦片会瘦吗
梦见手机坏了	梦见手机好了
十五乘二十	十六乘二十
五十乘四十当	五十除四十怎算
一点二乘一点二	五十乘五
上海到南京顺丰多少钱	南京到上海顺丰多少钱
不生气的歌	不高兴的歌
侄女和大伯是什么关系	大伯和侄女是什么关系
深圳飞金边的航班时刻表	金边飞深圳的航班时刻表
四乘三等多少	四乘四乘四等多少
左臂发冷是什么原因	右臂发冷是什么原因
六乘四	四乘六
一百乘五十	十八乘五等多少
压力过大会导致月经量少吗	压力过大会导致月经量多吗
一百除十五	十五除一百
徐州火车到邳州时刻表	邳州火车到徐州时刻表
萧军和萧红什么关系	萧红和萧军什么关系
六分之一加三分之一等几分之几	六分之一加七分之一等几分之几
如何把支付宝的钱转到余额宝	如何把余额宝的钱转到支付宝
十二除x等四十八解方程	四十八除x等十二解方程
头发长得慢怎么回事	头发长得快怎么回事
五十四克除九等	五十四克除六等
一百七十乘二十	十六除零点六四
尾同头合十的规律	头同尾合十的规律
献血的好处和坏处	献血的坏处和好处
三点一四乘一百	八点八四除一点七
二十四除六十	六百四十八除二十四
不喜欢吃热的食物	不喜欢吃冷的食物
三十四除零点一七	零点一三除零点一七
七十八减十八	七十八减八十三
三百六十除六等几	零除零等多少呀
关闭导航	打开导航
白带有臭味	白带有香味
眼睛冷敷和热敷的区别	眼睛热敷和冷敷的区别
零点二十六乘零点五	零点二十六乘四
三点一四乘四乘四	四乘三
十二乘十二列竖式怎么列	十二乘三十竖式怎么列
身上长了大痘痘	身上长了小痘痘
七乘十二	十七乘五
在瑞士买劳力士便宜吗	在瑞士买劳力士贵吗
金阳县到西昌有多少公里	西昌到金阳县有多少公里
二百四十除六十等多少	六十除六等多少
西安至怀化火车时刻表	怀化至西安火车时刻表
松龄血脉康的作用和功效	松龄血脉康的功效和作用
属马和属鼠的能结婚吗	属鼠和属马的能结婚吗
稀疏怎么拼	繁茂怎么拼
四十五乘一点五	四十五除一点五
十二分之七乘三	十二分之七乘十四
三点五乘零点二	九乘四等多少
一点七乘三	一点七乘四
钢和生铁性质不同的原因是	生铁和钢性质不同的原因是
两点一除三等多少	两点一除一点两等多少
汤原到南岔列车时刻表	南岔到汤原列车时刻表
尿不湿小了怎么贴	尿不湿大了怎么贴
二十四乘五分之二	十四乘五分之二
三十二乘三十二乘三十二怎算	十二乘三十二等多少
九除四等几分之几	九除六等几分之几
经常打喷嚏是什么原因	偶尔打喷嚏是什么原因
一百三十一点二除二	八十八点二除九
三点五乘零点四	三点六乘零点四
铝合金和镁合金有什么区别	镁合金和铝合金有什么区别
一百八十乘二十	三十六乘六
二十一乘六十约	二十一乘十八约
三百五十除一千等多少	三除一千等多少
为什么身体越来越瘦	为什么身体越来越胖
三十七除二十	七除二十
高钾症状有哪些	低钾症状有哪些
六十四除二	六十四除四
五点二除二	五点五除二
四十五乘四十五	十二乘四十五
武汉去深圳需要隔离吗	深圳去武汉需要隔离吗
二十三乘五	一百加五十
四乘零点二五	零点二五乘四
十五乘十五	十五乘四百
八十除四	八百除四
三百加三百等	十四乘六等多少
宽阔的反义词近义词	狭小的反义词近义词
三十七除二十	三十七除一百
零点四五乘零点四五	零点四五除零点九
身体水份含量低怎么办	身体水份含量高怎么办
青州到梁山多少公里	梁山到青州多少公里
白甜菜的功效与作用	白苦菜的功效与作用
李湘和王岳伦离婚了吗	王岳伦和李湘离婚了吗
血压高缺钾	血压低缺钾
河南职工住院报销比例	河北职工住院报销比例
盐城到淮安汽车	淮安到盐城汽车
四十七乘五	四百八十除三
大型沙滩车价格	小型沙滩车价格
轻微烫伤怎么办	严重烫伤怎么办
孕妇尿碘高怎么回事	孕妇尿碘低怎么回事
九减三	九减六
五除四十五等多少	五除七等多少
二百零四乘四	二百零五乘四
什么血型最好	什么血型最坏
一点八除十二	一除十二
二百四十乘八除五	十乘八除五
二十七点七千五百七十六乘七十	一百乘七十
一乘四等几	三十乘二十五
三十二乘二等多少	四十加四十
孕妇得了急性肠胃炎怎么办	孕妇得了慢性肠胃炎怎么办
保鲜期长的水果	保鲜期短的水果
丰田小排量	丰田大排量
一百乘二十怎么列竖式	十二乘二十怎么列竖式
三百五十乘二	四百五十乘二
普通近义词是什么标准答案	珍贵近义词是什么标准答案
二百零四乘三十	七十五乘六
五乘零点八	零点七八除六
二点八乘二	六点二八乘一点二
二十六点三七除三十一	三十一除二
形容心情惆怅的诗句	形容心情舒畅的诗句
什么是软导体	什么是硬导体
零点五乘二	零点五乘零点二
十五乘二	十除十二
九十乘九	九十减七十二
三十乘零点六	六乘三十
二十乘一点五	二十乘五
四十五减三十	三十减三十
地球离太阳有多远	太阳离地球有多远
七十二除五	七十二除十二
色膏零除四十三是什么颜色	色膏八除四十三是什么颜色
经常胃疼是什么原因	偶尔胃疼是什么原因
越来越瘦是什么原因	越来越胖是什么原因
七十六减六十七	七十六减九十九
二百五十乘二	二百五十乘六十
为什么自己的口水是苦的	为什么自己的口水是甜的
血压高可以吃二十一金维他吗	血压低可以吃二十一金维他吗
戒指尺寸可以调大吗	戒指尺寸可以调小吗
六除于八分之十五	六除于六
怎样减肚子和腰上的赘肉	怎样减腰和肚子上的赘肉
酸奶和生姜可以一起吃吗	生姜和酸奶可以一起吃吗
三百二十除五	八十五除十七
这次月经量特别少怎么回事	这次月经量特别多怎么回事
左边嘴角比右边低	右边嘴角比左边低
一百八十除四等多少	三乘十三
二加二十等几	二十加八十等几
四十八除二点三	二十乘二十
身子特别短的狗	身子特别长的狗
手经常发麻是什么原因	手偶尔发麻是什么原因
关闭网易云音乐	开启网易云音乐
湘乡离湘潭有多远	湘潭离湘乡有多远
月经老是推迟的原因	月经偶尔推迟的原因
鸡蛋能和菠萝一起吃吗	菠萝能和鸡蛋一起吃吗
一百五十六除十二	三百乘四等多少
一百八十乘三十一	三十一乘五
滨海机场到天津西站打车多少钱	天津西站到滨海机场打车多少钱
一百除一百等几	十七减八等几
大溪到金华汽车时刻表	金华到大溪汽车时刻表
皇家美素国行和港版有什么区别	皇家美素港版和国行有什么区别
三点四除十七	十七除四
十二乘八十是稍微	十八乘十八等多少
胖的英语反义词是什么	瘦的英语反义词是什么
四十五乘三等多少	九点零七减六点七等多少
六十乘十五等多少	六十乘十五怎算
七十五乘一百零二	七十五乘四十
麻烦英文怎么读	方便英文怎么读
三点一四乘四百	四百乘三点一四
天猫和京东哪个好	京东和天猫哪个好
二十四乘六十	四天加四天
外省回广东的人员需要隔离吗	外省回广西的人员需要隔离吗
五十七乘二	五十七除二
二十五点五除二点五	嘿小布零除零等多少
经常胸闷喘不上气	偶尔胸闷喘不上气
临朐到沂水多少公里	沂水到临朐多少公里
母英文翻译	公英文翻译
一百二十五除三十	一百二十五除二十五
三十乘五十	五十乘三十
十一乘十一	十二乘十二
三十二除五十	三十二除十五
二十三乘五	二加九等几
四减二十毫安是什么意思	四减三是什么意思
全身热怎么办	全身冷怎么办
大明湖站离济南站多远	济南站离大明湖站多远
六百零九除六等	十二除六等
二十五乘五	二十五乘四
三百七十八除六等几	十二除六等几
五百四十除八等多少	八除八等多少
十六乘十七	十六加十七
二十七乘八	二十七乘六
四十二乘四	五十除八
十四乘二十八	十四乘十二
痱子和湿疹有什么不同	湿疹和痱子有什么不同
十二乘二十四	四加一等几
三点一四乘九等多少	三点四乘九等几
经常便秘是什么原因	偶尔便秘是什么原因
一百二十四乘八十五等多少	一点二乘五等多少
一百五十乘三十等几	一百五十乘三十乘五十
大便颜色深褐色	大便颜色浅褐色
二十九乘九	一亿乘一
二乘几等六	二乘几等三十
河北大学怎么样	河南大学怎么样
九十九乘九十九等多少	九十九乘九等多少
西安到北京高铁多长时间	北京到西安高铁多长时间
一百零二乘十九简便计算	一百零二乘十六简便计算
老实的四字成语	调皮的四字成语
长沙至湘乡的火车	湘乡至长沙的火车
三十九除二	三十九除四
四十五点六减十四点八加六点三十二简便计算	四十五点六减十四点八加六点三十二简便运算
二十六乘八	四点九除七
成都至雅安客车时间表	雅安至成都客车时间表
四百除二十五	四百除六
四百五十五除五	三点一四乘十八
三点五乘零点四	五十除六
十五乘十六	十六乘十五
英文数字一减十二	英文数字一减六
老是跟女朋友吵架	老是跟男朋友吵架
一百二十除五	五除五等几
爷爷和孙女是什么关系	孙女和爷爷是什么关系
一百八十乘二十	四点三乘一点一
一百五十除二十	十八乘十六
近视怎么恢复视力	远视怎么恢复视力
二十七乘十五	六十三除七等多少
二十一乘九	零点二七除九
五除十二乘六十	五除十二乘八
一千除一百	一百乘一千
我能把你喊出来吗	你会不会被我喊出来呢
一点八乘零点五	零点八乘一点五
九除四等几分之几	九除十八等几分之几
四乘三点四乘四点四	三点一四乘三点一四怎算
雄伟的怎么写	渺小的怎么写
二十八乘一百	二十八乘零点一
一点七乘三等多少	一点七乘零点五等多少
氨纶和锦纶的优缺点	锦纶和氨纶的优缺点
一点五乘一点五乘一点五乘一点一	二乘一点五乘三点五等多少
胃泌素高说明什么	胃泌素低说明什么
四十五乘八	三十除二点四
十五减十八	十八减十五
十八除五分之三等多少	六除五分之三等多少
双色球十六加二多少钱	双色球一加二多少钱
形容开朗的成语	形容孤僻的成语
小米蓝牙耳机一百九十九和三百九十九的区别	小米蓝牙耳机三百九十九和一百九十九的区别
二十一乘三	二十一乘四
十乘十	十二乘十
苏泊尔燃气灶和海尔燃气灶哪个好	海尔燃气灶和苏泊尔燃气灶哪个好
三加四等几	四加三等多少四加四等几
经常放屁是什么原因	偶尔放屁是什么原因
天气很热怎么发朋友圈	天气很冷怎么发朋友圈
一百七十五除二十五	一百七十五除七
酒精肝和脂肪肝哪个严重	脂肪肝和酒精肝哪个严重
一百乘一万等多少	三乘二等几
三点一四乘一百九十六	二百乘二百等多少
三十除八	十六加七
坚硬的反义词和近义词是什么	柔软的反义词和近义词是什么
一除三乘七十五	一除三乘十
三除二	二除二
吉林和大庆哪个好	大庆和吉林哪个好
八十加八	十八乘二
四十五乘九	四十五乘二
一百二十五乘八	一百二十五乘六
二点五乘零点四等多少	六乘三十
一点六除零点二五	一百减五十等多少
九百六十除七等多少	一除七等多少
带有脏的四字词语	带有净的四字词语
梦见大便解不出来	梦见小便解不出来
大汽车品牌	小汽车品牌
最短命的生肖是什么	最长寿的生肖是什么
二十四乘二十四	二十四乘十二
四十五乘十二抵多少	十二乘四十五加十二
九江到株洲火车时刻表查询	株洲到九江火车时刻表查询
二十千克和二千五百克哪个大	二千五百克和二十千克哪个大
氨气和过量氯气反应	氯气和过量氨气反应
二十八乘二	二十八除二
二分之一减三分之一	十五乘五等多少
五十四乘八	五十四减二十八
西北师大考研分数线	东北师大考研分数线
济南至保定高铁时刻表查询	保定至济南高铁时刻表查询
三百二十六乘八等几	三百二十六乘三百二十等几
三点十四乘零点零六百二十五	三点十四乘六
特别的音节	普通的音节
昆山离浦东机场多远	浦东机场离昆山多远
一点二五乘三点二	二点二五乘三点一四
神奇的反近义词	普通的反近义词
三乘五等多少乘多少相当多少	五加三乘三等多少
五乘二点五	四十乘二点五
肾衰竭一千零二肾衰竭减百度	败血症一千零二败血症减百度
天猫和京东那个靠谱	京东和天猫那个靠谱
一百八十乘三	一百八十乘十
宝宝反复低烧	宝宝偶尔低烧
三十一除一百一十九	三十一除十二
四乘二十三	四十乘十五等多少
四十二除六等多少	三除零点六
二十一乘四	四百五十五除三点五
五十加六十等几	零加零等多少
五除十二乘六十	五除十二乘四
五乘四等多少	四乘四乘四等多少
尿少尿黄怎么回事	尿多尿黄怎么回事
壁布和壁纸有什么区别	壁纸和壁布有什么区别
七十乘七十乘五十	七十乘五十相当于多少
五乘三加五乘四加三乘四	五乘三加五乘三加三乘三
零点七五乘四	零点七五乘零点四
九时三六除零点三六除九	零点三六除零点九等小
七十乘三点一四	三点一四乘七十
七百二十除八十	三百加四百等几
幸福感最高的职业	幸福感最低的职业
嘉兴公立初中排名榜	嘉兴私立初中排名榜
一百乘二	十八乘七
牙齿敏感怎么办	牙齿麻木怎么办
三十乘三点一四	二十乘二十乘三点一四
美图秀秀怎么把人p黑	美图秀秀怎么把人p亮
五十八除两x十六的竖式	五十八除六的竖式
五十五乘二	十八乘五
头围正常双顶径偏小原因	头围正常双顶径偏大原因
二百五十乘四等多少	三加一呢
老是反胃干呕怎么回事	偶尔反胃干呕怎么回事
一百二十五乘三	八十除六
三减八什么意思	八减三什么意思
一百二十乘三	三点一四乘一百二十
七乘九	九乘七
二十五乘四十	四十乘二十五
一百六十除二	二十五乘六等多少
五十乘三	五十乘五十
十五除零点五	零点五除五
二十二乘八	零点四乘零点八
一点八除六	八除一点六
三十六乘十一	十二乘十一
邵阳离张家界多远	张家界离邵阳多远
一百零五除十三	一百零五除四十
阳历八月二十三日是什么星座的	阴历八月二十三日是什么星座的
五点四除六	六点四除四
三十二乘十五	十五乘三十二
三十三乘九	十五除二十四
二百七十除九十	一点二乘五
石家庄和成都哪个大	成都和石家庄哪个大
三点五乘零点四	三点四乘零点五
六百四十除十六等	六百四十除一百六十等
一百五十乘五十等多少	二百零八除二
二分之一加三分之一怎么算	二分之一加三分之一怎么做
上虞到义乌汽车时刻表	义乌到上虞汽车时刻表
二百除六	五点六除零点零八
四十四乘五十六的竖式	四十四乘三十四的竖式
五十四除三	五十四除四
十一乘四十五竖式	十一乘二十六竖式
十四亿乘二百五十	二百五十乘二百五十
一百零四除二十六等多少	八除二十六等多少
月经量少该怎么办	月经量多该怎么办
二百七十除五	二百七十除六
散光看近处模糊吗	散光看近处清晰吗
十四乘二等几	零点八乘二点五
八十二除二	三十乘九
十四乘六	十四乘十四
韶关到新丰有多少公里	新丰到韶关有多少公里
二百乘零点零一	二百乘一百四十
二十一除四	四十八乘六
华南植物园几点关门	华南植物园几点开门
三十二加九等	三十二加四十等
九百五十一除五的竖式怎么列	零除五的竖式怎么列
一百二十除五	二百五十除五
结肠炎可以吃大白菜吗	结肠炎可以吃小白菜吗
如何区分肾阳虚和肾阴虚	如何区分肾阴虚和肾阳虚
二里面有几个一除六	五里面有几个一除六
二百五十乘四等几	二乘八等几
上海哪里富	上海哪里穷
三点四乘两点五	三点四乘四
鼻咽炎和鼻咽癌的区别	鼻咽癌和鼻咽炎的区别
一百四十乘五十	一百四十乘六
银行卡可以转账到信用卡吗	信用卡可以转账到银行卡吗
四十二除十	七十六除十
三乘几等十二	十二乘三等几
0两年阳历九月十一什么星座	0两年阴历九月十一什么星座
八十四除四列竖式计算	八百四十四除四列竖式计算
三点二除零点零四	六乘八等多少
八乘三点一四等	十二乘十二
十二乘十八	十八乘十二
天津站到天津滨海机场有多远	天津滨海机场到天津站有多远
北京到武汉高铁多久	武汉到北京高铁多久
四十二乘三十	四十二乘十五
五加五加五加五等几	十二加八
怎么看iphone是不是假的	怎么看iphone是不是真的
三十二乘四	三十二除四
肾阴虚和肾阳虚的区别是什么	肾阳虚和肾阴虚的区别是什么
铜仁到贵阳过路费	贵阳到铜仁过路费
九点七百二十八除三点二	四百乘六
七十八点六除十一	十一除六
三百二十加三百二十等多少	十六乘十六等多少
二百零四乘三十	二百零四乘五
三点一四乘三十	三点一四乘十二
铜和铝哪个熔点高	铜和铝哪个熔点低
五除十二乘九	一除十二乘九
减一除两的五次方	减一除两的四次方
甘油三酯低怎么回事	甘油三酯高怎么回事
三十六乘三	十二点五乘八等多少
蛋白高怎么回事	蛋白低怎么回事
一点五乘八	八乘一点五
三点四乘五等多少	三点一五乘五点一二加三点二四等多少
七百二十除五十的竖式和验算	七百二十除七十的竖式和验算
三d和vr的区别	vr和三d的区别
八十乘八	八十乘八十
兰州到拉萨自驾	拉萨到兰州自驾
天然的英文	人造的英文
三十六乘二十四	二十四乘二十四
热量和光照有什么区别	光照和热量有什么区别
五乘零点六	零点六乘五
一加八pro有nfc吗	一加七有nfc吗
三加四	四加三
档案被单位丢失怎么办	单位把档案丢失怎么办
牛排热量高	牛排热量低
大乐透七加三中四加一多少钱	大乐透七加四中三加一多少钱
三点一四乘一点二	十乘十
一百八十加一百八十加一百八十是稍微	一百八十加一百八十等几
六十三除九	六十三除二
七十二除十八	七加三等
一百二十四乘六十五	一百三十乘六十五
女人阳虚和阴虚的区别	女人阴虚和阳虚的区别
表示舒服的词有哪些	表示难受的词有哪些
四百八十除八	十二乘二十五
七百五十除二	七百五十除十五
天润城到南京站	南京站到天润城
腰椎间盘突出和腰肌劳损有什么区别	腰肌劳损和腰椎间盘突出有什么区别
把游戏空间删了怎么办	游戏空间被不小心删除了怎么找回
二十六除五用竖式计算	三十六除五用竖式计算
河南大学到底什么时候开学	河北大学到底什么时候开学
通化至临江	临江至通化
小孩偶尔咳嗽	小孩经常咳嗽
五十四乘四	四乘四乘四
二十六乘二	七百五十除五
六十四除四	六加八加三加五
一百五十乘三十等多少	五十四乘七
任丘到石家庄的客车通车了吗	石家庄到任丘的客车通车了吗
三加五等多少	三加五加几等多少
三十九乘二	三十九除二
慈溪到宁波顺风车多少钱	宁波到慈溪顺风车多少钱
北京到开封快递几天	开封到北京快递几天
最漂亮的鱼	最丑陋的鱼
七十二乘三点十四	十六乘三点十四
苏打饼干吃了会胖吗	苏打饼干吃了会瘦吗
齐齐哈尔到阿城的火车时刻表	阿城到齐齐哈尔的火车时刻表
二百八十八除三	二百八十八除十二
形容很急促的词语	形容很缓慢的词语
r十一除零点六	六百除三十
三十六除二等多少	零点二四除三
张店到新泰多少公里	新泰到张店多少公里
七十七除四等多少	八除四等多少
一点八除三	四乘三等几
发热白细胞高怎么回事	发热白细胞低怎么回事
八十四除四等小	八十四除四等多少
三除四	四除三
十二乘零点五十六	十乘零点五十六
嘴唇太厚怎么办	嘴唇太薄怎么办
伤心用英语怎么写	高兴用英语怎么写
一除零点七	八乘三点一四等多少
五十乘六	四乘四十五
两百乘四	十八乘八
二十二乘四十等	二十二乘三等
白细胞低的危害	白细胞高的危害
吐白痰怎么回事	吐黑痰怎么回事
六十八乘二	六十八除二
七十乘一百四十	七十除一百四十
五百四十除五	五百四十除四
三点二乘一点五	十三乘二等几
二百一十除七	三点六除零点二
三十四乘五十八列竖式计算	三十四乘三十五竖式计算
五十五乘十等多少	六乘十等多少
三百乘六	六百乘六
广州到武汉的飞机票多少钱	武汉到广州的飞机票多少钱
衡水到周口	周口到衡水
拔火罐的好处和坏处	拔火罐的坏处和好处
只吃白米饭会胖吗	只吃白米饭会瘦吗
一除二点五	二点一除二
二十乘十七乘二十七	十七十乘七
七除五十六	七除四
九十九乘四十九加九十九简便运算	四十九乘九十九加九十九简便运算
宝宝老是干呕怎么回事	宝宝偶尔干呕怎么回事
什么少什么什么的成语	什么多什么什么的成语
三百六十五乘八	零乘八
一乘七等几	五十乘三点一四
你怎么样才能被我叫出来	我怎么才能把你叫出来呢
三十一除一百一十九	三十一除一百一十
五十四除二等多少	三百加五百等几
七乘几等二十	五乘几等二十
十六除十	十六除十二
三十二加二十	六十加二十
四十九乘三点二二乘四点三二	三点一四乘四十九等
一百七十乘五十	零点五除零点二
怎么瘦屁股和大腿	怎么瘦大腿和屁股
二十七乘九	二十七除九如何算
零点一乘零点七	一百乘零点七
信阳到佛山多少公里	佛山到信阳多少公里
二百一十乘二十	三十除二十
三十除二点四	十乘八
七百二十三除六等多少列竖式	七百二十三除八等多少列竖式
齐齐哈尔到加格达奇的火车	加格达奇到齐齐哈尔的火车
六十六年十二月二十一日生阳历是什么星座	六十六年十二月二十一日生阴历是什么星座
三点四乘零点五	四乘零点五
三点四乘两点五	三点四乘三点四
八百四十除六	五乘四等几
十四乘十四	十乘十
稀组词和拼音怎么写	稀拼音和组词怎么写
五除十二乘六十	五除十二乘十三
襄阳到武汉开车多久	武汉到襄阳开车多久
三百二十乘五	三百二十乘四
快递员把快递弄丢了怎么办	快递被快递员弄丢了怎么办
五十一乘八十七	五十一乘五十四
九百零六除四的竖式计算	九百零六除九的竖式计算
心率快血压会高吗	心率快血压会低吗
阴沉的英语怎么说	明朗的英语怎么说
扬州到重庆飞机时刻表	重庆到扬州飞机时刻表
五乘零点八	零点八乘五
三乘六	三点一四乘六
十三除七等多少	九加八
什么避孕药副作用最小	什么避孕药副作用最大
四十一乘二	四十一乘八
一千除一百五十七	九十乘五
连界到重庆汽车时刻表	重庆到连界汽车时刻表
猪肉和韭菜的比例	韭菜和猪肉的比例
江阴到苏州的汽车时刻表	苏州到江阴的汽车时刻表
七十六乘五十四	七十六乘八十
用粉底液之前要不要用隔离	用粉底液之后要不要用隔离
fun和cut的u发音相同吗	cut和fun的u发音相同吗
十四点五减一点五加六点九十七简便运算	十四点五减一点五加六点九十七简便算法
五十八乘六	七十五除四
我的腿很短英文	我的腿很长英文
为什么有些人怎么吃都不胖	为什么有些人怎么吃都不瘦
九点十乘十	九点八乘八
六十乘九	六十除九
五除三分之四	四除三分之四
二十五乘八	十四乘十五
一点五乘零点六等略微	一点六乘零点五
经济最发达的县	经济最落后的县
十一除一点五	十二除一点五
四十二乘九十九加四十二简便计算	一百乘九十九加一百简便计算
三十四乘多少等二百九十四	十九乘五十等多少
北大哲学系比清华好是吗	清华哲学系比北大的差些是吗
二十乘五等多少	零点八乘零点七
嘴里唾液甜	嘴里唾液苦
女人幼稚的表现	女人老练的表现
三加三等七加二	三加七等几
四十五和六十的最大公因数	六十和四十五的最大公因数
一千加一千等几百	一百除十二点五
牛奶和香蕉能在一起吃吗	香蕉和牛奶能在一起吃吗
英文数字一减十二	英文数字一减五
十一乘十五	一十乘五十
关闭荒野乱斗	打开荒野乱斗
四十五除五等几	六点五减五点六
四十八乘三等多少	零乘零等几
五十除十	一千除十
女人太胖对身体有什么影响	女人太瘦对身体有什么影响
二千乘六十	二千乘七百
三十除五当几	三十除五等多少
九十减八等多少	六减八等多少
吉木萨尔到哈密	哈密到吉木萨尔
九十减四十八	五十减四十八
二百一十六除九等多少	六十八乘八
十七乘四十的竖式	十七乘二十七的竖式
八点二十五乘五点四	八点五乘四怎算
十四乘五等多少	十四乘十四等多少
老是拉肚子是怎么回事	偶尔拉肚子是怎么回事
新郑到邯郸多少公里	邯郸到新郑多少公里
男生比女生平均身高更高吗	女孩子比男孩的平均身高矮吗
二百一十除七	二百一十除三
一点五除零点零五	三乘七
五十除十	五十除四十
二除三	二除二
河北师范大学分数线	河南师范大学分数线
零点十五加零点六等多少	零点九加零点六等多少
r十一乘三等几	三十乘五
一百二十五乘三	五十八除二等多少
一百乘二十	五百乘二十
一百二十六除三	一百二十六除六
龙眼和荔枝哪个好吃	荔枝和龙眼哪个好吃
十三分之一乘五十二	五十二乘十三分之一
脖子粗是什么原因	脖子细是什么原因
吃饭多的人一定比吃饭少的人胖吗	吃饭少的人一定比吃饭多的人瘦些吗
低组词语词	高组词语词
二十四乘二十四等多少	二十五除三
两点五乘十的负二次方	一乘十的负二次方
拜登比特朗普大多少岁	特朗普比拜登小多少岁
九江到南宁的火车票	南宁到九江的火车票
十四乘九	十四乘十四
十四除二当十几	二十四除二等多少
五乘六等多少	十五除二十五
经常出虚汗是怎么回事	偶尔出虚汗是怎么回事
伤心用英语怎么说	高兴用英语怎么说
怎么把图片变成八十乘八十	怎么把图片变成二百乘二百
二点一减二点零九	五百除三
三百六十八除七的竖式怎么列	四除七的竖式怎么列
深圳至长沙火车票	长沙至深圳火车票
二百五十乘三	二百五十乘六十
鼻子干燥是怎么回事	鼻子湿润是怎么回事
三百九十除三	四十五乘二十
十二乘十二等多少	零点二七除零点三
十三乘十三	十三乘十四
五十四乘二十三的竖式怎么写	十六乘二十三的竖式怎么写
七十七除四等多少	六除四等多少
什么忙成语	什么闲成语
九十除七	九十除六十
一百八十乘六十	零点九除零点三
六乘四十五等几	四十乘四十五等几
零点七乘零点五	零点五乘零点五
王俊凯和王源是亲生的吗	王源和王俊凯是亲生的吗
七除五十六	七除三
三点二除二点五	二除零点二五
五十除二点二	五十除二点五
肌张力低的表现	肌张力大的表现
衡水到石家庄北站	石家庄北站到衡水
六十一减十五	十八减十五
五十七点六除十八	一点六除零点零四
九百除四十五	五十乘三十
老是打喷嚏是怎么回事	偶尔打喷嚏是怎么回事
六十四除四十怎么列竖式	六十四除八怎么列竖式
京东和天猫哪个靠谱	天猫和京东哪个靠谱
二十一乘二十一	二十一乘十八
二十五乘四十四的简便方法	二十五乘六十五的简便方法
减肥喝粥会胖吗	减肥喝粥会瘦吗
二十九加七	十一加七
一百二十五乘八等多少	六乘八等多少
三点一四乘八	三点一四乘六
小便混浊是什么原因	小便清白是什么原因
葫芦岛穷吗	葫芦岛富吗
三乘四	四乘三
五十乘六十	六十乘五十
吉林到集安多少公里	集安到吉林多少公里
感冒怎么好的快	感冒怎么好的慢
八百除八	八百除八十
十加十六等几	十加一千等几
五十以内八和十二的倍数	五十以内十二和八的倍数
三加九	九加九
三百二十乘二十五	零点九一除一点三
血压一百二十八除八十正常吗	血压九十除八十正常吗
二十一乘四十四用竖式计算	二十一乘十五用竖式计算
六百一十九除五等多少	二十除五等多少
一点二五除零点八	十四乘八等多少
舌苔白怎么办	舌苔黑怎么办
急性心衰症状	慢性心衰症状
二十一乘二十四的竖式计算	二十一乘二十五的竖式计算
三十乘二十四	五十乘二十四
七十二乘二	十六除六
青岛到哈尔滨多少公里	哈尔滨到青岛多少公里
求阴影部分周长和面积	求阴影部分面积和周长
二十五乘十五	五十除三
十四乘八加五	五乘八加五
湖南大学偏文还是偏理	湖北大学偏文还是偏理
二十四乘六	二十四除六
十一月十九日阳历是什么星座	十一月十九日阴历是什么星座
二百二十五除二十五	六百七十五除二十五
六十四乘三等多少	零点四八除四
天津到阜阳飞机	阜阳到天津飞机
鼻子里偶尔有血丝是怎么回事	鼻子里老是有血丝是怎么回事
一除十一	八除十一
慢的拼音和部首	急的拼音和部首
一点五乘三点一四	十加八等几
二十三乘五十等多少	二十四乘九
动脉斑块怎么治疗	静脉斑块怎么治疗
七乘九	九乘九
少的英语	老的英语
七十六乘五	五点六除零点七
二十八乘十五等	二十八乘九等
梨和琵琶能一起熬吗	琵琶和梨能一起熬吗
二十五乘十	三点九四加六点八六
四十五加十九	四十五加十六
笨拙的近义词	伶俐的近义词
四十二乘十九约	四十二乘四十二约
七十乘一百四十等小	七十除一百四十怎算
六十四除七	十四乘五十等多少
七十五除一百	小布三加一
舌头厚白是怎么回事	舌头薄白是怎么回事
一百一十五除四等多少	一百一十五除十二等多少
韦德和詹姆斯谁厉害	詹姆斯和韦德谁厉害
转氨酶高的原因	转氨酶低的原因
头发白怎么回事	头发黑怎么回事
时间短的古文	时间长的古文
四十五加十九	四十五加十三
七十八乘九	五乘十七
十九乘五等多少	十九乘十九等多少
二点四除零点五	四除二点五
三点一四乘二十五等多少	四千加四千等几
快的的英文是什么	慢的的英文是什么
二点五乘三点一四	十除零点二
一百四十乘三十	一百减四十
忧伤的长句子	忧伤的短句子
零点二十五除一千	零点二十五乘一千
九十除十五等多少	九十除五等多少
一减根号三的平方	一减根号二的平方
二十四乘六十二	二十四乘十
十三乘十三等多少	十三乘四等多少
二十乘八	二十乘六
急性胆囊结石症状	慢性胆囊结石症状
九百八十除五等多少	一除五等多少
三十六加三十六等多少	八除八等多少
高密度脂蛋白胆固醇低怎么办	高密度脂蛋白胆固醇高怎么办
台北至成都航班时刻表	成都至台北航班时刻表
男孩子网名	女孩子网名
八十九乘七十八等有些	八十九乘七十八等稍微
一百二十五乘二十四	六十四减三十八
巢湖到苏州的火车时刻表	苏州到巢湖的火车时刻表
科比和詹姆斯谁更强	詹姆斯和科比谁更强
你被我扔掉可以吗	我可以把你扔掉吗
七百五十除十五除十五相等多少	七百五十除五等几
早上吃什么饭	晚上吃什么饭
猫吃的特别少	猫吃的特别多
七十八除二	二点五乘六
丽江到昭通多少公里	昭通到丽江多少公里
六十四乘九	十二乘五点五
三百六十除九等多少	四减三等几
二百五十乘十五	七乘九等几
九百九十九加九十九等几	九十九乘九十九等几
二除零点五	零点二除五
资产负债率和流动比率都很低	资产负债率和流动比率都很高
金鱼凹眼什么原因	金鱼凸眼什么原因
一亿乘一亿	一亿加一亿
湖南到南平多少公里	南平到湖南多少公里
自贡到井研汽车时刻表	井研到自贡汽车时刻表
十二乘零点五十六	十二乘三
二十五乘三百九十九的简便算法	二十五乘六的简便算法
一百六十除三	零点一乘零点一
抑郁症和神经症的区别	神经症和抑郁症的区别
一百五十除十	一点七乘零点五
二百一十六除二十四	二百一十六除二
手机qq语音声音大怎么调	手机qq语音声音小怎么调
四十一除一千化成最简分数	四十一除六十化成最简分数
二十九乘七	三十二除四十二
六百三十除四十二	零点三二除十六
阳历两点十一是什么星座	阴历两点十一是什么星座
十一除十二减两除五等几分之几	一除十二减两除五等几分之几
如何让照片小于六十k	如何让照片大于六十k
早上起来嗓子甜	早上起来嗓子苦
二十五乘九除二十	四十乘九除二十
脚丫大怎么办	脚丫小怎么办
四十二乘十九约	四十二乘二十一约
孕囊二十四乘十四是男是女	孕囊二十四乘十二是男是女
五十五乘三十八的竖式怎么列	五十五乘三十的竖式怎么列
一百二十乘五十	二百四十乘五十
满腹经纶的成语	目不识丁的成语
一百三十二加六十八等多少	十八加六十八等多少
七百二十除五	三点一四乘二点五
十一点二除四	十一除四
尿酸高的症状	尿酸低的症状
抽烟会瘦吗	抽烟会胖吗
晶莹的英文	晦暗的英文
什么动物爬的最慢	什么动物爬的最快
冯绍峰比赵丽颖大多少岁	赵丽颖比冯绍峰小多少岁
一百乘五	一百乘一
五减一	五减三
奇怪的近义词是什么一千零一奇怪的近义词是什么减百度	惊奇的近义词是什么一千零一惊奇的近义词是什么减百度
苹果能和燕麦一起吃吗	燕麦能和苹果一起吃吗
七加三	三加七
四百八十除二十	十七乘四等多少
三百零六除三	三百零六除九
三乘十二	八点一除九
五除十二乘九	五除十二乘四
淘气的日语	老实的日语
大兴国际机场到首都机场	首都机场到大兴国际机场
顺丰从上海到哈尔滨	顺丰从哈尔滨到上海
五百一十五除三的竖式	四除三的竖式
八乘六	六乘八
六十二乘三	六十二除四
女生比男生强的理由	男生比女生强的理由
三十八乘九	六乘九
五乘一等多少	十五除五等几
十一乘十八的竖式怎么写	十一乘十一的竖式怎么写
五十六乘九十九加五十六的简便运算	五十六加九十九乘五十六的简便运算
小便混浊是怎么回事	小便清白是怎么回事
信阳到舞阳	舞阳到信阳
七乘五表示什么	零乘五表示什么
二十三乘三等几	四百除七十五
形容别人美的词	形容别人丑的词
三十八乘六	三十八乘四
八十七乘四十三	八十七乘八十
六百五十除五十	三点一四乘八乘八
一百九十乘六	四千除八
牙齿经常出血是怎么回事	牙齿偶尔出血是怎么回事
经常打喷嚏是怎么回事	偶尔打喷嚏是怎么回事
三十二除六	九十六除三十二
葡萄吃多了会胖吗	葡萄吃多了会瘦吗
上海社保可以转到江苏吗	江苏社保可以转到上海吗
一百七十六加一百七十六等几	十四减三等几
五十加六十	六十加六十
六十乘一百二十cm是什么意思	八十乘一百二十cm是什么意思
五分之一乘四分之三	五分之一乘二分之三
小孩脸上长白斑怎么办	小孩脸上长黑斑怎么办
二十四乘十八	十八乘二十四
用胶水和牙膏制作起泡胶	用牙膏和胶水制作起泡胶
十二除三分之二	十二除四分之三
二十三乘四	四乘二十三
反义词雪白对什么	反义词漆黑对什么
兴隆县到承德的火车时刻表	承德到兴隆县的火车时刻表
十六乘十四	十四除十六
一百一十九除三	零点一二除四
小型平板车运输车价格	大型平板车运输车价格
三十二乘三点一四	三点二五除五
陵川到晋城多少公里	晋城到陵川多少公里
神奇的鹿游戏	普通的鹿游戏
十九年广西企业一百强	十九年广东企业一百强
八十八除九	八十八除四
德令哈到西宁汽车票	西宁到德令哈汽车票
沁阳到郑州汽车时刻表除汽车票查询	郑州到沁阳汽车时刻表除汽车票查询
二乘零点五	四点二乘零点五
形容轻微的词语	形容重大的词语
交流电机和直流电机的区别	直流电机和交流电机的区别
四十九乘十三	十乘十三
家庚和丽红在一起了吗	丽红和家庚在一起了吗
三点六除十	三除十
剖腹产比顺产好吗	顺产比剖腹产好吗
零点零八乘零点两	零点八十六乘零点两
七十八点五除四	四十除十四
六百除八竖式计算	一除八竖式计算
舌头白怎么回事	舌头黑怎么回事
羊奶和牛奶哪个好	牛奶和羊奶哪个好
四除零点二五	零点二五除四
运城到富平多少公里	富平到运城多少公里
描写心情阴郁的句子	描写心情开朗的句子
二百四十乘三什么样算	二百四十除三怎算
一点五乘零点六	一点六乘零点五
密山到齐齐哈尔	齐齐哈尔到密山
三国以前是什么朝代	三国以后是什么朝代
新生儿老是吐奶正常吗	新生儿偶尔吐奶正常吗
经常失眠怎么调理	偶尔失眠怎么调理
八十二乘三十二	八十二乘五
睡眠质量差怎么办	睡眠质量好怎么办
一个月的宝宝老是吐奶怎么回事	一个月的宝宝偶尔吐奶怎么回事
美国东部和西部时差	美国西部和东部时差
十八除三写作	六除三写作
舌头厚白是怎么回事	舌头厚黑是怎么回事
成都到大足汽车时刻表查询	大足到成都汽车时刻表查询
高的英语怎么	矮的英语怎么
六十四乘八	六十四乘六
三十乘六	四除十
周六日银行开门吗	周六日银行关门吗
什么动物最聪明	什么动物最愚蠢
钾低会引起什么	钾高会引起什么
五十一乘八十七	五十一乘三十一
脚趾甲发白怎么治	脚趾甲发黑怎么治
六十三除多少除九	六十三除九等几
扬州到南京不走高速怎么走	南京到扬州不走高速怎么走
七十乘五	七十乘五十
宝宝眼睛被蚊子咬肿了怎么办	蚊子把宝宝眼睛咬肿了怎么办
八十五除六	八十五除十七
一百一十三点零四除二	三点二除零点零四
什么油脂肪含量最低	什么油脂肪含量最高
七百五十除五列竖式计算	十除五列竖式计算
桐乡到临平怎么坐车	临平到桐乡怎么坐车
二十年阳历五月哪天搬家好	二十年阴历五月哪天搬家好
一千加五千	五千加五千
黄瓜能和茭白一起炒吗	茭白能和黄瓜一起炒吗
三十二乘十一	十七乘十一
目光短浅的下一句是什么	高瞻远瞩的下一句是什么
六十除三十当	六十除三十除三十相等多少
七乘三等多少	三乘十八等多少
慢性胃炎会瘦吗	慢性胃炎会胖吗
八十四除七等多少	零除一等几
奢华的词语	俭朴的词语
六百八十五除五等多少	八除五等多少
湖北大学二千零二十研究生分数线	湖南大学二千零二十研究生分数线
老包是什么	嫩包是什么
一百二十除二十四怎做	一百二十除二十四等几
四十五点八除十等多少	十二除十等多少
三百除六十等多少	十除九
户县到兴平班车	兴平到户县班车
四十五除五等多少	零点五乘零点五
七十二乘一千	七十二乘六十
乌鲁木齐到成都多少公里	成都到乌鲁木齐多少公里
一点零四除二	三十乘五等多少
一百乘一千等多少	三除三等几
四十五乘五十六竖式计算	四十五乘四十五竖式计算
五加二等	零点七乘零点九
六十六乘三	十四乘二十五等多少
二百零六除二	六百零六除六
二十四乘二等多少	二百六十乘四
七百八十乘二十	二十乘二十
五十五乘十二	十二乘五十五
九十六乘二十	九十六乘十二
三十除二	三十除二点二
二十一乘二十一	二十一乘四十
恶这个字一共几画	好这个字一共几画
二十五乘二十五乘二十五等有些	二十五乘二等多少
风油精搞到眼睛怎么办	眼睛搞到风油精怎么办
广州飞盐城机票时刻表	盐城飞广州机票时刻表
一百除六	三点一四乘二点五的平方
二十二乘四十三的竖式	二十二乘二十五的竖式
精致的读音	粗率的读音
孔雀鱼水温高	孔雀鱼水温低
防护服和隔离服的价格	隔离服和防护服的价格
一百二十除十六	二点一六除零点二七
湖北工业大学研究生读几年	湖南工业大学研究生读几年
三除四	十万乘十万等多少
肝胆虚热吃什么中成药	肝胆实热吃什么中成药
二百二十五乘三点一四	八十乘十二
四百七十除五	五除六等几
六除八化成带分数	三除八化成带分数
西宁到沈阳飞机票查询	沈阳到西宁飞机票查询
抽油烟机烟管短了怎么办	抽油烟机烟管长了怎么办
四乘十八	四十乘五
一百五十除三	一百五十除五
阳历十一月六是什么星座的呀	阴历十一月六是什么星座的呀
羊水少是怎么回事	羊水多是怎么回事
血压高有什么症状	血压低有什么症状
八点八除零点二	八点四除零点二
十除六	十除十
一点二乘四	四乘二
温州到上海动车	上海到温州动车
四乘二点五等多少	四十乘五
八十除二十	四点六除二点三
八百二十四乘五等多少	五加五等几
二百七十五除二点五	二百七十五除五
六十九除三等多少	一百减五十五等多少
八十八除四埒几	八十八除四等几
中国最发达的城市	中国最落后的城市
中国最富的省是哪一个	中国最穷的省是哪一个
十三乘五等多少	十三乘十四等多少
零点二七除三	零点二七除零点三
戴口罩的错误方式	戴口罩的正确方式
小便慢怎么回事	小便快怎么回事
十一除三分之一等多少	零除三分之一等多少
